key, pos_ratio, pos_ratio^2, count, pos, neg
AAA, 0.07447, 0.00555,       94,        7,       87
AAC, 0.04348, 0.00189,       23,        1,       22
AAD, 0.01835, 0.00034,      109,        2,      107
AAE, 0.00735, 0.00005,      136,        1,      135
AAF, 0.09375, 0.00879,       64,        6,       58
AAG, 0.0625 , 0.00391,      112,        7,      105
AAH, 0.10526, 0.01108,       38,        4,       34
AAI, 0.01852, 0.00034,      108,        2,      106
AAK, 0.06931, 0.0048 ,      101,        7,       94
AAL, 0.02484, 0.00062,      161,        4,      157
AAM, 0.07895, 0.00623,       38,        3,       35
AAN, 0.01754, 0.00031,       57,        1,       56
AAP, 0.03077, 0.00095,       65,        2,       63
AAQ, 0.05556, 0.00309,       90,        5,       85
AAR, 0.03261, 0.00106,       92,        3,       89
AAS, 0.06034, 0.00364,      116,        7,      109
AAT, 0.05618, 0.00316,       89,        5,       84
AAV, 0.08594, 0.00739,      128,       11,      117
AAW, 0.05   , 0.0025 ,       20,        1,       19
AAY, 0.0566 , 0.0032 ,       53,        3,       50
AA_, 0      , 0      ,       11,        0,       11
ACA, 0      , 0      ,       10,        0,       10
ACC, 0      , 0      ,        3,        0,        3
ACD, 0.04762, 0.00227,       21,        1,       20
ACE, 0      , 0      ,       21,        0,       21
ACF, 0      , 0      ,       14,        0,       14
ACG, 0.15789, 0.02493,       19,        3,       16
ACH, 0.07692, 0.00592,       13,        1,       12
ACI, 0.05263, 0.00277,       19,        1,       18
ACK, 0      , 0      ,       19,        0,       19
ACL, 0.02703, 0.00073,       37,        1,       36
ACM, 0.2    , 0.04   ,       10,        2,        8
ACN, 0      , 0      ,       10,        0,       10
ACP, 0.07143, 0.0051 ,       14,        1,       13
ACQ, 0.125  , 0.01562,       16,        2,       14
ACR, 0.23077, 0.05325,       13,        3,       10
ACS, 0.11538, 0.01331,       26,        3,       23
ACT, 0.05556, 0.00309,       18,        1,       17
ACV, 0.17391, 0.03025,       23,        4,       19
ACW, 0      , 0      ,        8,        0,        8
ACY, 0      , 0      ,       15,        0,       15
AC_, 0      , 0      ,        1,        0,        1
ADA, 0      , 0      ,       42,        0,       42
ADC, 0.07407, 0.00549,       27,        2,       25
ADD, 0.08571, 0.00735,       70,        6,       64
ADE, 0.01031, 0.00011,       97,        1,       96
ADF, 0.01562, 0.00024,       64,        1,       63
ADG, 0.03846, 0.00148,      104,        4,      100
ADH, 0.09524, 0.00907,       21,        2,       19
ADI, 0.03252, 0.00106,      123,        4,      119
ADK, 0.06667, 0.00444,       90,        6,       84
ADL, 0.05263, 0.00277,      152,        8,      144
ADM, 0.04878, 0.00238,       41,        2,       39
ADN, 0.15909, 0.02531,       44,        7,       37
ADP, 0.04412, 0.00195,       68,        3,       65
ADQ, 0.04082, 0.00167,       49,        2,       47
ADR, 0.01266, 0.00016,       79,        1,       78
ADS, 0.02532, 0.00064,       79,        2,       77
ADT, 0.08451, 0.00714,       71,        6,       65
ADV, 0.07692, 0.00592,      130,       10,      120
ADW, 0      , 0      ,       20,        0,       20
ADY, 0.04167, 0.00174,       72,        3,       69
AD_, 0      , 0      ,        4,        0,        4
AEA, 0.05263, 0.00277,       95,        5,       90
AEC, 0.04167, 0.00174,       24,        1,       23
AED, 0.08929, 0.00797,      112,       10,      102
AEE, 0.06918, 0.00479,      159,       11,      148
AEF, 0.15278, 0.02334,       72,       11,       61
AEG, 0.05941, 0.00353,      101,        6,       95
AEH, 0.25806, 0.0666 ,       31,        8,       23
AEI, 0.08036, 0.00646,      112,        9,      103
AEK, 0.03205, 0.00103,      156,        5,      151
AEL, 0.04186, 0.00175,      215,        9,      206
AEM, 0.07895, 0.00623,       38,        3,       35
AEN, 0.03333, 0.00111,       90,        3,       87
AEP, 0.03846, 0.00148,       78,        3,       75
AEQ, 0.01099, 0.00012,       91,        1,       90
AER, 0.03   , 0.0009 ,      100,        3,       97
AES, 0.04938, 0.00244,       81,        4,       77
AET, 0.02469, 0.00061,       81,        2,       79
AEV, 0.02817, 0.00079,      142,        4,      138
AEW, 0.03571, 0.00128,       28,        1,       27
AEY, 0.0411 , 0.00169,       73,        3,       70
AE_, 0.125  , 0.01562,        8,        1,        7
AFA, 0.04545, 0.00207,       22,        1,       21
AFC, 0.1875 , 0.03516,       16,        3,       13
AFD, 0.13115, 0.0172 ,       61,        8,       53
AFE, 0.23404, 0.05478,       47,       11,       36
AFF, 0.06897, 0.00476,       29,        2,       27
AFG, 0.06349, 0.00403,       63,        4,       59
AFH, 0.06667, 0.00444,       15,        1,       14
AFI, 0.16667, 0.02778,       42,        7,       35
AFK, 0.20312, 0.04126,       64,       13,       51
AFL, 0.13333, 0.01778,       75,       10,       65
AFM, 0.14286, 0.02041,       14,        2,       12
AFN, 0.02381, 0.00057,       42,        1,       41
AFP, 0.16216, 0.0263 ,       37,        6,       31
AFQ, 0.10811, 0.01169,       37,        4,       33
AFR, 0.04762, 0.00227,       42,        2,       40
AFS, 0.10606, 0.01125,       66,        7,       59
AFT, 0.17143, 0.02939,       35,        6,       29
AFV, 0.05556, 0.00309,       54,        3,       51
AFW, 0      , 0      ,        9,        0,        9
AFY, 0.07692, 0.00592,       26,        2,       24
AF_, 0      , 0      ,        4,        0,        4
AGA, 0.08333, 0.00694,       48,        4,       44
AGC, 0.07143, 0.0051 ,       28,        2,       26
AGD, 0.01064, 0.00011,       94,        1,       93
AGE, 0.03371, 0.00114,       89,        3,       86
AGF, 0.07143, 0.0051 ,       42,        3,       39
AGG, 0.05   , 0.0025 ,      120,        6,      114
AGH, 0.07895, 0.00623,       38,        3,       35
AGI, 0.06849, 0.00469,       73,        5,       68
AGK, 0.0404 , 0.00163,       99,        4,       95
AGL, 0.02703, 0.00073,      111,        3,      108
AGM, 0      , 0      ,       21,        0,       21
AGN, 0.03922, 0.00154,       51,        2,       49
AGP, 0.01887, 0.00036,       53,        1,       52
AGQ, 0.09836, 0.00967,       61,        6,       55
AGR, 0.06557, 0.0043 ,       61,        4,       57
AGS, 0.05102, 0.0026 ,       98,        5,       93
AGT, 0.09756, 0.00952,       82,        8,       74
AGV, 0.01075, 0.00012,       93,        1,       92
AGW, 0.11538, 0.01331,       26,        3,       23
AGY, 0.0597 , 0.00356,       67,        4,       63
AG_, 0      , 0      ,       15,        0,       15
AHA, 0.05263, 0.00277,       19,        1,       18
AHC, 0.23529, 0.05536,       17,        4,       13
AHD, 0.125  , 0.01562,       32,        4,       28
AHE, 0.15625, 0.02441,       32,        5,       27
AHF, 0.10526, 0.01108,       19,        2,       17
AHG, 0.13953, 0.01947,       43,        6,       37
AHH, 0.2    , 0.04   ,       10,        2,        8
AHI, 0.06667, 0.00444,       30,        2,       28
AHK, 0.16667, 0.02778,       24,        4,       20
AHL, 0.04   , 0.0016 ,       50,        2,       48
AHM, 0.18182, 0.03306,       11,        2,        9
AHN, 0.05882, 0.00346,       17,        1,       16
AHP, 0.14286, 0.02041,       21,        3,       18
AHQ, 0.12903, 0.01665,       31,        4,       27
AHR, 0.03448, 0.00119,       29,        1,       28
AHS, 0.10811, 0.01169,       37,        4,       33
AHT, 0.21429, 0.04592,       28,        6,       22
AHV, 0.125  , 0.01562,       32,        4,       28
AHW, 0.16667, 0.02778,        6,        1,        5
AHY, 0.13043, 0.01701,       23,        3,       20
AH_, 0      , 0      ,        2,        0,        2
AIA, 0.0339 , 0.00115,       59,        2,       57
AIC, 0.14286, 0.02041,       14,        2,       12
AID, 0.08   , 0.0064 ,       75,        6,       69
AIE, 0.04598, 0.00211,       87,        4,       83
AIF, 0.05128, 0.00263,       39,        2,       37
AIG, 0.01818, 0.00033,       55,        1,       54
AIH, 0.08696, 0.00756,       23,        2,       21
AII, 0.07843, 0.00615,       51,        4,       47
AIK, 0.06329, 0.00401,       79,        5,       74
AIL, 0.12222, 0.01494,       90,       11,       79
AIM, 0.16   , 0.0256 ,       25,        4,       21
AIN, 0.08163, 0.00666,       49,        4,       45
AIP, 0.04255, 0.00181,       47,        2,       45
AIQ, 0.02778, 0.00077,       36,        1,       35
AIR, 0.12987, 0.01687,       77,       10,       67
AIS, 0.06557, 0.0043 ,       61,        4,       57
AIT, 0.11842, 0.01402,       76,        9,       67
AIV, 0.09524, 0.00907,       63,        6,       57
AIW, 0      , 0      ,       13,        0,       13
AIY, 0.07895, 0.00623,       38,        3,       35
AI_, 0      , 0      ,        1,        0,        1
AKA, 0.05063, 0.00256,       79,        4,       75
AKC, 0.04167, 0.00174,       24,        1,       23
AKD, 0.02222, 0.00049,       90,        2,       88
AKE, 0.02941, 0.00087,      136,        4,      132
AKF, 0.11111, 0.01235,       54,        6,       48
AKG, 0.0463 , 0.00214,      108,        5,      103
AKH, 0.05556, 0.00309,       36,        2,       34
AKI, 0.08163, 0.00666,       98,        8,       90
AKK, 0.08257, 0.00682,      109,        9,      100
AKL, 0.07692, 0.00592,      182,       14,      168
AKM, 0.02222, 0.00049,       45,        1,       44
AKN, 0.02857, 0.00082,       70,        2,       68
AKP, 0      , 0      ,       53,        0,       53
AKQ, 0.04615, 0.00213,       65,        3,       62
AKR, 0.02899, 0.00084,       69,        2,       67
AKS, 0.04938, 0.00244,       81,        4,       77
AKT, 0.06897, 0.00476,       87,        6,       81
AKV, 0.07895, 0.00623,      114,        9,      105
AKW, 0.11111, 0.01235,       18,        2,       16
AKY, 0.05357, 0.00287,       56,        3,       53
AK_, 0.09091, 0.00826,       11,        1,       10
ALA, 0.05   , 0.0025 ,       80,        4,       76
ALC, 0.09091, 0.00826,       33,        3,       30
ALD, 0.07143, 0.0051 ,      112,        8,      104
ALE, 0.05521, 0.00305,      163,        9,      154
ALF, 0.10145, 0.01029,       69,        7,       62
ALG, 0.06452, 0.00416,      124,        8,      116
ALH, 0.11628, 0.01352,       43,        5,       38
ALI, 0.05102, 0.0026 ,       98,        5,       93
ALK, 0.08844, 0.00782,      147,       13,      134
ALL, 0.05495, 0.00302,      182,       10,      172
ALM, 0.04   , 0.0016 ,       50,        2,       48
ALN, 0.08108, 0.00657,       74,        6,       68
ALP, 0.0297 , 0.00088,      101,        3,       98
ALQ, 0.0625 , 0.00391,       96,        6,       90
ALR, 0.05385, 0.0029 ,      130,        7,      123
ALS, 0.06015, 0.00362,      133,        8,      125
ALT, 0.04255, 0.00181,       94,        4,       90
ALV, 0.09524, 0.00907,      126,       12,      114
ALW, 0.03448, 0.00119,       29,        1,       28
ALY, 0.06667, 0.00444,       75,        5,       70
AL_, 0      , 0      ,        8,        0,        8
AMA, 0      , 0      ,       20,        0,       20
AMC, 0.11111, 0.01235,        9,        1,        8
AMD, 0.02703, 0.00073,       37,        1,       36
AME, 0.05263, 0.00277,       38,        2,       36
AMF, 0      , 0      ,       19,        0,       19
AMG, 0.18605, 0.03461,       43,        8,       35
AMH, 0.04762, 0.00227,       21,        1,       20
AMI, 0.20833, 0.0434 ,       24,        5,       19
AMK, 0      , 0      ,       37,        0,       37
AML, 0.12245, 0.01499,       49,        6,       43
AMM, 0.07692, 0.00592,       13,        1,       12
AMN, 0      , 0      ,       20,        0,       20
AMP, 0.14286, 0.02041,       14,        2,       12
AMQ, 0.17391, 0.03025,       23,        4,       19
AMR, 0.08333, 0.00694,       24,        2,       22
AMS, 0.11429, 0.01306,       35,        4,       31
AMT, 0.04   , 0.0016 ,       25,        1,       24
AMV, 0.08571, 0.00735,       35,        3,       32
AMW, 0      , 0      ,        9,        0,        9
AMY, 0.16667, 0.02778,       12,        2,       10
AM_, 0      , 0      ,       10,        0,       10
ANA, 0      , 0      ,       43,        0,       43
ANC, 0.125  , 0.01562,       16,        2,       14
AND, 0.0625 , 0.00391,       48,        3,       45
ANE, 0.01818, 0.00033,       55,        1,       54
ANF, 0.06122, 0.00375,       49,        3,       46
ANG, 0.1125 , 0.01266,       80,        9,       71
ANH, 0.07143, 0.0051 ,       28,        2,       26
ANI, 0.09459, 0.00895,       74,        7,       67
ANK, 0.05882, 0.00346,       68,        4,       64
ANL, 0.07143, 0.0051 ,       98,        7,       91
ANM, 0.05   , 0.0025 ,       20,        1,       19
ANN, 0.05172, 0.00268,       58,        3,       55
ANP, 0.05357, 0.00287,       56,        3,       53
ANQ, 0      , 0      ,       40,        0,       40
ANR, 0      , 0      ,       53,        0,       53
ANS, 0.10204, 0.01041,       49,        5,       44
ANT, 0.09091, 0.00826,       44,        4,       40
ANV, 0.08955, 0.00802,       67,        6,       61
ANW, 0      , 0      ,       12,        0,       12
ANY, 0.15789, 0.02493,       38,        6,       32
AN_, 0      , 0      ,        7,        0,        7
APA, 0      , 0      ,       34,        0,       34
APC, 0      , 0      ,       17,        0,       17
APD, 0.025  , 0.00063,       80,        2,       78
APE, 0.01316, 0.00017,       76,        1,       75
APF, 0.16667, 0.02778,       24,        4,       20
APG, 0.06024, 0.00363,       83,        5,       78
APH, 0      , 0      ,       23,        0,       23
API, 0.04225, 0.00179,       71,        3,       68
APK, 0.06122, 0.00375,       49,        3,       46
APL, 0.01786, 0.00032,      112,        2,      110
APM, 0.10526, 0.01108,       19,        2,       17
APN, 0.04545, 0.00207,       44,        2,       42
APP, 0.0625 , 0.00391,       64,        4,       60
APQ, 0.03333, 0.00111,       30,        1,       29
APR, 0.12766, 0.0163 ,       47,        6,       41
APS, 0.02632, 0.00069,       76,        2,       74
APT, 0.0137 , 0.00019,       73,        1,       72
APV, 0.05   , 0.0025 ,       80,        4,       76
APW, 0.07143, 0.0051 ,       14,        1,       13
APY, 0.06897, 0.00476,       29,        2,       27
AP_, 0      , 0      ,        9,        0,        9
AQA, 0.10345, 0.0107 ,       58,        6,       52
AQC, 0.16   , 0.0256 ,       25,        4,       21
AQD, 0.07273, 0.00529,       55,        4,       51
AQE, 0.03614, 0.00131,       83,        3,       80
AQF, 0.11364, 0.01291,       44,        5,       39
AQG, 0.03614, 0.00131,       83,        3,       80
AQH, 0.02857, 0.00082,       35,        1,       34
AQI, 0.17391, 0.03025,       69,       12,       57
AQK, 0.04054, 0.00164,       74,        3,       71
AQL, 0.01754, 0.00031,      114,        2,      112
AQM, 0.18182, 0.03306,       33,        6,       27
AQN, 0.04545, 0.00207,       44,        2,       42
AQP, 0.02703, 0.00073,       37,        1,       36
AQQ, 0.0875 , 0.00766,       80,        7,       73
AQR, 0.06494, 0.00422,       77,        5,       72
AQS, 0.07692, 0.00592,       52,        4,       48
AQT, 0.08065, 0.0065 ,       62,        5,       57
AQV, 0.11765, 0.01384,       68,        8,       60
AQW, 0.14286, 0.02041,       21,        3,       18
AQY, 0.02381, 0.00057,       42,        1,       41
AQ_, 0      , 0      ,        1,        0,        1
ARA, 0.01818, 0.00033,       55,        1,       54
ARC, 0      , 0      ,       20,        0,       20
ARD, 0.10588, 0.01121,       85,        9,       76
ARE, 0.07692, 0.00592,      104,        8,       96
ARF, 0.05882, 0.00346,       51,        3,       48
ARG, 0.1125 , 0.01266,       80,        9,       71
ARH, 0.03846, 0.00148,       26,        1,       25
ARI, 0.11905, 0.01417,       84,       10,       74
ARK, 0.08824, 0.00779,       68,        6,       62
ARL, 0.06475, 0.00419,      139,        9,      130
ARM, 0.16   , 0.0256 ,       25,        4,       21
ARN, 0.08621, 0.00743,       58,        5,       53
ARP, 0.11111, 0.01235,       54,        6,       48
ARQ, 0.07692, 0.00592,       65,        5,       60
ARR, 0.03614, 0.00131,       83,        3,       80
ARS, 0.05634, 0.00317,       71,        4,       67
ART, 0.08333, 0.00694,       72,        6,       66
ARV, 0.04132, 0.00171,      121,        5,      116
ARW, 0.15   , 0.0225 ,       20,        3,       17
ARY, 0.06   , 0.0036 ,       50,        3,       47
AR_, 0      , 0      ,        3,        0,        3
ASA, 0.09091, 0.00826,       66,        6,       60
ASC, 0.1    , 0.01   ,       20,        2,       18
ASD, 0.01515, 0.00023,       66,        1,       65
ASE, 0.07895, 0.00623,       76,        6,       70
ASF, 0.04478, 0.002  ,       67,        3,       64
ASG, 0.05882, 0.00346,      102,        6,       96
ASH, 0.09091, 0.00826,       33,        3,       30
ASI, 0.04878, 0.00238,       82,        4,       78
ASK, 0.01111, 0.00012,       90,        1,       89
ASL, 0.07857, 0.00617,      140,       11,      129
ASM, 0.02222, 0.00049,       45,        1,       44
ASN, 0.05455, 0.00298,       55,        3,       52
ASP, 0.01266, 0.00016,       79,        1,       78
ASQ, 0.06122, 0.00375,       49,        3,       46
ASR, 0.06849, 0.00469,       73,        5,       68
ASS, 0.05085, 0.00259,      118,        6,      112
AST, 0.05797, 0.00336,       69,        4,       65
ASV, 0.06452, 0.00416,      124,        8,      116
ASW, 0.04545, 0.00207,       22,        1,       21
ASY, 0.06557, 0.0043 ,       61,        4,       57
AS_, 0      , 0      ,       13,        0,       13
ATA, 0.1    , 0.01   ,       60,        6,       54
ATC, 0.03448, 0.00119,       29,        1,       28
ATD, 0.07353, 0.00541,       68,        5,       63
ATE, 0.04054, 0.00164,       74,        3,       71
ATF, 0.08696, 0.00756,       46,        4,       42
ATG, 0.0303 , 0.00092,       99,        3,       96
ATH, 0.04167, 0.00174,       24,        1,       23
ATI, 0.01333, 0.00018,       75,        1,       74
ATK, 0.11321, 0.01282,       53,        6,       47
ATL, 0.04828, 0.00233,      145,        7,      138
ATM, 0.05263, 0.00277,       19,        1,       18
ATN, 0.08065, 0.0065 ,       62,        5,       57
ATP, 0.06122, 0.00375,       49,        3,       46
ATQ, 0.07273, 0.00529,       55,        4,       51
ATR, 0.04762, 0.00227,       63,        3,       60
ATS, 0.03448, 0.00119,       58,        2,       56
ATT, 0.08621, 0.00743,       58,        5,       53
ATV, 0.02174, 0.00047,       92,        2,       90
ATW, 0      , 0      ,       13,        0,       13
ATY, 0.04348, 0.00189,       46,        2,       44
AT_, 0      , 0      ,        2,        0,        2
AVA, 0.04478, 0.002  ,       67,        3,       64
AVC, 0      , 0      ,       24,        0,       24
AVD, 0.04762, 0.00227,       84,        4,       80
AVE, 0.11765, 0.01384,      102,       12,       90
AVF, 0.05769, 0.00333,       52,        3,       49
AVG, 0.05319, 0.00283,       94,        5,       89
AVH, 0.13333, 0.01778,       30,        4,       26
AVI, 0.07792, 0.00607,       77,        6,       71
AVK, 0.07609, 0.00579,       92,        7,       85
AVL, 0.09524, 0.00907,      126,       12,      114
AVM, 0.06452, 0.00416,       31,        2,       29
AVN, 0.06349, 0.00403,       63,        4,       59
AVP, 0.12698, 0.01612,       63,        8,       55
AVQ, 0.04478, 0.002  ,       67,        3,       64
AVR, 0.08235, 0.00678,       85,        7,       78
AVS, 0.11538, 0.01331,       78,        9,       69
AVT, 0.09756, 0.00952,       82,        8,       74
AVV, 0.04545, 0.00207,       88,        4,       84
AVW, 0.1    , 0.01   ,       20,        2,       18
AVY, 0.08696, 0.00756,       46,        4,       42
AV_, 0      , 0      ,        3,        0,        3
AWA, 0.2    , 0.04   ,        5,        1,        4
AWC, 0.375  , 0.14062,        8,        3,        5
AWD, 0.04762, 0.00227,       21,        1,       20
AWE, 0.1    , 0.01   ,       10,        1,        9
AWF, 0.15385, 0.02367,       13,        2,       11
AWG, 0.27273, 0.07438,       11,        3,        8
AWH, 0      , 0      ,        7,        0,        7
AWI, 0      , 0      ,       10,        0,       10
AWK, 0.20833, 0.0434 ,       24,        5,       19
AWL, 0.07692, 0.00592,       26,        2,       24
AWM, 0.1    , 0.01   ,       10,        1,        9
AWN, 0.2    , 0.04   ,       15,        3,       12
AWP, 0.10526, 0.01108,       19,        2,       17
AWQ, 0      , 0      ,       11,        0,       11
AWR, 0.16667, 0.02778,       18,        3,       15
AWS, 0.04545, 0.00207,       22,        1,       21
AWT, 0.21053, 0.04432,       19,        4,       15
AWV, 0.27273, 0.07438,       11,        3,        8
AWW, 0      , 0      ,        4,        0,        4
AWY, 0.09091, 0.00826,       11,        1,       10
AW_, 0      , 0      ,        2,        0,        2
AYA, 0.06061, 0.00367,       33,        2,       31
AYC, 0.14286, 0.02041,       21,        3,       18
AYD, 0.03774, 0.00142,       53,        2,       51
AYE, 0.16667, 0.02778,       60,       10,       50
AYF, 0.15152, 0.02296,       33,        5,       28
AYG, 0.1129 , 0.01275,       62,        7,       55
AYH, 0      , 0      ,       16,        0,       16
AYI, 0.08696, 0.00756,       46,        4,       42
AYK, 0.075  , 0.00562,       40,        3,       37
AYL, 0.15493, 0.024  ,       71,       11,       60
AYM, 0      , 0      ,       10,        0,       10
AYN, 0.10714, 0.01148,       28,        3,       25
AYP, 0.03846, 0.00148,       26,        1,       25
AYQ, 0.16667, 0.02778,       36,        6,       30
AYR, 0.09524, 0.00907,       42,        4,       38
AYS, 0.08511, 0.00724,       47,        4,       43
AYT, 0.16949, 0.02873,       59,       10,       49
AYV, 0.09524, 0.00907,       63,        6,       57
AYW, 0.15385, 0.02367,       13,        2,       11
AYY, 0.14286, 0.02041,       35,        5,       30
AY_, 0      , 0      ,        3,        0,        3
CAC, 0      , 0      ,        3,        0,        3
CAD, 0.14815, 0.02195,       27,        4,       23
CAE, 0.10526, 0.01108,       19,        2,       17
CAF, 0.21429, 0.04592,       14,        3,       11
CAG, 0.13043, 0.01701,       23,        3,       20
CAH, 0      , 0      ,        6,        0,        6
CAI, 0.0625 , 0.00391,       16,        1,       15
CAK, 0      , 0      ,       18,        0,       18
CAL, 0      , 0      ,       25,        0,       25
CAM, 0.2    , 0.04   ,        5,        1,        4
CAN, 0.05882, 0.00346,       17,        1,       16
CAP, 0      , 0      ,       20,        0,       20
CAQ, 0      , 0      ,       20,        0,       20
CAR, 0.06667, 0.00444,       15,        1,       14
CAS, 0.04   , 0.0016 ,       25,        1,       24
CAT, 0      , 0      ,       15,        0,       15
CAV, 0.03125, 0.00098,       32,        1,       31
CAW, 0      , 0      ,        5,        0,        5
CAY, 0.16667, 0.02778,       12,        2,       10
CA_, 0      , 0      ,        1,        0,        1
CCC, 0      , 0      ,        1,        0,        1
CCD, 0.14286, 0.02041,       14,        2,       12
CCE, 0      , 0      ,        8,        0,        8
CCF, 0.14286, 0.02041,        7,        1,        6
CCG, 0.1    , 0.01   ,       10,        1,        9
CCH, 0.16667, 0.02778,        6,        1,        5
CCI, 0.83333, 0.69444,        6,        5,        1
CCK, 0      , 0      ,        5,        0,        5
CCL, 0.16667, 0.02778,       12,        2,       10
CCM, 0      , 0      ,        2,        0,        2
CCN, 0      , 0      ,        7,        0,        7
CCP, 0.16667, 0.02778,        6,        1,        5
CCQ, 0.5    , 0.25   ,        2,        1,        1
CCR, 0      , 0      ,        2,        0,        2
CCS, 0.16667, 0.02778,       12,        2,       10
CCT, 0      , 0      ,        5,        0,        5
CCV, 0      , 0      ,        3,        0,        3
CCY, 0      , 0      ,        6,        0,        6
CDC, 0.28571, 0.08163,        7,        2,        5
CDD, 0.08333, 0.00694,       24,        2,       22
CDE, 0.22727, 0.05165,       22,        5,       17
CDF, 0.19048, 0.03628,       21,        4,       17
CDG, 0.18182, 0.03306,       22,        4,       18
CDH, 0.11111, 0.01235,        9,        1,        8
CDI, 0.05   , 0.0025 ,       20,        1,       19
CDK, 0.19048, 0.03628,       21,        4,       17
CDL, 0.10526, 0.01108,       38,        4,       34
CDM, 0.22222, 0.04938,        9,        2,        7
CDN, 0.0625 , 0.00391,       16,        1,       15
CDP, 0      , 0      ,       19,        0,       19
CDQ, 0      , 0      ,       10,        0,       10
CDR, 0.23529, 0.05536,       17,        4,       13
CDS, 0.11538, 0.01331,       26,        3,       23
CDT, 0      , 0      ,       18,        0,       18
CDV, 0      , 0      ,       25,        0,       25
CDW, 0      , 0      ,        6,        0,        6
CDY, 0.17647, 0.03114,       17,        3,       14
CD_, 0      , 0      ,        2,        0,        2
CEC, 0      , 0      ,        6,        0,        6
CED, 0.11111, 0.01235,       27,        3,       24
CEE, 0.09302, 0.00865,       43,        4,       39
CEF, 0      , 0      ,       11,        0,       11
CEG, 0.03125, 0.00098,       32,        1,       31
CEH, 0      , 0      ,       10,        0,       10
CEI, 0.18519, 0.03429,       27,        5,       22
CEK, 0.03571, 0.00128,       28,        1,       27
CEL, 0.10526, 0.01108,       38,        4,       34
CEM, 0.08333, 0.00694,       12,        1,       11
CEN, 0      , 0      ,       24,        0,       24
CEP, 0.03846, 0.00148,       26,        1,       25
CEQ, 0.0625 , 0.00391,       16,        1,       15
CER, 0.125  , 0.01562,       24,        3,       21
CES, 0.15385, 0.02367,       26,        4,       22
CET, 0.06667, 0.00444,       15,        1,       14
CEV, 0.04348, 0.00189,       23,        1,       22
CEW, 0.25   , 0.0625 ,        4,        1,        3
CEY, 0      , 0      ,       18,        0,       18
CFC, 0      , 0      ,        2,        0,        2
CFD, 0.17647, 0.03114,       17,        3,       14
CFE, 0.09091, 0.00826,       11,        1,       10
CFF, 0.1    , 0.01   ,       10,        1,        9
CFG, 0.25   , 0.0625 ,       16,        4,       12
CFH, 0.14286, 0.02041,        7,        1,        6
CFI, 0      , 0      ,        4,        0,        4
CFK, 0.08333, 0.00694,       12,        1,       11
CFL, 0.25   , 0.0625 ,       20,        5,       15
CFM, 0.11111, 0.01235,        9,        1,        8
CFN, 0.25   , 0.0625 ,       12,        3,        9
CFP, 0      , 0      ,        6,        0,        6
CFQ, 0.23077, 0.05325,       13,        3,       10
CFR, 0.2    , 0.04   ,       10,        2,        8
CFS, 0.13636, 0.0186 ,       22,        3,       19
CFT, 0.25   , 0.0625 ,       16,        4,       12
CFV, 0.0625 , 0.00391,       16,        1,       15
CFW, 0      , 0      ,        8,        0,        8
CFY, 0.25   , 0.0625 ,       12,        3,        9
CF_, 0      , 0      ,        1,        0,        1
CGC, 0      , 0      ,        5,        0,        5
CGD, 0.03226, 0.00104,       31,        1,       30
CGE, 0.12121, 0.01469,       33,        4,       29
CGF, 0.2    , 0.04   ,        5,        1,        4
CGG, 0.03333, 0.00111,       30,        1,       29
CGH, 0.08333, 0.00694,       12,        1,       11
CGI, 0.38462, 0.14793,       13,        5,        8
CGK, 0      , 0      ,       19,        0,       19
CGL, 0.05882, 0.00346,       17,        1,       16
CGM, 0      , 0      ,        4,        0,        4
CGN, 0      , 0      ,       15,        0,       15
CGP, 0      , 0      ,       14,        0,       14
CGQ, 0      , 0      ,       21,        0,       21
CGR, 0.08   , 0.0064 ,       25,        2,       23
CGS, 0.1    , 0.01   ,       30,        3,       27
CGT, 0.16667, 0.02778,       24,        4,       20
CGV, 0.07143, 0.0051 ,       14,        1,       13
CGW, 0      , 0      ,        4,        0,        4
CGY, 0      , 0      ,        9,        0,        9
CG_, 0.33333, 0.11111,        3,        1,        2
CHD, 0      , 0      ,        9,        0,        9
CHE, 0.3    , 0.09   ,       10,        3,        7
CHF, 0      , 0      ,        7,        0,        7
CHG, 0.09091, 0.00826,       11,        1,       10
CHH, 0      , 0      ,        6,        0,        6
CHI, 0      , 0      ,       12,        0,       12
CHK, 0.08333, 0.00694,       12,        1,       11
CHL, 0      , 0      ,       24,        0,       24
CHM, 0      , 0      ,        4,        0,        4
CHN, 0.11111, 0.01235,        9,        1,        8
CHP, 0.06667, 0.00444,       15,        1,       14
CHQ, 0.2    , 0.04   ,        5,        1,        4
CHR, 0      , 0      ,        9,        0,        9
CHS, 0.11765, 0.01384,       17,        2,       15
CHT, 0      , 0      ,        8,        0,        8
CHV, 0      , 0      ,        6,        0,        6
CHW, 0.33333, 0.11111,        3,        1,        2
CHY, 0      , 0      ,        7,        0,        7
CIC, 0      , 0      ,        3,        0,        3
CID, 0      , 0      ,       14,        0,       14
CIE, 0.25   , 0.0625 ,       16,        4,       12
CIF, 0      , 0      ,        7,        0,        7
CIG, 0.19048, 0.03628,       21,        4,       17
CIH, 0      , 0      ,        7,        0,        7
CII, 0.07692, 0.00592,       13,        1,       12
CIK, 0.07143, 0.0051 ,       14,        1,       13
CIL, 0.21429, 0.04592,       28,        6,       22
CIM, 0      , 0      ,        8,        0,        8
CIN, 0.05263, 0.00277,       19,        1,       18
CIP, 0      , 0      ,       19,        0,       19
CIQ, 0.0625 , 0.00391,       16,        1,       15
CIR, 0.09091, 0.00826,       11,        1,       10
CIS, 0.05556, 0.00309,       18,        1,       17
CIT, 0.125  , 0.01562,        8,        1,        7
CIV, 0.15385, 0.02367,       26,        4,       22
CIW, 0      , 0      ,        6,        0,        6
CIY, 0.08333, 0.00694,       12,        1,       11
CKC, 1      , 1      ,        1,        1,        0
CKD, 0.06452, 0.00416,       31,        2,       29
CKE, 0.06897, 0.00476,       29,        2,       27
CKF, 0.05556, 0.00309,       18,        1,       17
CKG, 0.03333, 0.00111,       30,        1,       29
CKH, 0      , 0      ,        7,        0,        7
CKI, 0.05556, 0.00309,       18,        1,       17
CKK, 0.02857, 0.00082,       35,        1,       34
CKL, 0.03125, 0.00098,       32,        1,       31
CKM, 0      , 0      ,        9,        0,        9
CKN, 0.05263, 0.00277,       19,        1,       18
CKP, 0      , 0      ,       18,        0,       18
CKQ, 0      , 0      ,       15,        0,       15
CKR, 0.07692, 0.00592,       13,        1,       12
CKS, 0      , 0      ,       21,        0,       21
CKT, 0.05263, 0.00277,       19,        1,       18
CKV, 0      , 0      ,       20,        0,       20
CKW, 0.125  , 0.01562,        8,        1,        7
CKY, 0      , 0      ,       13,        0,       13
CK_, 0      , 0      ,        2,        0,        2
CLC, 0      , 0      ,        7,        0,        7
CLD, 0.16   , 0.0256 ,       25,        4,       21
CLE, 0.10714, 0.01148,       28,        3,       25
CLF, 0      , 0      ,       17,        0,       17
CLG, 0.14706, 0.02163,       34,        5,       29
CLH, 0.14286, 0.02041,       14,        2,       12
CLI, 0.05556, 0.00309,       18,        1,       17
CLK, 0.1    , 0.01   ,       30,        3,       27
CLL, 0.11905, 0.01417,       42,        5,       37
CLM, 0.14286, 0.02041,        7,        1,        6
CLN, 0      , 0      ,       27,        0,       27
CLP, 0.04   , 0.0016 ,       25,        1,       24
CLQ, 0.07692, 0.00592,       26,        2,       24
CLR, 0.16667, 0.02778,       30,        5,       25
CLS, 0.09375, 0.00879,       32,        3,       29
CLT, 0.10345, 0.0107 ,       29,        3,       26
CLV, 0.07143, 0.0051 ,       28,        2,       26
CLW, 0      , 0      ,        5,        0,        5
CLY, 0.22727, 0.05165,       22,        5,       17
CL_, 0      , 0      ,        3,        0,        3
CMC, 0      , 0      ,        1,        0,        1
CMD, 0      , 0      ,       10,        0,       10
CME, 0      , 0      ,       10,        0,       10
CMF, 0      , 0      ,        3,        0,        3
CMG, 0.33333, 0.11111,        6,        2,        4
CMH, 0      , 0      ,        3,        0,        3
CMI, 0      , 0      ,        2,        0,        2
CMK, 0      , 0      ,       15,        0,       15
CML, 0.5    , 0.25   ,        8,        4,        4
CMM, 1      , 1      ,        1,        1,        0
CMN, 0      , 0      ,        5,        0,        5
CMP, 0      , 0      ,        5,        0,        5
CMQ, 0.16667, 0.02778,        6,        1,        5
CMS, 0      , 0      ,       14,        0,       14
CMT, 0      , 0      ,        2,        0,        2
CMV, 0.22222, 0.04938,        9,        2,        7
CMY, 0      , 0      ,        2,        0,        2
CM_, 0.33333, 0.11111,        3,        1,        2
CNC, 0      , 0      ,        9,        0,        9
CND, 0.0625 , 0.00391,       16,        1,       15
CNE, 0.04   , 0.0016 ,       25,        1,       24
CNF, 0.08333, 0.00694,       12,        1,       11
CNG, 0      , 0      ,       16,        0,       16
CNH, 0      , 0      ,        6,        0,        6
CNI, 0      , 0      ,       13,        0,       13
CNK, 0.05882, 0.00346,       17,        1,       16
CNL, 0      , 0      ,       27,        0,       27
CNM, 0      , 0      ,        1,        0,        1
CNN, 0.09091, 0.00826,       11,        1,       10
CNP, 0.05556, 0.00309,       18,        1,       17
CNQ, 0      , 0      ,       14,        0,       14
CNR, 0.05882, 0.00346,       17,        1,       16
CNS, 0.04348, 0.00189,       23,        1,       22
CNT, 0      , 0      ,       19,        0,       19
CNV, 0.0625 , 0.00391,       16,        1,       15
CNW, 0      , 0      ,        1,        0,        1
CNY, 0      , 0      ,        7,        0,        7
CPC, 0      , 0      ,        2,        0,        2
CPD, 0.09091, 0.00826,       22,        2,       20
CPE, 0.03846, 0.00148,       26,        1,       25
CPF, 0      , 0      ,        8,        0,        8
CPG, 0.05263, 0.00277,       19,        1,       18
CPH, 0      , 0      ,        9,        0,        9
CPI, 0      , 0      ,       19,        0,       19
CPK, 0      , 0      ,       25,        0,       25
CPL, 0.08   , 0.0064 ,       25,        2,       23
CPM, 0      , 0      ,        1,        0,        1
CPN, 0      , 0      ,       14,        0,       14
CPP, 0      , 0      ,       18,        0,       18
CPQ, 0      , 0      ,       16,        0,       16
CPR, 0.08696, 0.00756,       23,        2,       21
CPS, 0.18182, 0.03306,       22,        4,       18
CPT, 0      , 0      ,       18,        0,       18
CPV, 0.04348, 0.00189,       23,        1,       22
CPW, 0      , 0      ,        7,        0,        7
CPY, 0.30769, 0.09467,       13,        4,        9
CQC, 0.4    , 0.16   ,        5,        2,        3
CQD, 0.10714, 0.01148,       28,        3,       25
CQE, 0.09524, 0.00907,       21,        2,       19
CQF, 0.09091, 0.00826,       11,        1,       10
CQG, 0.11538, 0.01331,       26,        3,       23
CQH, 0.11111, 0.01235,        9,        1,        8
CQI, 0      , 0      ,       12,        0,       12
CQK, 0      , 0      ,       29,        0,       29
CQL, 0      , 0      ,       19,        0,       19
CQM, 0.25   , 0.0625 ,        8,        2,        6
CQN, 0.16667, 0.02778,       12,        2,       10
CQP, 0      , 0      ,       11,        0,       11
CQQ, 0      , 0      ,       14,        0,       14
CQR, 0.125  , 0.01562,       16,        2,       14
CQS, 0.09091, 0.00826,       22,        2,       20
CQT, 0.13043, 0.01701,       23,        3,       20
CQV, 0.15789, 0.02493,       19,        3,       16
CQW, 0      , 0      ,        4,        0,        4
CQY, 0      , 0      ,       16,        0,       16
CQ_, 0      , 0      ,        1,        0,        1
CRC, 0      , 0      ,        2,        0,        2
CRD, 0.03448, 0.00119,       29,        1,       28
CRE, 0      , 0      ,       27,        0,       27
CRF, 0.23077, 0.05325,       13,        3,       10
CRG, 0.1    , 0.01   ,       30,        3,       27
CRH, 0      , 0      ,       10,        0,       10
CRI, 0.05556, 0.00309,       18,        1,       17
CRK, 0.19048, 0.03628,       21,        4,       17
CRL, 0      , 0      ,       32,        0,       32
CRM, 0.1    , 0.01   ,       10,        1,        9
CRN, 0.10526, 0.01108,       19,        2,       17
CRP, 0.04762, 0.00227,       21,        1,       20
CRQ, 0      , 0      ,       17,        0,       17
CRR, 0.10714, 0.01148,       28,        3,       25
CRS, 0.0625 , 0.00391,       16,        1,       15
CRT, 0.06667, 0.00444,       15,        1,       14
CRV, 0.09091, 0.00826,       33,        3,       30
CRW, 0      , 0      ,       13,        0,       13
CRY, 0.07143, 0.0051 ,       14,        1,       13
CR_, 0      , 0      ,        4,        0,        4
CSC, 0      , 0      ,        8,        0,        8
CSD, 0.22727, 0.05165,       22,        5,       17
CSE, 0      , 0      ,       21,        0,       21
CSF, 0.15   , 0.0225 ,       20,        3,       17
CSG, 0.03226, 0.00104,       31,        1,       30
CSH, 0      , 0      ,       10,        0,       10
CSI, 0.15385, 0.02367,       26,        4,       22
CSK, 0.05556, 0.00309,       18,        1,       17
CSL, 0      , 0      ,       37,        0,       37
CSM, 0      , 0      ,        7,        0,        7
CSN, 0      , 0      ,       12,        0,       12
CSP, 0.04167, 0.00174,       24,        1,       23
CSQ, 0      , 0      ,       14,        0,       14
CSR, 0      , 0      ,       15,        0,       15
CSS, 0      , 0      ,       42,        0,       42
CST, 0      , 0      ,        9,        0,        9
CSV, 0      , 0      ,       29,        0,       29
CSW, 0.16667, 0.02778,        6,        1,        5
CSY, 0      , 0      ,       14,        0,       14
CS_, 0.4    , 0.16   ,        5,        2,        3
CTC, 0      , 0      ,        7,        0,        7
CTD, 0.13043, 0.01701,       23,        3,       20
CTE, 0.05   , 0.0025 ,       20,        1,       19
CTF, 0      , 0      ,       13,        0,       13
CTG, 0.11111, 0.01235,       18,        2,       16
CTH, 0      , 0      ,       11,        0,       11
CTI, 0.11111, 0.01235,        9,        1,        8
CTK, 0.08696, 0.00756,       23,        2,       21
CTL, 0.04348, 0.00189,       23,        1,       22
CTM, 0      , 0      ,        7,        0,        7
CTN, 0      , 0      ,       12,        0,       12
CTP, 0.1    , 0.01   ,       20,        2,       18
CTQ, 0.1    , 0.01   ,       10,        1,        9
CTR, 0      , 0      ,       11,        0,       11
CTS, 0.11111, 0.01235,       18,        2,       16
CTT, 0.09524, 0.00907,       21,        2,       19
CTV, 0.03226, 0.00104,       31,        1,       30
CTW, 0      , 0      ,        3,        0,        3
CTY, 0      , 0      ,       18,        0,       18
CVC, 0      , 0      ,        9,        0,        9
CVD, 0      , 0      ,       15,        0,       15
CVE, 0      , 0      ,       29,        0,       29
CVF, 0.21429, 0.04592,       14,        3,       11
CVG, 0.1    , 0.01   ,       30,        3,       27
CVH, 0.16667, 0.02778,        6,        1,        5
CVI, 0.0625 , 0.00391,       16,        1,       15
CVK, 0.07143, 0.0051 ,       14,        1,       13
CVL, 0.18519, 0.03429,       27,        5,       22
CVM, 0.25   , 0.0625 ,        4,        1,        3
CVN, 0      , 0      ,       17,        0,       17
CVP, 0.04762, 0.00227,       21,        1,       20
CVQ, 0      , 0      ,       10,        0,       10
CVR, 0.05   , 0.0025 ,       20,        1,       19
CVS, 0.09091, 0.00826,       22,        2,       20
CVT, 0      , 0      ,       14,        0,       14
CVV, 0.04   , 0.0016 ,       25,        1,       24
CVW, 0      , 0      ,        2,        0,        2
CVY, 0.1    , 0.01   ,       10,        1,        9
CV_, 0      , 0      ,        1,        0,        1
CWC, 0      , 0      ,        1,        0,        1
CWD, 0.4    , 0.16   ,        5,        2,        3
CWE, 0      , 0      ,        8,        0,        8
CWF, 0      , 0      ,        2,        0,        2
CWG, 0      , 0      ,        5,        0,        5
CWH, 0      , 0      ,        1,        0,        1
CWI, 0      , 0      ,        6,        0,        6
CWL, 0.28571, 0.08163,        7,        2,        5
CWM, 0      , 0      ,        2,        0,        2
CWN, 0      , 0      ,        4,        0,        4
CWP, 0.2    , 0.04   ,       10,        2,        8
CWQ, 0      , 0      ,        2,        0,        2
CWR, 0.16667, 0.02778,        6,        1,        5
CWS, 0.16667, 0.02778,        6,        1,        5
CWT, 1      , 1      ,        2,        2,        0
CWW, 0      , 0      ,        2,        0,        2
CWY, 0      , 0      ,        4,        0,        4
CYC, 0.2    , 0.04   ,        5,        1,        4
CYD, 0.25   , 0.0625 ,       20,        5,       15
CYE, 0.2    , 0.04   ,       15,        3,       12
CYF, 0      , 0      ,        5,        0,        5
CYG, 0.17391, 0.03025,       23,        4,       19
CYH, 0      , 0      ,        7,        0,        7
CYI, 0.22222, 0.04938,        9,        2,        7
CYK, 0.13333, 0.01778,       15,        2,       13
CYL, 0.19048, 0.03628,       21,        4,       17
CYM, 0.14286, 0.02041,        7,        1,        6
CYN, 0.23529, 0.05536,       17,        4,       13
CYP, 0.18182, 0.03306,       11,        2,        9
CYQ, 0      , 0      ,       15,        0,       15
CYR, 0.09091, 0.00826,       11,        1,       10
CYS, 0.4    , 0.16   ,       20,        8,       12
CYT, 0.16667, 0.02778,       12,        2,       10
CYV, 0.2    , 0.04   ,       25,        5,       20
CYW, 0      , 0      ,        8,        0,        8
CYY, 0.07143, 0.0051 ,       14,        1,       13
CY_, 0      , 0      ,        1,        0,        1
DAD, 0      , 0      ,       32,        0,       32
DAE, 0.04651, 0.00216,       86,        4,       82
DAF, 0.05556, 0.00309,       54,        3,       51
DAG, 0.06977, 0.00487,       86,        6,       80
DAH, 0.04348, 0.00189,       23,        1,       22
DAI, 0.07407, 0.00549,       81,        6,       75
DAK, 0.04478, 0.002  ,       67,        3,       64
DAL, 0.04274, 0.00183,      117,        5,      112
DAM, 0      , 0      ,       33,        0,       33
DAN, 0.05357, 0.00287,       56,        3,       53
DAP, 0.03448, 0.00119,       58,        2,       56
DAQ, 0.07317, 0.00535,       41,        3,       38
DAR, 0.03704, 0.00137,       54,        2,       52
DAS, 0.02469, 0.00061,       81,        2,       79
DAT, 0.07042, 0.00496,       71,        5,       66
DAV, 0.02083, 0.00043,       96,        2,       94
DAW, 0      , 0      ,       13,        0,       13
DAY, 0.02326, 0.00054,       43,        1,       42
DA_, 0      , 0      ,        8,        0,        8
DCD, 0.25   , 0.0625 ,        8,        2,        6
DCE, 0      , 0      ,       19,        0,       19
DCF, 0.11111, 0.01235,       18,        2,       16
DCG, 0.14286, 0.02041,       35,        5,       30
DCH, 0      , 0      ,        3,        0,        3
DCI, 0.09091, 0.00826,       11,        1,       10
DCK, 0.125  , 0.01562,       16,        2,       14
DCL, 0.02857, 0.00082,       35,        1,       34
DCM, 0      , 0      ,        9,        0,        9
DCN, 0      , 0      ,        5,        0,        5
DCP, 0      , 0      ,       14,        0,       14
DCQ, 0.1    , 0.01   ,       10,        1,        9
DCR, 0      , 0      ,       16,        0,       16
DCS, 0.04348, 0.00189,       23,        1,       22
DCT, 0.06667, 0.00444,       15,        1,       14
DCV, 0.11538, 0.01331,       26,        3,       23
DCW, 0.25   , 0.0625 ,        4,        1,        3
DCY, 0      , 0      ,       10,        0,       10
DDD, 0.15686, 0.02461,       51,        8,       43
DDE, 0.08219, 0.00676,       73,        6,       67
DDF, 0.0678 , 0.0046 ,       59,        4,       55
DDG, 0.10843, 0.01176,       83,        9,       74
DDH, 0.10526, 0.01108,       19,        2,       17
DDI, 0.11842, 0.01402,       76,        9,       67
DDK, 0.03125, 0.00098,       64,        2,       62
DDL, 0.02174, 0.00047,      138,        3,      135
DDM, 0.16   , 0.0256 ,       25,        4,       21
DDN, 0.09302, 0.00865,       43,        4,       39
DDP, 0.03175, 0.00101,       63,        2,       61
DDQ, 0.07317, 0.00535,       41,        3,       38
DDR, 0.07143, 0.0051 ,       42,        3,       39
DDS, 0.0814 , 0.00663,       86,        7,       79
DDT, 0.03125, 0.00098,       64,        2,       62
DDV, 0.06494, 0.00422,       77,        5,       72
DDW, 0.04545, 0.00207,       22,        1,       21
DDY, 0.16667, 0.02778,       54,        9,       45
DD_, 0      , 0      ,        3,        0,        3
DED, 0.02857, 0.00082,       35,        1,       34
DEE, 0.02703, 0.00073,      111,        3,      108
DEF, 0.08065, 0.0065 ,       62,        5,       57
DEG, 0.04545, 0.00207,       88,        4,       84
DEH, 0.14286, 0.02041,       35,        5,       30
DEI, 0.08889, 0.0079 ,       90,        8,       82
DEK, 0.03191, 0.00102,       94,        3,       91
DEL, 0.04636, 0.00215,      151,        7,      144
DEM, 0.02778, 0.00077,       36,        1,       35
DEN, 0.08434, 0.00711,       83,        7,       76
DEP, 0.04255, 0.00181,       94,        4,       90
DEQ, 0.07692, 0.00592,       52,        4,       48
DER, 0.04839, 0.00234,       62,        3,       59
DES, 0.06667, 0.00444,       90,        6,       84
DET, 0.04494, 0.00202,       89,        4,       85
DEV, 0.05755, 0.00331,      139,        8,      131
DEW, 0.08333, 0.00694,       24,        2,       22
DEY, 0.08621, 0.00743,       58,        5,       53
DE_, 0.07692, 0.00592,       13,        1,       12
DFD, 0.03448, 0.00119,       29,        1,       28
DFE, 0.09756, 0.00952,       41,        4,       37
DFF, 0.02439, 0.00059,       41,        1,       40
DFG, 0.12698, 0.01612,       63,        8,       55
DFH, 0.14286, 0.02041,       21,        3,       18
DFI, 0.08511, 0.00724,       47,        4,       43
DFK, 0.07143, 0.0051 ,       56,        4,       52
DFL, 0.15116, 0.02285,       86,       13,       73
DFM, 0.14815, 0.02195,       27,        4,       23
DFN, 0.14583, 0.02127,       48,        7,       41
DFP, 0      , 0      ,       43,        0,       43
DFQ, 0.125  , 0.01562,       40,        5,       35
DFR, 0      , 0      ,       37,        0,       37
DFS, 0.07812, 0.0061 ,       64,        5,       59
DFT, 0.08   , 0.0064 ,       50,        4,       46
DFV, 0.10204, 0.01041,       49,        5,       44
DFW, 0.11111, 0.01235,       18,        2,       16
DFY, 0.15385, 0.02367,       26,        4,       22
DF_, 0.25   , 0.0625 ,        4,        1,        3
DGD, 0.04545, 0.00207,       44,        2,       42
DGE, 0.03529, 0.00125,       85,        3,       82
DGF, 0.04348, 0.00189,       69,        3,       66
DGG, 0.12346, 0.01524,       81,       10,       71
DGH, 0.0303 , 0.00092,       33,        1,       32
DGI, 0.02469, 0.00061,       81,        2,       79
DGK, 0.00794, 0.00006,      126,        1,      125
DGL, 0.07826, 0.00612,      115,        9,      106
DGM, 0.03571, 0.00128,       28,        1,       27
DGN, 0.0411 , 0.00169,       73,        3,       70
DGP, 0.03448, 0.00119,       87,        3,       84
DGQ, 0.04   , 0.0016 ,       75,        3,       72
DGR, 0.03093, 0.00096,       97,        3,       94
DGS, 0.05085, 0.00259,      118,        6,      112
DGT, 0.02041, 0.00042,       98,        2,       96
DGV, 0.04211, 0.00177,       95,        4,       91
DGW, 0.16667, 0.02778,       18,        3,       15
DGY, 0.04918, 0.00242,       61,        3,       58
DG_, 0      , 0      ,        1,        0,        1
DHD, 0.09091, 0.00826,       11,        1,       10
DHE, 0.05882, 0.00346,       34,        2,       32
DHF, 0.1    , 0.01   ,       20,        2,       18
DHG, 0.08333, 0.00694,       24,        2,       22
DHH, 0.11111, 0.01235,        9,        1,        8
DHI, 0.07692, 0.00592,       26,        2,       24
DHK, 0.1    , 0.01   ,       20,        2,       18
DHL, 0.01923, 0.00037,       52,        1,       51
DHM, 0.09091, 0.00826,       11,        1,       10
DHN, 0.3    , 0.09   ,       20,        6,       14
DHP, 0.11765, 0.01384,       17,        2,       15
DHQ, 0.06667, 0.00444,       15,        1,       14
DHR, 0.15   , 0.0225 ,       20,        3,       17
DHS, 0      , 0      ,       17,        0,       17
DHT, 0.18182, 0.03306,       22,        4,       18
DHV, 0.23077, 0.05325,       26,        6,       20
DHW, 0      , 0      ,        9,        0,        9
DHY, 0      , 0      ,       24,        0,       24
DH_, 0      , 0      ,        1,        0,        1
DID, 0.08108, 0.00657,       37,        3,       34
DIE, 0.08333, 0.00694,       72,        6,       66
DIF, 0.1    , 0.01   ,       60,        6,       54
DIG, 0.03077, 0.00095,       65,        2,       63
DIH, 0.07143, 0.0051 ,       28,        2,       26
DII, 0.08   , 0.0064 ,       75,        6,       69
DIK, 0.07692, 0.00592,       52,        4,       48
DIL, 0.07246, 0.00525,      138,       10,      128
DIM, 0      , 0      ,       31,        0,       31
DIN, 0.03226, 0.00104,       62,        2,       60
DIP, 0.10714, 0.01148,       56,        6,       50
DIQ, 0.04762, 0.00227,       42,        2,       40
DIR, 0.08   , 0.0064 ,       50,        4,       46
DIS, 0.04762, 0.00227,       63,        3,       60
DIT, 0.12903, 0.01665,       62,        8,       54
DIV, 0.08989, 0.00808,       89,        8,       81
DIW, 0.2    , 0.04   ,       15,        3,       12
DIY, 0.1087 , 0.01181,       46,        5,       41
DI_, 0      , 0      ,        1,        0,        1
DKD, 0      , 0      ,       36,        0,       36
DKE, 0.01905, 0.00036,      105,        2,      103
DKF, 0.04878, 0.00238,       82,        4,       78
DKG, 0.0625 , 0.00391,       96,        6,       90
DKH, 0      , 0      ,       25,        0,       25
DKI, 0.05455, 0.00298,      110,        6,      104
DKK, 0.03797, 0.00144,       79,        3,       76
DKL, 0.05   , 0.0025 ,      160,        8,      152
DKM, 0.03125, 0.00098,       32,        1,       31
DKN, 0      , 0      ,       63,        0,       63
DKP, 0.02899, 0.00084,       69,        2,       67
DKQ, 0.04255, 0.00181,       47,        2,       45
DKR, 0.06452, 0.00416,       62,        4,       58
DKS, 0.03125, 0.00098,       96,        3,       93
DKT, 0.05128, 0.00263,       78,        4,       74
DKV, 0.07207, 0.00519,      111,        8,      103
DKW, 0.07143, 0.0051 ,       28,        2,       26
DKY, 0.03226, 0.00104,       62,        2,       60
DK_, 0      , 0      ,        8,        0,        8
DLD, 0.05172, 0.00268,       58,        3,       55
DLE, 0.06569, 0.00432,      137,        9,      128
DLF, 0.09524, 0.00907,       63,        6,       57
DLG, 0.08421, 0.00709,       95,        8,       87
DLH, 0.09677, 0.00937,       31,        3,       28
DLI, 0.04717, 0.00222,      106,        5,      101
DLK, 0.05785, 0.00335,      121,        7,      114
DLL, 0.08065, 0.0065 ,      186,       15,      171
DLM, 0.04878, 0.00238,       41,        2,       39
DLN, 0.09524, 0.00907,       84,        8,       76
DLP, 0.02299, 0.00053,       87,        2,       85
DLQ, 0.03226, 0.00104,       62,        2,       60
DLR, 0.03448, 0.00119,       87,        3,       84
DLS, 0.03077, 0.00095,      130,        4,      126
DLT, 0.12931, 0.01672,      116,       15,      101
DLV, 0.0458 , 0.0021 ,      131,        6,      125
DLW, 0      , 0      ,       18,        0,       18
DLY, 0.11864, 0.01408,       59,        7,       52
DL_, 0      , 0      ,       14,        0,       14
DMD, 0.09091, 0.00826,       11,        1,       10
DME, 0      , 0      ,       21,        0,       21
DMF, 0.12903, 0.01665,       31,        4,       27
DMG, 0.0625 , 0.00391,       32,        2,       30
DMH, 0.0625 , 0.00391,       16,        1,       15
DMI, 0.11111, 0.01235,       27,        3,       24
DMK, 0      , 0      ,       22,        0,       22
DML, 0.07692, 0.00592,       39,        3,       36
DMM, 0.07143, 0.0051 ,       14,        1,       13
DMN, 0      , 0      ,       22,        0,       22
DMP, 0      , 0      ,       12,        0,       12
DMQ, 0.125  , 0.01562,       16,        2,       14
DMR, 0.125  , 0.01562,       16,        2,       14
DMS, 0.19231, 0.03698,       26,        5,       21
DMT, 0.11538, 0.01331,       26,        3,       23
DMV, 0.06452, 0.00416,       31,        2,       29
DMW, 0.09091, 0.00826,       11,        1,       10
DMY, 0.30769, 0.09467,       13,        4,        9
DM_, 0      , 0      ,       12,        0,       12
DND, 0.03704, 0.00137,       27,        1,       26
DNE, 0.10448, 0.01092,       67,        7,       60
DNF, 0.02273, 0.00052,       44,        1,       43
DNG, 0.07407, 0.00549,       54,        4,       50
DNH, 0.1    , 0.01   ,       20,        2,       18
DNI, 0.06452, 0.00416,       62,        4,       58
DNK, 0.0625 , 0.00391,       48,        3,       45
DNL, 0.04301, 0.00185,       93,        4,       89
DNM, 0.04348, 0.00189,       23,        1,       22
DNN, 0      , 0      ,       23,        0,       23
DNP, 0.02041, 0.00042,       49,        1,       48
DNQ, 0      , 0      ,       26,        0,       26
DNR, 0.02632, 0.00069,       38,        1,       37
DNS, 0.07273, 0.00529,       55,        4,       51
DNT, 0.04615, 0.00213,       65,        3,       62
DNV, 0.05714, 0.00327,       70,        4,       66
DNW, 0.05263, 0.00277,       19,        1,       18
DNY, 0      , 0      ,       36,        0,       36
DN_, 0      , 0      ,        2,        0,        2
DPD, 0.09524, 0.00907,       42,        4,       38
DPE, 0      , 0      ,       73,        0,       73
DPF, 0.08   , 0.0064 ,       50,        4,       46
DPG, 0      , 0      ,       43,        0,       43
DPH, 0      , 0      ,       34,        0,       34
DPI, 0.0339 , 0.00115,       59,        2,       57
DPK, 0.03509, 0.00123,       57,        2,       55
DPL, 0.02128, 0.00045,       94,        2,       92
DPM, 0.10526, 0.01108,       19,        2,       17
DPN, 0.05882, 0.00346,       85,        5,       80
DPP, 0.03448, 0.00119,       58,        2,       56
DPQ, 0.04255, 0.00181,       47,        2,       45
DPR, 0      , 0      ,       84,        0,       84
DPS, 0.02326, 0.00054,       86,        2,       84
DPT, 0.02941, 0.00087,       68,        2,       66
DPV, 0.0641 , 0.00411,       78,        5,       73
DPW, 0      , 0      ,       16,        0,       16
DPY, 0      , 0      ,       53,        0,       53
DP_, 0      , 0      ,        4,        0,        4
DQD, 0.3125 , 0.09766,       16,        5,       11
DQE, 0.07273, 0.00529,       55,        4,       51
DQF, 0      , 0      ,       35,        0,       35
DQG, 0.05172, 0.00268,       58,        3,       55
DQH, 0      , 0      ,       13,        0,       13
DQI, 0.09091, 0.00826,       66,        6,       60
DQK, 0.05714, 0.00327,       35,        2,       33
DQL, 0.0381 , 0.00145,      105,        4,      101
DQM, 0      , 0      ,       20,        0,       20
DQN, 0.06667, 0.00444,       30,        2,       28
DQP, 0.06122, 0.00375,       49,        3,       46
DQQ, 0.03125, 0.00098,       32,        1,       31
DQR, 0      , 0      ,       32,        0,       32
DQS, 0      , 0      ,       42,        0,       42
DQT, 0.05556, 0.00309,       36,        2,       34
DQV, 0.08   , 0.0064 ,       75,        6,       69
DQW, 0      , 0      ,       14,        0,       14
DQY, 0      , 0      ,       34,        0,       34
DQ_, 0      , 0      ,        5,        0,        5
DRD, 0.03333, 0.00111,       30,        1,       29
DRE, 0.05333, 0.00284,       75,        4,       71
DRF, 0.01923, 0.00037,       52,        1,       51
DRG, 0.08219, 0.00676,       73,        6,       67
DRH, 0.05714, 0.00327,       35,        2,       33
DRI, 0.07609, 0.00579,       92,        7,       85
DRK, 0.12698, 0.01612,       63,        8,       55
DRL, 0.0566 , 0.0032 ,      106,        6,      100
DRM, 0      , 0      ,       18,        0,       18
DRN, 0.09302, 0.00865,       43,        4,       39
DRP, 0.02   , 0.0004 ,       50,        1,       49
DRQ, 0.03448, 0.00119,       29,        1,       28
DRR, 0.08571, 0.00735,       35,        3,       32
DRS, 0.11111, 0.01235,       63,        7,       56
DRT, 0.01852, 0.00034,       54,        1,       53
DRV, 0.09783, 0.00957,       92,        9,       83
DRW, 0.27778, 0.07716,       18,        5,       13
DRY, 0.11111, 0.01235,       45,        5,       40
DR_, 0      , 0      ,        2,        0,        2
DSD, 0      , 0      ,       40,        0,       40
DSE, 0.0411 , 0.00169,       73,        3,       70
DSF, 0.06061, 0.00367,       66,        4,       62
DSG, 0.04082, 0.00167,       98,        4,       94
DSH, 0      , 0      ,       20,        0,       20
DSI, 0.05952, 0.00354,       84,        5,       79
DSK, 0.02597, 0.00067,       77,        2,       75
DSL, 0.02516, 0.00063,      159,        4,      155
DSM, 0.125  , 0.01562,       24,        3,       21
DSN, 0.01786, 0.00032,       56,        1,       55
DSP, 0.02857, 0.00082,       70,        2,       68
DSQ, 0.06122, 0.00375,       49,        3,       46
DSR, 0.04918, 0.00242,       61,        3,       58
DSS, 0.13402, 0.01796,       97,       13,       84
DST, 0.06173, 0.00381,       81,        5,       76
DSV, 0.09639, 0.00929,       83,        8,       75
DSW, 0.04348, 0.00189,       23,        1,       22
DSY, 0.02273, 0.00052,       44,        1,       43
DS_, 0.11111, 0.01235,        9,        1,        8
DTD, 0.03448, 0.00119,       29,        1,       28
DTE, 0.03333, 0.00111,       60,        2,       58
DTF, 0.03333, 0.00111,       60,        2,       58
DTG, 0.03797, 0.00144,       79,        3,       76
DTH, 0.08333, 0.00694,       24,        2,       22
DTI, 0.05952, 0.00354,       84,        5,       79
DTK, 0.02041, 0.00042,       49,        1,       48
DTL, 0.03571, 0.00128,      140,        5,      135
DTM, 0.06897, 0.00476,       29,        2,       27
DTN, 0.075  , 0.00562,       40,        3,       37
DTP, 0.02703, 0.00073,       37,        1,       36
DTQ, 0.08   , 0.0064 ,       25,        2,       23
DTR, 0      , 0      ,       40,        0,       40
DTS, 0.07792, 0.00607,       77,        6,       71
DTT, 0.0274 , 0.00075,       73,        2,       71
DTV, 0.03571, 0.00128,       84,        3,       81
DTW, 0.07143, 0.0051 ,       14,        1,       13
DTY, 0.13043, 0.01701,       46,        6,       40
DT_, 0      , 0      ,        1,        0,        1
DVD, 0.05714, 0.00327,       35,        2,       33
DVE, 0.07447, 0.00555,       94,        7,       87
DVF, 0.13725, 0.01884,       51,        7,       44
DVG, 0.06173, 0.00381,       81,        5,       76
DVH, 0.11111, 0.01235,       36,        4,       32
DVI, 0.06122, 0.00375,       98,        6,       92
DVK, 0.10448, 0.01092,       67,        7,       60
DVL, 0.05172, 0.00268,      116,        6,      110
DVM, 0.12   , 0.0144 ,       25,        3,       22
DVN, 0.09836, 0.00967,       61,        6,       55
DVP, 0.0597 , 0.00356,       67,        4,       63
DVQ, 0.02174, 0.00047,       46,        1,       45
DVR, 0.03922, 0.00154,       51,        2,       49
DVS, 0.03704, 0.00137,       81,        3,       78
DVT, 0.06579, 0.00433,       76,        5,       71
DVV, 0.05217, 0.00272,      115,        6,      109
DVW, 0.1875 , 0.03516,       16,        3,       13
DVY, 0.06977, 0.00487,       43,        3,       40
DV_, 0      , 0      ,        6,        0,        6
DWD, 0.05882, 0.00346,       17,        1,       16
DWE, 0.13636, 0.0186 ,       22,        3,       19
DWF, 0.22222, 0.04938,        9,        2,        7
DWG, 0.22222, 0.04938,       18,        4,       14
DWH, 0      , 0      ,        4,        0,        4
DWI, 0.13636, 0.0186 ,       22,        3,       19
DWK, 0.13333, 0.01778,       15,        2,       13
DWL, 0.18182, 0.03306,       33,        6,       27
DWM, 0      , 0      ,        7,        0,        7
DWN, 0.11765, 0.01384,       17,        2,       15
DWP, 0.2    , 0.04   ,       10,        2,        8
DWQ, 0.06667, 0.00444,       15,        1,       14
DWR, 0      , 0      ,       14,        0,       14
DWS, 0.14815, 0.02195,       27,        4,       23
DWT, 0      , 0      ,       17,        0,       17
DWV, 0.13793, 0.01902,       29,        4,       25
DWW, 0.55556, 0.30864,        9,        5,        4
DWY, 0.1    , 0.01   ,       10,        1,        9
DW_, 0.5    , 0.25   ,        2,        1,        1
DYD, 0.04   , 0.0016 ,       25,        1,       24
DYE, 0.13333, 0.01778,       60,        8,       52
DYF, 0.08333, 0.00694,       36,        3,       33
DYG, 0.24138, 0.05826,       58,       14,       44
DYH, 0.17241, 0.02973,       29,        5,       24
DYI, 0.15   , 0.0225 ,       60,        9,       51
DYK, 0.15909, 0.02531,       44,        7,       37
DYL, 0.15842, 0.0251 ,      101,       16,       85
DYM, 0      , 0      ,       15,        0,       15
DYN, 0.1    , 0.01   ,       40,        4,       36
DYP, 0.27027, 0.07305,       37,       10,       27
DYQ, 0.05714, 0.00327,       35,        2,       33
DYR, 0.05263, 0.00277,       38,        2,       36
DYS, 0.08333, 0.00694,       60,        5,       55
DYT, 0.15789, 0.02493,       57,        9,       48
DYV, 0.05357, 0.00287,       56,        3,       53
DYW, 0.0625 , 0.00391,       16,        1,       15
DYY, 0.1875 , 0.03516,       32,        6,       26
DY_, 0      , 0      ,        7,        0,        7
EAE, 0.07246, 0.00525,       69,        5,       64
EAF, 0.13043, 0.01701,       46,        6,       40
EAG, 0.07143, 0.0051 ,       84,        6,       78
EAH, 0.04545, 0.00207,       22,        1,       21
EAI, 0.02299, 0.00053,       87,        2,       85
EAK, 0.075  , 0.00562,       80,        6,       74
EAL, 0.03015, 0.00091,      199,        6,      193
EAM, 0.05714, 0.00327,       35,        2,       33
EAN, 0.02817, 0.00079,       71,        2,       69
EAP, 0.02941, 0.00087,       68,        2,       66
EAQ, 0.05797, 0.00336,       69,        4,       65
EAR, 0.06098, 0.00372,       82,        5,       77
EAS, 0.02817, 0.00079,       71,        2,       69
EAT, 0.04598, 0.00211,       87,        4,       83
EAV, 0.03876, 0.0015 ,      129,        5,      124
EAW, 0.15385, 0.02367,       13,        2,       11
EAY, 0.06122, 0.00375,       49,        3,       46
EA_, 0      , 0      ,        9,        0,        9
ECE, 0.14286, 0.02041,        7,        1,        6
ECF, 0      , 0      ,       12,        0,       12
ECG, 0.03846, 0.00148,       26,        1,       25
ECH, 0.14286, 0.02041,       14,        2,       12
ECI, 0.07692, 0.00592,       13,        1,       12
ECK, 0      , 0      ,       23,        0,       23
ECL, 0.09091, 0.00826,       33,        3,       30
ECM, 0      , 0      ,        9,        0,        9
ECN, 0.14286, 0.02041,       14,        2,       12
ECP, 0      , 0      ,       17,        0,       17
ECQ, 0.05263, 0.00277,       19,        1,       18
ECR, 0.04762, 0.00227,       21,        1,       20
ECS, 0      , 0      ,       22,        0,       22
ECT, 0.07143, 0.0051 ,       14,        1,       13
ECV, 0.06667, 0.00444,       30,        2,       28
ECW, 0      , 0      ,        4,        0,        4
ECY, 0.09091, 0.00826,       11,        1,       10
EC_, 0      , 0      ,        2,        0,        2
EDE, 0.17308, 0.02996,       52,        9,       43
EDF, 0.06061, 0.00367,       66,        4,       62
EDG, 0.05512, 0.00304,      127,        7,      120
EDH, 0.02439, 0.00059,       41,        1,       40
EDI, 0.09524, 0.00907,      126,       12,      114
EDK, 0.03947, 0.00156,       76,        3,       73
EDL, 0.05056, 0.00256,      178,        9,      169
EDM, 0.07843, 0.00615,       51,        4,       47
EDN, 0.12698, 0.01612,       63,        8,       55
EDP, 0.09859, 0.00972,       71,        7,       64
EDQ, 0.1    , 0.01   ,       40,        4,       36
EDR, 0.01493, 0.00022,       67,        1,       66
EDS, 0.03797, 0.00144,       79,        3,       76
EDT, 0.02667, 0.00071,       75,        2,       73
EDV, 0.075  , 0.00562,      120,        9,      111
EDW, 0.05263, 0.00277,       19,        1,       18
EDY, 0.09231, 0.00852,       65,        6,       59
ED_, 0      , 0      ,        4,        0,        4
EEE, 0.05063, 0.00256,       79,        4,       75
EEF, 0.04348, 0.00189,       92,        4,       88
EEG, 0.0438 , 0.00192,      137,        6,      131
EEH, 0.04878, 0.00238,       41,        2,       39
EEI, 0.05556, 0.00309,      144,        8,      136
EEK, 0.01802, 0.00032,      111,        2,      109
EEL, 0.03629, 0.00132,      248,        9,      239
EEM, 0.01754, 0.00031,       57,        1,       56
EEN, 0.02632, 0.00069,       76,        2,       74
EEP, 0.0396 , 0.00157,      101,        4,       97
EEQ, 0.04   , 0.0016 ,       75,        3,       72
EER, 0.0198 , 0.00039,      101,        2,       99
EES, 0.02062, 0.00043,       97,        2,       95
EET, 0.03361, 0.00113,      119,        4,      115
EEV, 0.05755, 0.00331,      139,        8,      131
EEW, 0.1    , 0.01   ,       30,        3,       27
EEY, 0.07353, 0.00541,       68,        5,       63
EE_, 0.09091, 0.00826,       11,        1,       10
EFE, 0.08333, 0.00694,       36,        3,       33
EFF, 0.07895, 0.00623,       38,        3,       35
EFG, 0.06667, 0.00444,       45,        3,       42
EFH, 0.16667, 0.02778,       12,        2,       10
EFI, 0.09804, 0.00961,       51,        5,       46
EFK, 0.12308, 0.01515,       65,        8,       57
EFL, 0.11905, 0.01417,       84,       10,       74
EFM, 0.13333, 0.01778,       15,        2,       13
EFN, 0.13514, 0.01826,       37,        5,       32
EFP, 0.0625 , 0.00391,       32,        2,       30
EFQ, 0.13889, 0.01929,       36,        5,       31
EFR, 0.08333, 0.00694,       48,        4,       44
EFS, 0.13235, 0.01752,       68,        9,       59
EFT, 0.01724, 0.0003 ,       58,        1,       57
EFV, 0.12857, 0.01653,       70,        9,       61
EFW, 0.125  , 0.01562,       16,        2,       14
EFY, 0.08333, 0.00694,       24,        2,       22
EGE, 0      , 0      ,       51,        0,       51
EGF, 0.03333, 0.00111,       60,        2,       58
EGG, 0.05607, 0.00314,      107,        6,      101
EGH, 0.03226, 0.00104,       31,        1,       30
EGI, 0.04762, 0.00227,       63,        3,       60
EGK, 0.02913, 0.00085,      103,        3,      100
EGL, 0.03488, 0.00122,      172,        6,      166
EGM, 0.05263, 0.00277,       38,        2,       36
EGN, 0.02817, 0.00079,       71,        2,       69
EGP, 0.02532, 0.00064,       79,        2,       77
EGQ, 0.06349, 0.00403,       63,        4,       59
EGR, 0      , 0      ,       78,        0,       78
EGS, 0.04124, 0.0017 ,       97,        4,       93
EGT, 0.03488, 0.00122,       86,        3,       83
EGV, 0.02174, 0.00047,       92,        2,       90
EGW, 0.08333, 0.00694,       24,        2,       22
EGY, 0.03509, 0.00123,       57,        2,       55
EG_, 0      , 0      ,        6,        0,        6
EHE, 0      , 0      ,       13,        0,       13
EHF, 0.14286, 0.02041,       14,        2,       12
EHG, 0.05714, 0.00327,       35,        2,       33
EHH, 0.09524, 0.00907,       21,        2,       19
EHI, 0.06061, 0.00367,       33,        2,       31
EHK, 0.12121, 0.01469,       33,        4,       29
EHL, 0.07937, 0.0063 ,       63,        5,       58
EHM, 0.125  , 0.01562,       16,        2,       14
EHN, 0.03448, 0.00119,       29,        1,       28
EHP, 0.08333, 0.00694,       36,        3,       33
EHQ, 0.10526, 0.01108,       19,        2,       17
EHR, 0      , 0      ,       21,        0,       21
EHS, 0.17391, 0.03025,       23,        4,       19
EHT, 0.26087, 0.06805,       23,        6,       17
EHV, 0.05   , 0.0025 ,       40,        2,       38
EHW, 0      , 0      ,        7,        0,        7
EHY, 0.03846, 0.00148,       26,        1,       25
EH_, 0      , 0      ,        4,        0,        4
EIE, 0.04878, 0.00238,       41,        2,       39
EIF, 0.16129, 0.02601,       31,        5,       26
EIG, 0.04545, 0.00207,       88,        4,       84
EIH, 0      , 0      ,       22,        0,       22
EII, 0.0625 , 0.00391,       64,        4,       60
EIK, 0.07595, 0.00577,       79,        6,       73
EIL, 0.07627, 0.00582,      118,        9,      109
EIM, 0.16667, 0.02778,       24,        4,       20
EIN, 0.05   , 0.0025 ,       60,        3,       57
EIP, 0.05882, 0.00346,       68,        4,       64
EIQ, 0.14   , 0.0196 ,       50,        7,       43
EIR, 0.06557, 0.0043 ,       61,        4,       57
EIS, 0.11268, 0.0127 ,       71,        8,       63
EIT, 0.02941, 0.00087,       68,        2,       66
EIV, 0.04348, 0.00189,       69,        3,       66
EIW, 0      , 0      ,       16,        0,       16
EIY, 0.02703, 0.00073,       37,        1,       36
EI_, 0      , 0      ,        3,        0,        3
EKE, 0.04211, 0.00177,       95,        4,       91
EKF, 0.05   , 0.0025 ,       80,        4,       76
EKG, 0.01869, 0.00035,      107,        2,      105
EKH, 0      , 0      ,       33,        0,       33
EKI, 0.06452, 0.00416,      124,        8,      116
EKK, 0.06061, 0.00367,       99,        6,       93
EKL, 0.05714, 0.00327,      245,       14,      231
EKM, 0.05797, 0.00336,       69,        4,       65
EKN, 0.05634, 0.00317,       71,        4,       67
EKP, 0.0122 , 0.00015,       82,        1,       81
EKQ, 0.05263, 0.00277,       57,        3,       54
EKR, 0.0125 , 0.00016,       80,        1,       79
EKS, 0.02857, 0.00082,       70,        2,       68
EKT, 0.0202 , 0.00041,       99,        2,       97
EKV, 0.04878, 0.00238,      123,        6,      117
EKW, 0.08333, 0.00694,       24,        2,       22
EKY, 0.07895, 0.00623,       76,        6,       70
EK_, 0      , 0      ,        7,        0,        7
ELE, 0.06557, 0.0043 ,       61,        4,       57
ELF, 0.07353, 0.00541,       68,        5,       63
ELG, 0.1129 , 0.01275,      124,       14,      110
ELH, 0.04255, 0.00181,       47,        2,       45
ELI, 0.05   , 0.0025 ,      140,        7,      133
ELK, 0.064  , 0.0041 ,      125,        8,      117
ELL, 0.04186, 0.00175,      215,        9,      206
ELM, 0.04167, 0.00174,       72,        3,       69
ELN, 0.03896, 0.00152,       77,        3,       74
ELP, 0.04301, 0.00185,       93,        4,       89
ELQ, 0.06897, 0.00476,       87,        6,       81
ELR, 0.04301, 0.00185,       93,        4,       89
ELS, 0.06667, 0.00444,      120,        8,      112
ELT, 0.04386, 0.00192,      114,        5,      109
ELV, 0.06993, 0.00489,      143,       10,      133
ELW, 0      , 0      ,       13,        0,       13
ELY, 0.05556, 0.00309,       72,        4,       68
EL_, 0      , 0      ,        8,        0,        8
EME, 0.05   , 0.0025 ,       20,        1,       19
EMF, 0.05263, 0.00277,       19,        1,       18
EMG, 0.10811, 0.01169,       37,        4,       33
EMH, 0.23077, 0.05325,       13,        3,       10
EMI, 0.21212, 0.045  ,       33,        7,       26
EMK, 0.03125, 0.00098,       32,        1,       31
EML, 0.05769, 0.00333,       52,        3,       49
EMM, 0      , 0      ,       10,        0,       10
EMN, 0.07407, 0.00549,       27,        2,       25
EMP, 0.125  , 0.01562,       16,        2,       14
EMQ, 0.04167, 0.00174,       24,        1,       23
EMR, 0.14815, 0.02195,       27,        4,       23
EMS, 0.06452, 0.00416,       31,        2,       29
EMT, 0.07692, 0.00592,       26,        2,       24
EMV, 0.02439, 0.00059,       41,        1,       40
EMW, 0      , 0      ,        3,        0,        3
EMY, 0      , 0      ,       13,        0,       13
EM_, 0.14286, 0.02041,       14,        2,       12
ENE, 0.02222, 0.00049,       45,        1,       44
ENF, 0.01449, 0.00021,       69,        1,       68
ENG, 0.03093, 0.00096,       97,        3,       94
ENH, 0.0625 , 0.00391,       16,        1,       15
ENI, 0.04854, 0.00236,      103,        5,       98
ENK, 0.05882, 0.00346,       68,        4,       64
ENL, 0.05147, 0.00265,      136,        7,      129
ENM, 0.08571, 0.00735,       35,        3,       32
ENN, 0.02381, 0.00057,       42,        1,       41
ENP, 0.08475, 0.00718,       59,        5,       54
ENQ, 0.13514, 0.01826,       37,        5,       32
ENR, 0.02041, 0.00042,       49,        1,       48
ENS, 0.03448, 0.00119,       58,        2,       56
ENT, 0.03704, 0.00137,       54,        2,       52
ENV, 0.02439, 0.00059,       82,        2,       80
ENW, 0      , 0      ,       20,        0,       20
ENY, 0.04762, 0.00227,       42,        2,       40
EN_, 0      , 0      ,        7,        0,        7
EPE, 0      , 0      ,       34,        0,       34
EPF, 0.08929, 0.00797,       56,        5,       51
EPG, 0.01351, 0.00018,       74,        1,       73
EPH, 0.03125, 0.00098,       32,        1,       31
EPI, 0.09091, 0.00826,       77,        7,       70
EPK, 0.0137 , 0.00019,       73,        1,       72
EPL, 0.02941, 0.00087,      136,        4,      132
EPM, 0.09524, 0.00907,       21,        2,       19
EPN, 0      , 0      ,       61,        0,       61
EPP, 0.07576, 0.00574,       66,        5,       61
EPQ, 0      , 0      ,       55,        0,       55
EPR, 0.01695, 0.00029,       59,        1,       58
EPS, 0.02105, 0.00044,       95,        2,       93
EPT, 0.02632, 0.00069,       76,        2,       74
EPV, 0.08696, 0.00756,       92,        8,       84
EPW, 0.05   , 0.0025 ,       20,        1,       19
EPY, 0.04444, 0.00198,       45,        2,       43
EP_, 0      , 0      ,        8,        0,        8
EQE, 0      , 0      ,       33,        0,       33
EQF, 0.05172, 0.00268,       58,        3,       55
EQG, 0.07143, 0.0051 ,       56,        4,       52
EQH, 0.04348, 0.00189,       23,        1,       22
EQI, 0.01266, 0.00016,       79,        1,       78
EQK, 0.03279, 0.00107,       61,        2,       59
EQL, 0.05988, 0.00359,      167,       10,      157
EQM, 0.05   , 0.0025 ,       40,        2,       38
EQN, 0      , 0      ,       44,        0,       44
EQP, 0.09091, 0.00826,       44,        4,       40
EQQ, 0.16216, 0.0263 ,       37,        6,       31
EQR, 0.01887, 0.00036,       53,        1,       52
EQS, 0.12245, 0.01499,       49,        6,       43
EQT, 0      , 0      ,       30,        0,       30
EQV, 0.08642, 0.00747,       81,        7,       74
EQW, 0.14286, 0.02041,       21,        3,       18
EQY, 0.06383, 0.00407,       47,        3,       44
EQ_, 0      , 0      ,        9,        0,        9
ERE, 0.06383, 0.00407,       47,        3,       44
ERF, 0.03279, 0.00107,       61,        2,       59
ERG, 0.1    , 0.01   ,       60,        6,       54
ERH, 0      , 0      ,       27,        0,       27
ERI, 0.16505, 0.02724,      103,       17,       86
ERK, 0      , 0      ,       66,        0,       66
ERL, 0.07273, 0.00529,      165,       12,      153
ERM, 0      , 0      ,       33,        0,       33
ERN, 0.08163, 0.00666,       49,        4,       45
ERP, 0.06944, 0.00482,       72,        5,       67
ERQ, 0.06   , 0.0036 ,       50,        3,       47
ERR, 0.07937, 0.0063 ,       63,        5,       58
ERS, 0.09302, 0.00865,       86,        8,       78
ERT, 0.05634, 0.00317,       71,        4,       67
ERV, 0.09023, 0.00814,      133,       12,      121
ERW, 0      , 0      ,       20,        0,       20
ERY, 0.04167, 0.00174,       48,        2,       46
ER_, 0      , 0      ,        3,        0,        3
ESE, 0.11429, 0.01306,       35,        4,       31
ESF, 0.09091, 0.00826,       66,        6,       60
ESG, 0.01136, 0.00013,       88,        1,       87
ESH, 0.15385, 0.02367,       26,        4,       22
ESI, 0.04478, 0.002  ,       67,        3,       64
ESK, 0.05405, 0.00292,       74,        4,       70
ESL, 0.01571, 0.00025,      191,        3,      188
ESM, 0.12121, 0.01469,       33,        4,       29
ESN, 0.05172, 0.00268,       58,        3,       55
ESP, 0.03226, 0.00104,       62,        2,       60
ESQ, 0      , 0      ,       55,        0,       55
ESR, 0.0339 , 0.00115,       59,        2,       57
ESS, 0.06667, 0.00444,       90,        6,       84
EST, 0.10526, 0.01108,       57,        6,       51
ESV, 0.02247, 0.0005 ,       89,        2,       87
ESW, 0.04167, 0.00174,       24,        1,       23
ESY, 0.04348, 0.00189,       46,        2,       44
ES_, 0.13333, 0.01778,       15,        2,       13
ETE, 0      , 0      ,       32,        0,       32
ETF, 0.04082, 0.00167,       49,        2,       47
ETG, 0      , 0      ,      101,        0,      101
ETH, 0      , 0      ,       24,        0,       24
ETI, 0.13043, 0.01701,       92,       12,       80
ETK, 0.06557, 0.0043 ,       61,        4,       57
ETL, 0.04516, 0.00204,      155,        7,      148
ETM, 0.0303 , 0.00092,       33,        1,       32
ETN, 0.04255, 0.00181,       47,        2,       45
ETP, 0      , 0      ,       56,        0,       56
ETQ, 0      , 0      ,       39,        0,       39
ETR, 0.05263, 0.00277,       57,        3,       54
ETS, 0.06557, 0.0043 ,       61,        4,       57
ETT, 0.01695, 0.00029,       59,        1,       58
ETV, 0.03061, 0.00094,       98,        3,       95
ETW, 0.19048, 0.03628,       21,        4,       17
ETY, 0.08571, 0.00735,       35,        3,       32
ET_, 0.14286, 0.02041,        7,        1,        6
EVE, 0.04615, 0.00213,       65,        3,       62
EVF, 0.05882, 0.00346,       68,        4,       64
EVG, 0.03529, 0.00125,       85,        3,       82
EVH, 0.05263, 0.00277,       19,        1,       18
EVI, 0.03191, 0.00102,       94,        3,       91
EVK, 0.04225, 0.00179,       71,        3,       68
EVL, 0.02878, 0.00083,      139,        4,      135
EVM, 0.03125, 0.00098,       32,        1,       31
EVN, 0.04615, 0.00213,       65,        3,       62
EVP, 0.06757, 0.00457,       74,        5,       69
EVQ, 0      , 0      ,       58,        0,       58
EVR, 0.03125, 0.00098,       64,        2,       62
EVS, 0.08333, 0.00694,       84,        7,       77
EVT, 0.06742, 0.00454,       89,        6,       83
EVV, 0.06504, 0.00423,      123,        8,      115
EVW, 0.05882, 0.00346,       17,        1,       16
EVY, 0.13636, 0.0186 ,       44,        6,       38
EV_, 0      , 0      ,        4,        0,        4
EWE, 0      , 0      ,        5,        0,        5
EWF, 0.375  , 0.14062,       16,        6,       10
EWG, 0.09375, 0.00879,       32,        3,       29
EWH, 0.14286, 0.02041,        7,        1,        6
EWI, 0.08696, 0.00756,       23,        2,       21
EWK, 0.14286, 0.02041,       28,        4,       24
EWL, 0.03448, 0.00119,       29,        1,       28
EWM, 0.25   , 0.0625 ,        8,        2,        6
EWN, 0.25   , 0.0625 ,       12,        3,        9
EWP, 0.14286, 0.02041,       14,        2,       12
EWQ, 0.45455, 0.20661,       11,        5,        6
EWR, 0.11538, 0.01331,       26,        3,       23
EWS, 0.14286, 0.02041,       14,        2,       12
EWT, 0.16   , 0.0256 ,       25,        4,       21
EWV, 0.11111, 0.01235,       27,        3,       24
EWW, 0.375  , 0.14062,        8,        3,        5
EWY, 0.125  , 0.01562,       16,        2,       14
EYE, 0.04   , 0.0016 ,       25,        1,       24
EYF, 0.08333, 0.00694,       36,        3,       33
EYG, 0.10169, 0.01034,       59,        6,       53
EYH, 0.13043, 0.01701,       23,        3,       20
EYI, 0.03774, 0.00142,       53,        2,       51
EYK, 0.13462, 0.01812,       52,        7,       45
EYL, 0.09524, 0.00907,       84,        8,       76
EYM, 0.11111, 0.01235,       18,        2,       16
EYN, 0      , 0      ,       33,        0,       33
EYP, 0.16667, 0.02778,       30,        5,       25
EYQ, 0.08333, 0.00694,       24,        2,       22
EYR, 0.07143, 0.0051 ,       42,        3,       39
EYS, 0.04348, 0.00189,       46,        2,       44
EYT, 0.22222, 0.04938,       45,       10,       35
EYV, 0.09091, 0.00826,       55,        5,       50
EYW, 0.06667, 0.00444,       15,        1,       14
EYY, 0.18919, 0.03579,       37,        7,       30
EY_, 0      , 0      ,        6,        0,        6
FAF, 0.3125 , 0.09766,       16,        5,       11
FAG, 0.08772, 0.00769,       57,        5,       52
FAH, 0      , 0      ,       13,        0,       13
FAI, 0.13514, 0.01826,       37,        5,       32
FAK, 0.02899, 0.00084,       69,        2,       67
FAL, 0.08511, 0.00724,       47,        4,       43
FAM, 0.10526, 0.01108,       19,        2,       17
FAN, 0.08889, 0.0079 ,       45,        4,       41
FAP, 0.01923, 0.00037,       52,        1,       51
FAQ, 0.0303 , 0.00092,       33,        1,       32
FAR, 0.04167, 0.00174,       48,        2,       46
FAS, 0.05172, 0.00268,       58,        3,       55
FAT, 0.10811, 0.01169,       37,        4,       33
FAV, 0.02632, 0.00069,       38,        1,       37
FAW, 0.33333, 0.11111,        6,        2,        4
FAY, 0      , 0      ,       17,        0,       17
FA_, 0      , 0      ,        4,        0,        4
FCF, 0.5    , 0.25   ,        2,        1,        1
FCG, 0      , 0      ,       16,        0,       16
FCH, 0      , 0      ,        7,        0,        7
FCI, 0      , 0      ,        3,        0,        3
FCK, 0      , 0      ,       14,        0,       14
FCL, 0      , 0      ,       17,        0,       17
FCM, 0      , 0      ,        2,        0,        2
FCN, 0      , 0      ,       12,        0,       12
FCP, 0      , 0      ,       20,        0,       20
FCQ, 0      , 0      ,        6,        0,        6
FCR, 0.1    , 0.01   ,       10,        1,        9
FCS, 0      , 0      ,       14,        0,       14
FCT, 0.08333, 0.00694,       12,        1,       11
FCV, 0.18182, 0.03306,       11,        2,        9
FCW, 0      , 0      ,        3,        0,        3
FCY, 0.14286, 0.02041,       14,        2,       12
FDF, 0.16   , 0.0256 ,       25,        4,       21
FDG, 0.0274 , 0.00075,       73,        2,       71
FDH, 0.05   , 0.0025 ,       20,        1,       19
FDI, 0.01887, 0.00036,       53,        1,       52
FDK, 0.04   , 0.0016 ,       75,        3,       72
FDL, 0.08046, 0.00647,       87,        7,       80
FDM, 0.05   , 0.0025 ,       20,        1,       19
FDN, 0.04545, 0.00207,       44,        2,       42
FDP, 0.04167, 0.00174,       48,        2,       46
FDQ, 0.05128, 0.00263,       39,        2,       37
FDR, 0.0625 , 0.00391,       48,        3,       45
FDS, 0.07692, 0.00592,       65,        5,       60
FDT, 0.05333, 0.00284,       75,        4,       71
FDV, 0.08219, 0.00676,       73,        6,       67
FDW, 0.125  , 0.01562,       16,        2,       14
FDY, 0      , 0      ,       26,        0,       26
FD_, 0      , 0      ,       10,        0,       10
FEF, 0.08696, 0.00756,       23,        2,       21
FEG, 0.05479, 0.003  ,       73,        4,       69
FEH, 0.03846, 0.00148,       26,        1,       25
FEI, 0.14286, 0.02041,       49,        7,       42
FEK, 0.08163, 0.00666,       98,        8,       90
FEL, 0.03704, 0.00137,       81,        3,       78
FEM, 0.14286, 0.02041,       28,        4,       24
FEN, 0.09756, 0.00952,       41,        4,       37
FEP, 0.01724, 0.0003 ,       58,        1,       57
FEQ, 0.02174, 0.00047,       46,        1,       45
FER, 0.03279, 0.00107,       61,        2,       59
FES, 0.08333, 0.00694,       60,        5,       55
FET, 0.03704, 0.00137,       54,        2,       52
FEV, 0.04412, 0.00195,       68,        3,       65
FEW, 0.125  , 0.01562,        8,        1,        7
FEY, 0.1    , 0.01   ,       30,        3,       27
FE_, 0      , 0      ,        5,        0,        5
FFF, 0.09091, 0.00826,       11,        1,       10
FFG, 0.08333, 0.00694,       36,        3,       33
FFH, 0.28571, 0.08163,       14,        4,       10
FFI, 0.07407, 0.00549,       27,        2,       25
FFK, 0.03571, 0.00128,       28,        1,       27
FFL, 0.17143, 0.02939,       35,        6,       29
FFM, 0.08333, 0.00694,       12,        1,       11
FFN, 0.12903, 0.01665,       31,        4,       27
FFP, 0.16129, 0.02601,       31,        5,       26
FFQ, 0.11765, 0.01384,       17,        2,       15
FFR, 0.18182, 0.03306,       33,        6,       27
FFS, 0.05405, 0.00292,       37,        2,       35
FFT, 0.11111, 0.01235,       27,        3,       24
FFV, 0.11538, 0.01331,       26,        3,       23
FFW, 0      , 0      ,        5,        0,        5
FFY, 0.07692, 0.00592,       13,        1,       12
FGF, 0.10526, 0.01108,       19,        2,       17
FGG, 0.15686, 0.02461,       51,        8,       43
FGH, 0.05882, 0.00346,       17,        1,       16
FGI, 0.02857, 0.00082,       35,        1,       34
FGK, 0.04688, 0.0022 ,       64,        3,       61
FGL, 0.18293, 0.03346,       82,       15,       67
FGM, 0      , 0      ,       12,        0,       12
FGN, 0.025  , 0.00063,       40,        1,       39
FGP, 0.04651, 0.00216,       43,        2,       41
FGQ, 0.02703, 0.00073,       37,        1,       36
FGR, 0.15385, 0.02367,       39,        6,       33
FGS, 0.05634, 0.00317,       71,        4,       67
FGT, 0.06122, 0.00375,       49,        3,       46
FGV, 0.1    , 0.01   ,       40,        4,       36
FGW, 0.2    , 0.04   ,       10,        2,        8
FGY, 0.19444, 0.03781,       36,        7,       29
FG_, 0      , 0      ,        3,        0,        3
FHF, 0      , 0      ,       12,        0,       12
FHG, 0.06897, 0.00476,       29,        2,       27
FHH, 0      , 0      ,        8,        0,        8
FHI, 0.17391, 0.03025,       23,        4,       19
FHK, 0.03846, 0.00148,       26,        1,       25
FHL, 0.10256, 0.01052,       39,        4,       35
FHM, 0.08333, 0.00694,       12,        1,       11
FHN, 0.13333, 0.01778,       15,        2,       13
FHP, 0.09524, 0.00907,       21,        2,       19
FHQ, 0.09677, 0.00937,       31,        3,       28
FHR, 0.03333, 0.00111,       30,        1,       29
FHS, 0.05882, 0.00346,       34,        2,       32
FHT, 0.04348, 0.00189,       23,        1,       22
FHV, 0.11538, 0.01331,       26,        3,       23
FHY, 0      , 0      ,       20,        0,       20
FIF, 0.11765, 0.01384,       17,        2,       15
FIG, 0.14634, 0.02142,       41,        6,       35
FIH, 0.0625 , 0.00391,       16,        1,       15
FII, 0.03448, 0.00119,       29,        1,       28
FIK, 0.02128, 0.00045,       47,        1,       46
FIL, 0.04762, 0.00227,       42,        2,       40
FIM, 0.06667, 0.00444,       15,        1,       14
FIN, 0.15217, 0.02316,       46,        7,       39
FIP, 0.03333, 0.00111,       30,        1,       29
FIQ, 0.0625 , 0.00391,       32,        2,       30
FIR, 0      , 0      ,       32,        0,       32
FIS, 0      , 0      ,       37,        0,       37
FIT, 0      , 0      ,       42,        0,       42
FIV, 0.08824, 0.00779,       34,        3,       31
FIW, 0      , 0      ,        1,        0,        1
FIY, 0.17647, 0.03114,       17,        3,       14
FI_, 0      , 0      ,        1,        0,        1
FKF, 0.16667, 0.02778,       12,        2,       10
FKG, 0.07937, 0.0063 ,       63,        5,       58
FKH, 0.10526, 0.01108,       19,        2,       17
FKI, 0.03125, 0.00098,       64,        2,       62
FKK, 0.05   , 0.0025 ,       60,        3,       57
FKL, 0.05405, 0.00292,       74,        4,       70
FKM, 0.07692, 0.00592,       13,        1,       12
FKN, 0.07547, 0.0057 ,       53,        4,       49
FKP, 0.10345, 0.0107 ,       29,        3,       26
FKQ, 0.03774, 0.00142,       53,        2,       51
FKR, 0.08511, 0.00724,       47,        4,       43
FKS, 0.08772, 0.00769,       57,        5,       52
FKT, 0.11364, 0.01291,       44,        5,       39
FKV, 0.14943, 0.02233,       87,       13,       74
FKW, 0      , 0      ,        9,        0,        9
FKY, 0.04651, 0.00216,       43,        2,       41
FK_, 0      , 0      ,        4,        0,        4
FLF, 0.07692, 0.00592,       13,        1,       12
FLG, 0.06757, 0.00457,       74,        5,       69
FLH, 0.07692, 0.00592,       26,        2,       24
FLI, 0.025  , 0.00063,       40,        1,       39
FLK, 0.08108, 0.00657,       74,        6,       68
FLL, 0.22535, 0.05078,       71,       16,       55
FLM, 0.18182, 0.03306,       22,        4,       18
FLN, 0.11628, 0.01352,       43,        5,       38
FLP, 0.01852, 0.00034,       54,        1,       53
FLQ, 0.01961, 0.00038,       51,        1,       50
FLR, 0.04054, 0.00164,       74,        3,       71
FLS, 0.10145, 0.01029,       69,        7,       62
FLT, 0.02857, 0.00082,       70,        2,       68
FLV, 0.08333, 0.00694,       60,        5,       55
FLW, 0.21429, 0.04592,       14,        3,       11
FLY, 0.09524, 0.00907,       21,        2,       19
FL_, 0      , 0      ,        2,        0,        2
FMF, 0      , 0      ,        4,        0,        4
FMG, 0.23077, 0.05325,       13,        3,       10
FMH, 0.2    , 0.04   ,       10,        2,        8
FMI, 0.28571, 0.08163,        7,        2,        5
FMK, 0      , 0      ,       16,        0,       16
FML, 0.08696, 0.00756,       23,        2,       21
FMM, 0      , 0      ,        5,        0,        5
FMN, 0.09091, 0.00826,       11,        1,       10
FMP, 0.09091, 0.00826,       11,        1,       10
FMQ, 0      , 0      ,        7,        0,        7
FMR, 0      , 0      ,        9,        0,        9
FMS, 0.2    , 0.04   ,       15,        3,       12
FMT, 0.10526, 0.01108,       19,        2,       17
FMV, 0.21429, 0.04592,       14,        3,       11
FMW, 0      , 0      ,        3,        0,        3
FMY, 0.125  , 0.01562,        8,        1,        7
FM_, 0      , 0      ,        3,        0,        3
FNF, 0      , 0      ,        9,        0,        9
FNG, 0.12727, 0.0162 ,       55,        7,       48
FNH, 0      , 0      ,       20,        0,       20
FNI, 0.13953, 0.01947,       43,        6,       37
FNK, 0.05556, 0.00309,       54,        3,       51
FNL, 0.12727, 0.0162 ,       55,        7,       48
FNM, 0      , 0      ,       19,        0,       19
FNN, 0.025  , 0.00063,       40,        1,       39
FNP, 0.02174, 0.00047,       46,        1,       45
FNQ, 0.02632, 0.00069,       38,        1,       37
FNR, 0.09302, 0.00865,       43,        4,       39
FNS, 0.02083, 0.00043,       48,        1,       47
FNT, 0.15385, 0.02367,       39,        6,       33
FNV, 0.10417, 0.01085,       48,        5,       43
FNW, 0.11111, 0.01235,        9,        1,        8
FNY, 0.07143, 0.0051 ,       28,        2,       26
FN_, 0      , 0      ,        4,        0,        4
FPF, 0      , 0      ,       16,        0,       16
FPG, 0.02174, 0.00047,       46,        1,       45
FPH, 0      , 0      ,       16,        0,       16
FPI, 0.03333, 0.00111,       30,        1,       29
FPK, 0.05714, 0.00327,       35,        2,       33
FPL, 0.07895, 0.00623,       76,        6,       70
FPM, 0.08333, 0.00694,       12,        1,       11
FPN, 0.1    , 0.01   ,       40,        4,       36
FPP, 0.0303 , 0.00092,       33,        1,       32
FPQ, 0      , 0      ,       25,        0,       25
FPR, 0.02857, 0.00082,       35,        1,       34
FPS, 0.1    , 0.01   ,       50,        5,       45
FPT, 0.02703, 0.00073,       37,        1,       36
FPV, 0.05556, 0.00309,       54,        3,       51
FPW, 0.14286, 0.02041,       14,        2,       12
FPY, 0.07692, 0.00592,       26,        2,       24
FP_, 0      , 0      ,        5,        0,        5
FQF, 0      , 0      ,       16,        0,       16
FQG, 0.03846, 0.00148,       52,        2,       50
FQH, 0.25   , 0.0625 ,       16,        4,       12
FQI, 0.09091, 0.00826,       44,        4,       40
FQK, 0.09524, 0.00907,       42,        4,       38
FQL, 0.08511, 0.00724,       47,        4,       43
FQM, 0      , 0      ,       18,        0,       18
FQN, 0.02381, 0.00057,       42,        1,       41
FQP, 0      , 0      ,       32,        0,       32
FQQ, 0.0303 , 0.00092,       33,        1,       32
FQR, 0      , 0      ,       31,        0,       31
FQS, 0.07692, 0.00592,       39,        3,       36
FQT, 0.03125, 0.00098,       32,        1,       31
FQV, 0      , 0      ,       46,        0,       46
FQW, 0.11111, 0.01235,        9,        1,        8
FQY, 0.12903, 0.01665,       31,        4,       27
FQ_, 0      , 0      ,        4,        0,        4
FRF, 0.11765, 0.01384,       17,        2,       15
FRG, 0.03509, 0.00123,       57,        2,       55
FRH, 0.1    , 0.01   ,       20,        2,       18
FRI, 0.08108, 0.00657,       37,        3,       34
FRK, 0.09615, 0.00925,       52,        5,       47
FRL, 0.025  , 0.00063,       80,        2,       78
FRM, 0.06667, 0.00444,       15,        1,       14
FRN, 0.02439, 0.00059,       41,        1,       40
FRP, 0.05556, 0.00309,       36,        2,       34
FRQ, 0.02857, 0.00082,       35,        1,       34
FRR, 0.11628, 0.01352,       43,        5,       38
FRS, 0.08451, 0.00714,       71,        6,       65
FRT, 0.07692, 0.00592,       39,        3,       36
FRV, 0.10127, 0.01025,       79,        8,       71
FRW, 0      , 0      ,        6,        0,        6
FRY, 0.13333, 0.01778,       30,        4,       26
FR_, 0.5    , 0.25   ,        2,        1,        1
FSF, 0.10714, 0.01148,       28,        3,       25
FSG, 0.0597 , 0.00356,       67,        4,       63
FSH, 0.04348, 0.00189,       23,        1,       22
FSI, 0.22222, 0.04938,       54,       12,       42
FSK, 0.08   , 0.0064 ,       75,        6,       69
FSL, 0.07921, 0.00627,      101,        8,       93
FSM, 0.04545, 0.00207,       22,        1,       21
FSN, 0.02083, 0.00043,       48,        1,       47
FSP, 0.01639, 0.00027,       61,        1,       60
FSQ, 0.06667, 0.00444,       45,        3,       42
FSR, 0.03704, 0.00137,       54,        2,       52
FSS, 0.05455, 0.00298,       55,        3,       52
FST, 0.04839, 0.00234,       62,        3,       59
FSV, 0.09589, 0.00919,       73,        7,       66
FSW, 0.1    , 0.01   ,       10,        1,        9
FSY, 0.05714, 0.00327,       35,        2,       33
FS_, 0.2    , 0.04   ,        5,        1,        4
FTF, 0      , 0      ,       21,        0,       21
FTG, 0.06122, 0.00375,       49,        3,       46
FTH, 0.04762, 0.00227,       21,        1,       20
FTI, 0.03922, 0.00154,       51,        2,       49
FTK, 0.03279, 0.00107,       61,        2,       59
FTL, 0.1125 , 0.01266,       80,        9,       71
FTM, 0.10526, 0.01108,       19,        2,       17
FTN, 0.07143, 0.0051 ,       42,        3,       39
FTP, 0.04082, 0.00167,       49,        2,       47
FTQ, 0.02439, 0.00059,       41,        1,       40
FTR, 0.06383, 0.00407,       47,        3,       44
FTS, 0.11765, 0.01384,       68,        8,       60
FTT, 0.04167, 0.00174,       48,        2,       46
FTV, 0.02778, 0.00077,       72,        2,       70
FTW, 0      , 0      ,       12,        0,       12
FTY, 0      , 0      ,       27,        0,       27
FT_, 0      , 0      ,        2,        0,        2
FVF, 0      , 0      ,       12,        0,       12
FVG, 0.08065, 0.0065 ,       62,        5,       57
FVH, 0.0625 , 0.00391,       16,        1,       15
FVI, 0.17143, 0.02939,       35,        6,       29
FVK, 0.07843, 0.00615,       51,        4,       47
FVL, 0.05882, 0.00346,       51,        3,       48
FVM, 0.08333, 0.00694,       12,        1,       11
FVN, 0.04348, 0.00189,       46,        2,       44
FVP, 0.04762, 0.00227,       42,        2,       40
FVQ, 0.07143, 0.0051 ,       42,        3,       39
FVR, 0.10417, 0.01085,       48,        5,       43
FVS, 0.07273, 0.00529,       55,        4,       51
FVT, 0.03846, 0.00148,       26,        1,       25
FVV, 0.02326, 0.00054,       43,        1,       42
FVW, 0      , 0      ,        6,        0,        6
FVY, 0.10526, 0.01108,       19,        2,       17
FV_, 0.5    , 0.25   ,        2,        1,        1
FWF, 0      , 0      ,        4,        0,        4
FWG, 0.18182, 0.03306,       11,        2,        9
FWH, 1      , 1      ,        1,        1,        0
FWI, 0      , 0      ,        9,        0,        9
FWK, 0.05556, 0.00309,       18,        1,       17
FWL, 0.08333, 0.00694,       12,        1,       11
FWM, 0      , 0      ,        5,        0,        5
FWN, 0.28571, 0.08163,        7,        2,        5
FWP, 0.33333, 0.11111,       15,        5,       10
FWQ, 0.30769, 0.09467,       13,        4,        9
FWR, 0.22222, 0.04938,        9,        2,        7
FWS, 0.2    , 0.04   ,       10,        2,        8
FWT, 0      , 0      ,        7,        0,        7
FWV, 0      , 0      ,       11,        0,       11
FWW, 0      , 0      ,        5,        0,        5
FWY, 0.15385, 0.02367,       13,        2,       11
FW_, 0      , 0      ,        3,        0,        3
FYF, 0.11765, 0.01384,       17,        2,       15
FYG, 0.2439 , 0.05949,       41,       10,       31
FYH, 0.21429, 0.04592,       14,        3,       11
FYI, 0.17391, 0.03025,       23,        4,       19
FYK, 0.08571, 0.00735,       35,        3,       32
FYL, 0.10811, 0.01169,       37,        4,       33
FYM, 0.11111, 0.01235,        9,        1,        8
FYN, 0.17391, 0.03025,       23,        4,       19
FYP, 0.07692, 0.00592,       26,        2,       24
FYQ, 0      , 0      ,       21,        0,       21
FYR, 0.18919, 0.03579,       37,        7,       30
FYS, 0.07692, 0.00592,       39,        3,       36
FYT, 0.1875 , 0.03516,       32,        6,       26
FYV, 0.25   , 0.0625 ,       32,        8,       24
FYW, 0.22222, 0.04938,        9,        2,        7
FYY, 0.17241, 0.02973,       29,        5,       24
FY_, 0      , 0      ,        1,        0,        1
GAG, 0.05882, 0.00346,       51,        3,       48
GAH, 0      , 0      ,       17,        0,       17
GAI, 0.06849, 0.00469,       73,        5,       68
GAK, 0.05155, 0.00266,       97,        5,       92
GAL, 0.03226, 0.00104,      124,        4,      120
GAM, 0.02381, 0.00057,       42,        1,       41
GAN, 0.08333, 0.00694,       60,        5,       55
GAP, 0.05063, 0.00256,       79,        4,       75
GAQ, 0.08   , 0.0064 ,       50,        4,       46
GAR, 0.01299, 0.00017,       77,        1,       76
GAS, 0.11702, 0.01369,       94,       11,       83
GAT, 0.02469, 0.00061,       81,        2,       79
GAV, 0.07527, 0.00567,       93,        7,       86
GAW, 0.16667, 0.02778,       12,        2,       10
GAY, 0.08108, 0.00657,       37,        3,       34
GA_, 0.125  , 0.01562,        8,        1,        7
GCG, 0.08333, 0.00694,       12,        1,       11
GCH, 0      , 0      ,        4,        0,        4
GCI, 0      , 0      ,       17,        0,       17
GCK, 0.13333, 0.01778,       15,        2,       13
GCL, 0.11538, 0.01331,       26,        3,       23
GCM, 0.25   , 0.0625 ,        4,        1,        3
GCN, 0.06667, 0.00444,       15,        1,       14
GCP, 0.09091, 0.00826,       22,        2,       20
GCQ, 0.13333, 0.01778,       15,        2,       13
GCR, 0.12   , 0.0144 ,       25,        3,       22
GCS, 0.16667, 0.02778,       24,        4,       20
GCT, 0.04167, 0.00174,       24,        1,       23
GCV, 0.14815, 0.02195,       27,        4,       23
GCW, 0.33333, 0.11111,        3,        1,        2
GCY, 0.30435, 0.09263,       23,        7,       16
GC_, 0      , 0      ,        1,        0,        1
GDG, 0.07692, 0.00592,       65,        5,       60
GDH, 0.0625 , 0.00391,       32,        2,       30
GDI, 0.05155, 0.00266,       97,        5,       92
GDK, 0.06299, 0.00397,      127,        8,      119
GDL, 0.02837, 0.0008 ,      141,        4,      137
GDM, 0.08824, 0.00779,       34,        3,       31
GDN, 0.01786, 0.00032,       56,        1,       55
GDP, 0.03093, 0.00096,       97,        3,       94
GDQ, 0.09259, 0.00857,       54,        5,       49
GDR, 0.07527, 0.00567,       93,        7,       86
GDS, 0.04386, 0.00192,      114,        5,      109
GDT, 0.10227, 0.01046,       88,        9,       79
GDV, 0.05882, 0.00346,      119,        7,      112
GDW, 0.13043, 0.01701,       23,        3,       20
GDY, 0.02597, 0.00067,       77,        2,       75
GD_, 0      , 0      ,        3,        0,        3
GEG, 0.01786, 0.00032,       56,        1,       55
GEH, 0.03125, 0.00098,       32,        1,       31
GEI, 0.04167, 0.00174,       96,        4,       92
GEK, 0.04098, 0.00168,      122,        5,      117
GEL, 0.08889, 0.0079 ,      135,       12,      123
GEM, 0.075  , 0.00562,       40,        3,       37
GEN, 0.05263, 0.00277,       76,        4,       72
GEP, 0.05932, 0.00352,      118,        7,      111
GEQ, 0.05085, 0.00259,       59,        3,       56
GER, 0.08889, 0.0079 ,       90,        8,       82
GES, 0.09091, 0.00826,       88,        8,       80
GET, 0.02041, 0.00042,       98,        2,       96
GEV, 0.02985, 0.00089,      134,        4,      130
GEW, 0.05263, 0.00277,       19,        1,       18
GEY, 0.02041, 0.00042,       49,        1,       48
GE_, 0      , 0      ,        7,        0,        7
GFG, 0.2    , 0.04   ,       40,        8,       32
GFH, 0.1    , 0.01   ,       30,        3,       27
GFI, 0.13043, 0.01701,       46,        6,       40
GFK, 0.17241, 0.02973,       58,       10,       48
GFL, 0.13433, 0.01804,       67,        9,       58
GFM, 0.14286, 0.02041,       14,        2,       12
GFN, 0.2766 , 0.07651,       47,       13,       34
GFP, 0.02381, 0.00057,       42,        1,       41
GFQ, 0.06452, 0.00416,       31,        2,       29
GFR, 0.06977, 0.00487,       43,        3,       40
GFS, 0.20588, 0.04239,       68,       14,       54
GFT, 0.15385, 0.02367,       39,        6,       33
GFV, 0.09722, 0.00945,       72,        7,       65
GFW, 0.35714, 0.12755,       14,        5,        9
GFY, 0.10256, 0.01052,       39,        4,       35
GF_, 0      , 0      ,        1,        0,        1
GGG, 0.09231, 0.00852,       65,        6,       59
GGH, 0.03704, 0.00137,       27,        1,       26
GGI, 0.07692, 0.00592,       78,        6,       72
GGK, 0.01389, 0.00019,       72,        1,       71
GGL, 0.03008, 0.0009 ,      133,        4,      129
GGM, 0.0625 , 0.00391,       32,        2,       30
GGN, 0.07576, 0.00574,       66,        5,       61
GGP, 0.01299, 0.00017,       77,        1,       76
GGQ, 0.04839, 0.00234,       62,        3,       59
GGR, 0.07447, 0.00555,       94,        7,       87
GGS, 0.09402, 0.00884,      117,       11,      106
GGT, 0.07692, 0.00592,       78,        6,       72
GGV, 0.0566 , 0.0032 ,      106,        6,      100
GGW, 0.03333, 0.00111,       30,        1,       29
GGY, 0.11667, 0.01361,       60,        7,       53
GG_, 0      , 0      ,       10,        0,       10
GHG, 0.33333, 0.11111,       21,        7,       14
GHH, 0      , 0      ,       18,        0,       18
GHI, 0.10526, 0.01108,       38,        4,       34
GHK, 0.06061, 0.00367,       33,        2,       31
GHL, 0.09615, 0.00925,       52,        5,       47
GHM, 0.14286, 0.02041,       14,        2,       12
GHN, 0      , 0      ,       14,        0,       14
GHP, 0.08696, 0.00756,       23,        2,       21
GHQ, 0.07692, 0.00592,       13,        1,       12
GHR, 0.08   , 0.0064 ,       25,        2,       23
GHS, 0.13953, 0.01947,       43,        6,       37
GHT, 0.075  , 0.00562,       40,        3,       37
GHV, 0.13889, 0.01929,       36,        5,       31
GHW, 0.5    , 0.25   ,        4,        2,        2
GHY, 0.13333, 0.01778,       30,        4,       26
GH_, 0      , 0      ,        2,        0,        2
GIG, 0.14286, 0.02041,       35,        5,       30
GIH, 0.03704, 0.00137,       27,        1,       26
GII, 0.15094, 0.02278,       53,        8,       45
GIK, 0.06579, 0.00433,       76,        5,       71
GIL, 0.04211, 0.00177,       95,        4,       91
GIM, 0.26087, 0.06805,       23,        6,       17
GIN, 0.05357, 0.00287,       56,        3,       53
GIP, 0.08475, 0.00718,       59,        5,       54
GIQ, 0.07143, 0.0051 ,       42,        3,       39
GIR, 0.05   , 0.0025 ,       60,        3,       57
GIS, 0.08475, 0.00718,       59,        5,       54
GIT, 0.1194 , 0.01426,       67,        8,       59
GIV, 0.05714, 0.00327,       70,        4,       66
GIW, 0.125  , 0.01562,       16,        2,       14
GIY, 0.17647, 0.03114,       34,        6,       28
GI_, 0      , 0      ,        2,        0,        2
GKG, 0.025  , 0.00063,       40,        1,       39
GKH, 0      , 0      ,       36,        0,       36
GKI, 0.05833, 0.0034 ,      120,        7,      113
GKK, 0.05618, 0.00316,       89,        5,       84
GKL, 0.07317, 0.00535,      164,       12,      152
GKM, 0.08696, 0.00756,       23,        2,       21
GKN, 0.07937, 0.0063 ,       63,        5,       58
GKP, 0.05333, 0.00284,       75,        4,       71
GKQ, 0.01818, 0.00033,       55,        1,       54
GKR, 0.0122 , 0.00015,       82,        1,       81
GKS, 0.03797, 0.00144,       79,        3,       76
GKT, 0.05435, 0.00295,       92,        5,       87
GKV, 0.08571, 0.00735,      105,        9,       96
GKW, 0.03571, 0.00128,       28,        1,       27
GKY, 0.01515, 0.00023,       66,        1,       65
GK_, 0      , 0      ,        5,        0,        5
GLG, 0.13725, 0.01884,       51,        7,       44
GLH, 0.05263, 0.00277,       38,        2,       36
GLI, 0.12295, 0.01512,      122,       15,      107
GLK, 0.07692, 0.00592,      117,        9,      108
GLL, 0.06061, 0.00367,      165,       10,      155
GLM, 0.0303 , 0.00092,       33,        1,       32
GLN, 0.01471, 0.00022,       68,        1,       67
GLP, 0.05505, 0.00303,      109,        6,      103
GLQ, 0.02778, 0.00077,       72,        2,       70
GLR, 0.05556, 0.00309,      108,        6,      102
GLS, 0.07273, 0.00529,      110,        8,      102
GLT, 0.1215 , 0.01476,      107,       13,       94
GLV, 0.07087, 0.00502,      127,        9,      118
GLW, 0      , 0      ,       25,        0,       25
GLY, 0.03846, 0.00148,       52,        2,       50
GL_, 0.14286, 0.02041,        7,        1,        6
GMG, 0      , 0      ,       12,        0,       12
GMH, 0      , 0      ,       11,        0,       11
GMI, 0.11765, 0.01384,       34,        4,       30
GMK, 0.03571, 0.00128,       28,        1,       27
GML, 0.11111, 0.01235,       45,        5,       40
GMM, 0      , 0      ,       10,        0,       10
GMN, 0.13043, 0.01701,       23,        3,       20
GMP, 0.09524, 0.00907,       21,        2,       19
GMQ, 0.17391, 0.03025,       23,        4,       19
GMR, 0      , 0      ,       16,        0,       16
GMS, 0.06452, 0.00416,       31,        2,       29
GMT, 0.13793, 0.01902,       29,        4,       25
GMV, 0      , 0      ,       32,        0,       32
GMW, 0.125  , 0.01562,        8,        1,        7
GMY, 0.07143, 0.0051 ,       14,        1,       13
GM_, 0.14286, 0.02041,        7,        1,        6
GNG, 0.18919, 0.03579,       37,        7,       30
GNH, 0.04348, 0.00189,       23,        1,       22
GNI, 0.05319, 0.00283,       94,        5,       89
GNK, 0.05357, 0.00287,       56,        3,       53
GNL, 0.07216, 0.00521,       97,        7,       90
GNM, 0.05882, 0.00346,       17,        1,       16
GNN, 0.08511, 0.00724,       47,        4,       43
GNP, 0.08219, 0.00676,       73,        6,       67
GNQ, 0.05455, 0.00298,       55,        3,       52
GNR, 0.09434, 0.0089 ,       53,        5,       48
GNS, 0.07317, 0.00535,       82,        6,       76
GNT, 0.10667, 0.01138,       75,        8,       67
GNV, 0.04386, 0.00192,      114,        5,      109
GNW, 0      , 0      ,       22,        0,       22
GNY, 0.02041, 0.00042,       49,        1,       48
GN_, 0      , 0      ,        6,        0,        6
GPG, 0.02174, 0.00047,       46,        1,       45
GPH, 0      , 0      ,       24,        0,       24
GPI, 0.05634, 0.00317,       71,        4,       67
GPK, 0.02857, 0.00082,       70,        2,       68
GPL, 0.07619, 0.0058 ,      105,        8,       97
GPM, 0.08333, 0.00694,       24,        2,       22
GPN, 0.07143, 0.0051 ,       42,        3,       39
GPP, 0.03226, 0.00104,       62,        2,       60
GPQ, 0      , 0      ,       47,        0,       47
GPR, 0.0625 , 0.00391,       64,        4,       60
GPS, 0.07812, 0.0061 ,       64,        5,       59
GPT, 0.07353, 0.00541,       68,        5,       63
GPV, 0.03846, 0.00148,       78,        3,       75
GPW, 0      , 0      ,       13,        0,       13
GPY, 0.03125, 0.00098,       32,        1,       31
GP_, 0      , 0      ,        2,        0,        2
GQG, 0      , 0      ,       25,        0,       25
GQH, 0.09524, 0.00907,       21,        2,       19
GQI, 0.09375, 0.00879,       64,        6,       58
GQK, 0.05357, 0.00287,       56,        3,       53
GQL, 0.09524, 0.00907,       84,        8,       76
GQM, 0.03226, 0.00104,       31,        1,       30
GQN, 0.08889, 0.0079 ,       45,        4,       41
GQP, 0.03636, 0.00132,       55,        2,       53
GQQ, 0.06818, 0.00465,       44,        3,       41
GQR, 0.07547, 0.0057 ,       53,        4,       49
GQS, 0.01724, 0.0003 ,       58,        1,       57
GQT, 0.08333, 0.00694,       48,        4,       44
GQV, 0.07692, 0.00592,       91,        7,       84
GQW, 0.05556, 0.00309,       18,        1,       17
GQY, 0.07143, 0.0051 ,       42,        3,       39
GQ_, 0.25   , 0.0625 ,        4,        1,        3
GRG, 0.17778, 0.0316 ,       45,        8,       37
GRH, 0.04   , 0.0016 ,       25,        1,       24
GRI, 0.06863, 0.00471,      102,        7,       95
GRK, 0.08861, 0.00785,       79,        7,       72
GRL, 0.08725, 0.00761,      149,       13,      136
GRM, 0.23077, 0.05325,       26,        6,       20
GRN, 0.06122, 0.00375,       49,        3,       46
GRP, 0.01429, 0.0002 ,       70,        1,       69
GRQ, 0.08333, 0.00694,       48,        4,       44
GRR, 0.08791, 0.00773,       91,        8,       83
GRS, 0.0875 , 0.00766,       80,        7,       73
GRT, 0.13699, 0.01877,       73,       10,       63
GRV, 0.12963, 0.0168 ,      108,       14,       94
GRW, 0.18182, 0.03306,       22,        4,       18
GRY, 0.05882, 0.00346,       51,        3,       48
GR_, 0      , 0      ,        2,        0,        2
GSG, 0.0241 , 0.00058,       83,        2,       81
GSH, 0.02   , 0.0004 ,       50,        1,       49
GSI, 0.1125 , 0.01266,       80,        9,       71
GSK, 0.04545, 0.00207,       88,        4,       84
GSL, 0.04724, 0.00223,      127,        6,      121
GSM, 0      , 0      ,       31,        0,       31
GSN, 0.03226, 0.00104,       62,        2,       60
GSP, 0.04124, 0.0017 ,       97,        4,       93
GSQ, 0.03125, 0.00098,       64,        2,       62
GSR, 0.0875 , 0.00766,       80,        7,       73
GSS, 0.05036, 0.00254,      139,        7,      132
GST, 0.06731, 0.00453,      104,        7,       97
GSV, 0.03876, 0.0015 ,      129,        5,      124
GSW, 0.16667, 0.02778,       24,        4,       20
GSY, 0.05195, 0.0027 ,       77,        4,       73
GS_, 0      , 0      ,       14,        0,       14
GTG, 0.10526, 0.01108,       57,        6,       51
GTH, 0.02703, 0.00073,       37,        1,       36
GTI, 0.06383, 0.00407,       94,        6,       88
GTK, 0.05797, 0.00336,       69,        4,       65
GTL, 0.04808, 0.00231,      104,        5,       99
GTM, 0      , 0      ,       18,        0,       18
GTN, 0.05357, 0.00287,       56,        3,       53
GTP, 0.08861, 0.00785,       79,        7,       72
GTQ, 0.04444, 0.00198,       45,        2,       43
GTR, 0.12727, 0.0162 ,       55,        7,       48
GTS, 0.05825, 0.00339,      103,        6,       97
GTT, 0.06818, 0.00465,       88,        6,       82
GTV, 0.0396 , 0.00157,      101,        4,       97
GTW, 0.04167, 0.00174,       24,        1,       23
GTY, 0.03175, 0.00101,       63,        2,       61
GT_, 0      , 0      ,        3,        0,        3
GVG, 0.09091, 0.00826,       44,        4,       40
GVH, 0.1    , 0.01   ,       30,        3,       27
GVI, 0.06154, 0.00379,       65,        4,       61
GVK, 0.05195, 0.0027 ,       77,        4,       73
GVL, 0.1    , 0.01   ,      120,       12,      108
GVM, 0.04348, 0.00189,       23,        1,       22
GVN, 0.03636, 0.00132,       55,        2,       53
GVP, 0.10294, 0.0106 ,       68,        7,       61
GVQ, 0.03333, 0.00111,       60,        2,       58
GVR, 0.12903, 0.01665,       62,        8,       54
GVS, 0.12222, 0.01494,       90,       11,       79
GVT, 0.04225, 0.00179,       71,        3,       68
GVV, 0.06897, 0.00476,      116,        8,      108
GVW, 0.2    , 0.04   ,       20,        4,       16
GVY, 0.01961, 0.00038,       51,        1,       50
GV_, 0      , 0      ,        5,        0,        5
GWG, 0.26316, 0.06925,       19,        5,       14
GWH, 0.42857, 0.18367,        7,        3,        4
GWI, 0.04348, 0.00189,       23,        1,       22
GWK, 0.09091, 0.00826,       22,        2,       20
GWL, 0.14286, 0.02041,       21,        3,       18
GWM, 0      , 0      ,        7,        0,        7
GWN, 0.19048, 0.03628,       21,        4,       17
GWP, 0.14286, 0.02041,       14,        2,       12
GWQ, 0.25   , 0.0625 ,        4,        1,        3
GWR, 0      , 0      ,       16,        0,       16
GWS, 0.28571, 0.08163,       28,        8,       20
GWT, 0.17391, 0.03025,       23,        4,       19
GWV, 0.2381 , 0.05669,       21,        5,       16
GWW, 0.42857, 0.18367,        7,        3,        4
GWY, 0.16667, 0.02778,       18,        3,       15
GYG, 0.20588, 0.04239,       34,        7,       27
GYH, 0.12   , 0.0144 ,       25,        3,       22
GYI, 0.11864, 0.01408,       59,        7,       52
GYK, 0.125  , 0.01562,       64,        8,       56
GYL, 0.17722, 0.03141,       79,       14,       65
GYM, 0.26667, 0.07111,       15,        4,       11
GYN, 0.02326, 0.00054,       43,        1,       42
GYP, 0.15686, 0.02461,       51,        8,       43
GYQ, 0.13636, 0.0186 ,       22,        3,       19
GYR, 0.25   , 0.0625 ,       48,       12,       36
GYS, 0.12821, 0.01644,       78,       10,       68
GYT, 0.16901, 0.02857,       71,       12,       59
GYV, 0.19643, 0.03858,       56,       11,       45
GYW, 0.15385, 0.02367,       13,        2,       11
GYY, 0.11111, 0.01235,       36,        4,       32
GY_, 0      , 0      ,        1,        0,        1
HAH, 0.16667, 0.02778,        6,        1,        5
HAI, 0.03846, 0.00148,       26,        1,       25
HAK, 0      , 0      ,       24,        0,       24
HAL, 0.02857, 0.00082,       35,        1,       34
HAM, 0      , 0      ,       11,        0,       11
HAN, 0      , 0      ,       16,        0,       16
HAP, 0.05882, 0.00346,       17,        1,       16
HAQ, 0      , 0      ,       23,        0,       23
HAR, 0.03846, 0.00148,       26,        1,       25
HAS, 0.03448, 0.00119,       29,        1,       28
HAT, 0      , 0      ,       17,        0,       17
HAV, 0.16667, 0.02778,       24,        4,       20
HAW, 0.14286, 0.02041,        7,        1,        6
HAY, 0.125  , 0.01562,        8,        1,        7
HA_, 0      , 0      ,        3,        0,        3
HCI, 0.09091, 0.00826,       11,        1,       10
HCK, 0.1    , 0.01   ,       10,        1,        9
HCL, 0      , 0      ,       11,        0,       11
HCM, 0      , 0      ,        3,        0,        3
HCN, 0      , 0      ,        6,        0,        6
HCP, 0.125  , 0.01562,        8,        1,        7
HCQ, 0      , 0      ,       10,        0,       10
HCR, 0      , 0      ,        7,        0,        7
HCS, 0      , 0      ,        8,        0,        8
HCT, 0      , 0      ,        5,        0,        5
HCV, 0.18182, 0.03306,       11,        2,        9
HCW, 0      , 0      ,        1,        0,        1
HCY, 0      , 0      ,        9,        0,        9
HDH, 0      , 0      ,        2,        0,        2
HDI, 0.07407, 0.00549,       27,        2,       25
HDK, 0.03846, 0.00148,       26,        1,       25
HDL, 0.02083, 0.00043,       48,        1,       47
HDM, 0      , 0      ,        8,        0,        8
HDN, 0      , 0      ,       13,        0,       13
HDP, 0.03571, 0.00128,       28,        1,       27
HDQ, 0      , 0      ,       26,        0,       26
HDR, 0.13333, 0.01778,       15,        2,       13
HDS, 0.04348, 0.00189,       23,        1,       22
HDT, 0.07692, 0.00592,       13,        1,       12
HDV, 0.13158, 0.01731,       38,        5,       33
HDW, 0.16667, 0.02778,        6,        1,        5
HDY, 0.26667, 0.07111,       15,        4,       11
HD_, 1      , 1      ,        1,        1,        0
HEH, 0      , 0      ,        8,        0,        8
HEI, 0.075  , 0.00562,       40,        3,       37
HEK, 0      , 0      ,       26,        0,       26
HEL, 0.08621, 0.00743,       58,        5,       53
HEM, 0.05263, 0.00277,       19,        1,       18
HEN, 0      , 0      ,       23,        0,       23
HEP, 0      , 0      ,       30,        0,       30
HEQ, 0.04545, 0.00207,       22,        1,       21
HER, 0.08696, 0.00756,       23,        2,       21
HES, 0.12   , 0.0144 ,       25,        3,       22
HET, 0.12903, 0.01665,       31,        4,       27
HEV, 0.02632, 0.00069,       38,        1,       37
HEW, 0      , 0      ,       12,        0,       12
HEY, 0.1875 , 0.03516,       16,        3,       13
HE_, 0      , 0      ,        2,        0,        2
HFH, 0.125  , 0.01562,        8,        1,        7
HFI, 0.05   , 0.0025 ,       20,        1,       19
HFK, 0.2    , 0.04   ,       25,        5,       20
HFL, 0.06897, 0.00476,       29,        2,       27
HFM, 0.14286, 0.02041,        7,        1,        6
HFN, 0.33333, 0.11111,       12,        4,        8
HFP, 0.2    , 0.04   ,       20,        4,       16
HFQ, 0.05556, 0.00309,       18,        1,       17
HFR, 0      , 0      ,        9,        0,        9
HFS, 0.06452, 0.00416,       31,        2,       29
HFT, 0.03333, 0.00111,       30,        1,       29
HFV, 0.11538, 0.01331,       26,        3,       23
HFW, 0      , 0      ,       16,        0,       16
HFY, 0.16667, 0.02778,        6,        1,        5
HGH, 0      , 0      ,        3,        0,        3
HGI, 0.07692, 0.00592,       39,        3,       36
HGK, 0      , 0      ,       37,        0,       37
HGL, 0.04545, 0.00207,       44,        2,       42
HGM, 0.11111, 0.01235,        9,        1,        8
HGN, 0      , 0      ,       33,        0,       33
HGP, 0      , 0      ,       23,        0,       23
HGQ, 0.04167, 0.00174,       24,        1,       23
HGR, 0.08333, 0.00694,       24,        2,       22
HGS, 0.03333, 0.00111,       30,        1,       29
HGT, 0      , 0      ,       31,        0,       31
HGV, 0.08824, 0.00779,       34,        3,       31
HGW, 0      , 0      ,        2,        0,        2
HGY, 0.05556, 0.00309,       18,        1,       17
HG_, 0      , 0      ,        6,        0,        6
HHH, 0      , 0      ,       50,        0,       50
HHI, 0.07143, 0.0051 ,       14,        1,       13
HHK, 0      , 0      ,       11,        0,       11
HHL, 0.05556, 0.00309,       18,        1,       17
HHM, 0.27273, 0.07438,       11,        3,        8
HHN, 0      , 0      ,        7,        0,        7
HHP, 0      , 0      ,       12,        0,       12
HHQ, 0.125  , 0.01562,        8,        1,        7
HHR, 0      , 0      ,       12,        0,       12
HHS, 0.07143, 0.0051 ,       14,        1,       13
HHT, 0.0625 , 0.00391,       16,        1,       15
HHV, 0.09091, 0.00826,       22,        2,       20
HHW, 0      , 0      ,        6,        0,        6
HHY, 0.16667, 0.02778,        6,        1,        5
HH_, 0      , 0      ,       13,        0,       13
HIH, 0      , 0      ,        3,        0,        3
HII, 0.11765, 0.01384,       17,        2,       15
HIK, 0.08696, 0.00756,       23,        2,       21
HIL, 0.10256, 0.01052,       39,        4,       35
HIM, 0      , 0      ,        4,        0,        4
HIN, 0      , 0      ,       17,        0,       17
HIP, 0.04762, 0.00227,       21,        1,       20
HIQ, 0      , 0      ,       20,        0,       20
HIR, 0.09524, 0.00907,       21,        2,       19
HIS, 0.03226, 0.00104,       31,        1,       30
HIT, 0      , 0      ,       15,        0,       15
HIV, 0.12   , 0.0144 ,       25,        3,       22
HIW, 0      , 0      ,        8,        0,        8
HIY, 0.07692, 0.00592,       13,        1,       12
HKH, 0      , 0      ,        4,        0,        4
HKI, 0.06897, 0.00476,       29,        2,       27
HKK, 0.12195, 0.01487,       41,        5,       36
HKL, 0.08621, 0.00743,       58,        5,       53
HKM, 0.0625 , 0.00391,       16,        1,       15
HKN, 0.11538, 0.01331,       26,        3,       23
HKP, 0      , 0      ,       19,        0,       19
HKQ, 0.03846, 0.00148,       26,        1,       25
HKR, 0      , 0      ,       25,        0,       25
HKS, 0.03125, 0.00098,       32,        1,       31
HKT, 0.05882, 0.00346,       17,        1,       16
HKV, 0.14706, 0.02163,       34,        5,       29
HKW, 0.08333, 0.00694,       12,        1,       11
HKY, 0.05556, 0.00309,       18,        1,       17
HK_, 0      , 0      ,        1,        0,        1
HLH, 0.1    , 0.01   ,       10,        1,        9
HLI, 0.10526, 0.01108,       38,        4,       34
HLK, 0      , 0      ,       41,        0,       41
HLL, 0.04225, 0.00179,       71,        3,       68
HLM, 0.1    , 0.01   ,       10,        1,        9
HLN, 0.08333, 0.00694,       24,        2,       22
HLP, 0.08571, 0.00735,       35,        3,       32
HLQ, 0.09375, 0.00879,       32,        3,       29
HLR, 0.08571, 0.00735,       35,        3,       32
HLS, 0.07895, 0.00623,       38,        3,       35
HLT, 0.09677, 0.00937,       31,        3,       28
HLV, 0.12727, 0.0162 ,       55,        7,       48
HLW, 0      , 0      ,        4,        0,        4
HLY, 0.10526, 0.01108,       19,        2,       17
HL_, 1      , 1      ,        1,        1,        0
HMH, 0      , 0      ,        2,        0,        2
HMI, 0      , 0      ,        7,        0,        7
HMK, 0      , 0      ,       12,        0,       12
HML, 0.125  , 0.01562,       24,        3,       21
HMM, 0.2    , 0.04   ,        5,        1,        4
HMN, 0      , 0      ,        7,        0,        7
HMP, 0      , 0      ,        9,        0,        9
HMQ, 0      , 0      ,       12,        0,       12
HMR, 0      , 0      ,        9,        0,        9
HMS, 0.1    , 0.01   ,       10,        1,        9
HMT, 0.11111, 0.01235,        9,        1,        8
HMV, 0      , 0      ,        9,        0,        9
HMW, 0      , 0      ,        1,        0,        1
HMY, 1      , 1      ,        2,        2,        0
HM_, 0      , 0      ,        2,        0,        2
HNH, 0      , 0      ,        3,        0,        3
HNI, 0.06897, 0.00476,       29,        2,       27
HNK, 0.05882, 0.00346,       17,        1,       16
HNL, 0.03226, 0.00104,       31,        1,       30
HNM, 0.125  , 0.01562,        8,        1,        7
HNN, 0.05   , 0.0025 ,       20,        1,       19
HNP, 0.09091, 0.00826,       22,        2,       20
HNQ, 0      , 0      ,       19,        0,       19
HNR, 0.11111, 0.01235,       18,        2,       16
HNS, 0      , 0      ,       14,        0,       14
HNT, 0.05   , 0.0025 ,       20,        1,       19
HNV, 0.07692, 0.00592,       26,        2,       24
HNW, 0      , 0      ,        5,        0,        5
HNY, 0.2    , 0.04   ,       10,        2,        8
HN_, 0.5    , 0.25   ,        2,        1,        1
HPH, 0      , 0      ,        5,        0,        5
HPI, 0      , 0      ,       21,        0,       21
HPK, 0      , 0      ,       29,        0,       29
HPL, 0.02857, 0.00082,       35,        1,       34
HPM, 0      , 0      ,        8,        0,        8
HPN, 0.05556, 0.00309,       18,        1,       17
HPP, 0      , 0      ,       18,        0,       18
HPQ, 0      , 0      ,       13,        0,       13
HPR, 0.05882, 0.00346,       17,        1,       16
HPS, 0      , 0      ,       30,        0,       30
HPT, 0.1    , 0.01   ,       20,        2,       18
HPV, 0.17391, 0.03025,       23,        4,       19
HPW, 0.09091, 0.00826,       11,        1,       10
HPY, 0      , 0      ,       15,        0,       15
HP_, 0.5    , 0.25   ,        2,        1,        1
HQH, 0      , 0      ,        8,        0,        8
HQI, 0.2    , 0.04   ,       20,        4,       16
HQK, 0.03846, 0.00148,       26,        1,       25
HQL, 0.05172, 0.00268,       58,        3,       55
HQM, 0.25   , 0.0625 ,        4,        1,        3
HQN, 0.125  , 0.01562,        8,        1,        7
HQP, 0      , 0      ,       13,        0,       13
HQQ, 0.05   , 0.0025 ,       20,        1,       19
HQR, 0.06667, 0.00444,       15,        1,       14
HQS, 0.09091, 0.00826,       22,        2,       20
HQT, 0      , 0      ,       15,        0,       15
HQV, 0.23333, 0.05444,       30,        7,       23
HQW, 0.25   , 0.0625 ,        4,        1,        3
HQY, 0.07143, 0.0051 ,       14,        1,       13
HQ_, 0      , 0      ,        2,        0,        2
HRH, 0.14286, 0.02041,        7,        1,        6
HRI, 0.06061, 0.00367,       33,        2,       31
HRK, 0.07692, 0.00592,       26,        2,       24
HRL, 0.02632, 0.00069,       38,        1,       37
HRM, 0      , 0      ,        7,        0,        7
HRN, 0.04762, 0.00227,       21,        1,       20
HRP, 0.03846, 0.00148,       26,        1,       25
HRQ, 0.05882, 0.00346,       17,        1,       16
HRR, 0.06667, 0.00444,       30,        2,       28
HRS, 0.06667, 0.00444,       30,        2,       28
HRT, 0.14286, 0.02041,       21,        3,       18
HRV, 0.13793, 0.01902,       29,        4,       25
HRW, 0.25   , 0.0625 ,        8,        2,        6
HRY, 0      , 0      ,       22,        0,       22
HR_, 0      , 0      ,        1,        0,        1
HSH, 0      , 0      ,        2,        0,        2
HSI, 0.11538, 0.01331,       26,        3,       23
HSK, 0      , 0      ,       26,        0,       26
HSL, 0.01818, 0.00033,       55,        1,       54
HSM, 0      , 0      ,       17,        0,       17
HSN, 0.04167, 0.00174,       24,        1,       23
HSP, 0      , 0      ,       27,        0,       27
HSQ, 0      , 0      ,       28,        0,       28
HSR, 0.03448, 0.00119,       29,        1,       28
HSS, 0.20588, 0.04239,       34,        7,       27
HST, 0.04167, 0.00174,       24,        1,       23
HSV, 0.06522, 0.00425,       46,        3,       43
HSW, 0      , 0      ,        5,        0,        5
HSY, 0.2381 , 0.05669,       21,        5,       16
HS_, 0      , 0      ,        9,        0,        9
HTH, 0      , 0      ,        8,        0,        8
HTI, 0      , 0      ,       22,        0,       22
HTK, 0.04167, 0.00174,       24,        1,       23
HTL, 0.02703, 0.00073,       37,        1,       36
HTM, 0      , 0      ,        8,        0,        8
HTN, 0.05263, 0.00277,       19,        1,       18
HTP, 0      , 0      ,       16,        0,       16
HTQ, 0      , 0      ,       11,        0,       11
HTR, 0.06667, 0.00444,       15,        1,       14
HTS, 0      , 0      ,       17,        0,       17
HTT, 0      , 0      ,       27,        0,       27
HTV, 0.03448, 0.00119,       29,        1,       28
HTW, 0      , 0      ,        7,        0,        7
HTY, 0.0625 , 0.00391,       16,        1,       15
HVH, 0      , 0      ,        2,        0,        2
HVI, 0      , 0      ,       21,        0,       21
HVK, 0      , 0      ,       24,        0,       24
HVL, 0.05   , 0.0025 ,       40,        2,       38
HVM, 0      , 0      ,       10,        0,       10
HVN, 0.05263, 0.00277,       19,        1,       18
HVP, 0.13636, 0.0186 ,       22,        3,       19
HVQ, 0.08696, 0.00756,       23,        2,       21
HVR, 0.05   , 0.0025 ,       20,        1,       19
HVS, 0.12903, 0.01665,       31,        4,       27
HVT, 0      , 0      ,       24,        0,       24
HVV, 0.08696, 0.00756,       23,        2,       21
HVW, 0.5    , 0.25   ,        2,        1,        1
HVY, 0.14286, 0.02041,       14,        2,       12
HV_, 0      , 0      ,        2,        0,        2
HWH, 0      , 0      ,        5,        0,        5
HWI, 0      , 0      ,        6,        0,        6
HWK, 0.22222, 0.04938,        9,        2,        7
HWL, 0      , 0      ,        8,        0,        8
HWM, 0      , 0      ,        5,        0,        5
HWN, 0      , 0      ,        3,        0,        3
HWP, 0.11111, 0.01235,        9,        1,        8
HWQ, 0      , 0      ,        2,        0,        2
HWR, 0.6    , 0.36   ,        5,        3,        2
HWS, 0.4    , 0.16   ,        5,        2,        3
HWT, 0.27273, 0.07438,       11,        3,        8
HWV, 0.5    , 0.25   ,        4,        2,        2
HWW, 0      , 0      ,        3,        0,        3
HWY, 0.16667, 0.02778,        6,        1,        5
HYH, 0      , 0      ,        3,        0,        3
HYI, 0.08333, 0.00694,       24,        2,       22
HYK, 0.04762, 0.00227,       21,        1,       20
HYL, 0.17241, 0.02973,       29,        5,       24
HYM, 0.25   , 0.0625 ,        4,        1,        3
HYN, 0.11765, 0.01384,       17,        2,       15
HYP, 0      , 0      ,       13,        0,       13
HYQ, 0.15385, 0.02367,       13,        2,       11
HYR, 0.3    , 0.09   ,       10,        3,        7
HYS, 0.07407, 0.00549,       27,        2,       25
HYT, 0.25   , 0.0625 ,       12,        3,        9
HYV, 0.04545, 0.00207,       22,        1,       21
HYW, 0      , 0      ,       10,        0,       10
HYY, 0.17647, 0.03114,       17,        3,       14
IAI, 0.09524, 0.00907,       21,        2,       19
IAK, 0.03846, 0.00148,       78,        3,       75
IAL, 0.06024, 0.00363,       83,        5,       78
IAM, 0.08   , 0.0064 ,       25,        2,       23
IAN, 0.04412, 0.00195,       68,        3,       65
IAP, 0      , 0      ,       38,        0,       38
IAQ, 0.11667, 0.01361,       60,        7,       53
IAR, 0.0339 , 0.00115,       59,        2,       57
IAS, 0.0411 , 0.00169,       73,        3,       70
IAT, 0.09524, 0.00907,       63,        6,       57
IAV, 0.10345, 0.0107 ,       58,        6,       52
IAW, 0.14286, 0.02041,        7,        1,        6
IAY, 0.08333, 0.00694,       24,        2,       22
IA_, 0      , 0      ,        5,        0,        5
ICI, 0.33333, 0.11111,        3,        1,        2
ICK, 0.03846, 0.00148,       26,        1,       25
ICL, 0.07407, 0.00549,       27,        2,       25
ICM, 0.125  , 0.01562,        8,        1,        7
ICN, 0.07692, 0.00592,       13,        1,       12
ICP, 0      , 0      ,       15,        0,       15
ICQ, 0.15789, 0.02493,       19,        3,       16
ICR, 0      , 0      ,       15,        0,       15
ICS, 0      , 0      ,       14,        0,       14
ICT, 0      , 0      ,       12,        0,       12
ICV, 0.11111, 0.01235,       18,        2,       16
ICW, 0      , 0      ,        1,        0,        1
ICY, 0.3    , 0.09   ,       10,        3,        7
IC_, 0      , 0      ,        1,        0,        1
IDI, 0.06667, 0.00444,       30,        2,       28
IDK, 0.05882, 0.00346,      102,        6,       96
IDL, 0.07937, 0.0063 ,      126,       10,      116
IDM, 0      , 0      ,       24,        0,       24
IDN, 0.0339 , 0.00115,       59,        2,       57
IDP, 0      , 0      ,       68,        0,       68
IDQ, 0.08   , 0.0064 ,       50,        4,       46
IDR, 0.06667, 0.00444,       75,        5,       70
IDS, 0.06098, 0.00372,       82,        5,       77
IDT, 0.04225, 0.00179,       71,        3,       68
IDV, 0.06122, 0.00375,       98,        6,       92
IDW, 0.08333, 0.00694,       24,        2,       22
IDY, 0.04444, 0.00198,       45,        2,       43
ID_, 0      , 0      ,        3,        0,        3
IEI, 0.03333, 0.00111,       30,        1,       29
IEK, 0.05505, 0.00303,      109,        6,      103
IEL, 0.09848, 0.0097 ,      132,       13,      119
IEM, 0.0303 , 0.00092,       33,        1,       32
IEN, 0.04918, 0.00242,       61,        3,       58
IEP, 0.04225, 0.00179,       71,        3,       68
IEQ, 0.04054, 0.00164,       74,        3,       71
IER, 0.00935, 0.00009,      107,        1,      106
IES, 0.05882, 0.00346,       85,        5,       80
IET, 0.05882, 0.00346,       51,        3,       48
IEV, 0.02062, 0.00043,       97,        2,       95
IEW, 0.10714, 0.01148,       28,        3,       25
IEY, 0.14634, 0.02142,       41,        6,       35
IE_, 0      , 0      ,        3,        0,        3
IFI, 0      , 0      ,       17,        0,       17
IFK, 0.10526, 0.01108,       57,        6,       51
IFL, 0.06977, 0.00487,       43,        3,       40
IFM, 0      , 0      ,       11,        0,       11
IFN, 0.11765, 0.01384,       34,        4,       30
IFP, 0.03448, 0.00119,       29,        1,       28
IFQ, 0.125  , 0.01562,       40,        5,       35
IFR, 0.08889, 0.0079 ,       45,        4,       41
IFS, 0.09615, 0.00925,       52,        5,       47
IFT, 0.13043, 0.01701,       46,        6,       40
IFV, 0.07895, 0.00623,       38,        3,       35
IFW, 0      , 0      ,        7,        0,        7
IFY, 0.14815, 0.02195,       27,        4,       23
IF_, 0      , 0      ,        4,        0,        4
IGI, 0.13043, 0.01701,       23,        3,       20
IGK, 0.02899, 0.00084,       69,        2,       67
IGL, 0.06383, 0.00407,       94,        6,       88
IGM, 0.10526, 0.01108,       19,        2,       17
IGN, 0.05357, 0.00287,       56,        3,       53
IGP, 0      , 0      ,       36,        0,       36
IGQ, 0.04545, 0.00207,       44,        2,       42
IGR, 0.05882, 0.00346,       68,        4,       64
IGS, 0.05357, 0.00287,       56,        3,       53
IGT, 0.03279, 0.00107,       61,        2,       59
IGV, 0.04348, 0.00189,       46,        2,       44
IGW, 0      , 0      ,       13,        0,       13
IGY, 0.05556, 0.00309,       36,        2,       34
IG_, 0      , 0      ,        6,        0,        6
IHI, 0.0625 , 0.00391,       16,        1,       15
IHK, 0.06522, 0.00425,       46,        3,       43
IHL, 0.02703, 0.00073,       37,        1,       36
IHM, 0      , 0      ,        4,        0,        4
IHN, 0      , 0      ,       25,        0,       25
IHP, 0.12   , 0.0144 ,       25,        3,       22
IHQ, 0.03571, 0.00128,       28,        1,       27
IHR, 0.03226, 0.00104,       31,        1,       30
IHS, 0.31707, 0.10054,       41,       13,       28
IHT, 0.11111, 0.01235,       27,        3,       24
IHV, 0.12   , 0.0144 ,       25,        3,       22
IHW, 0      , 0      ,        5,        0,        5
IHY, 0.11765, 0.01384,       17,        2,       15
IH_, 0      , 0      ,        2,        0,        2
III, 0      , 0      ,        8,        0,        8
IIK, 0.06024, 0.00363,       83,        5,       78
IIL, 0.06   , 0.0036 ,       50,        3,       47
IIM, 0.05263, 0.00277,       19,        1,       18
IIN, 0.09259, 0.00857,       54,        5,       49
IIP, 0.07895, 0.00623,       38,        3,       35
IIQ, 0.05   , 0.0025 ,       40,        2,       38
IIR, 0.06667, 0.00444,       45,        3,       42
IIS, 0.13559, 0.01839,       59,        8,       51
IIT, 0.11111, 0.01235,       45,        5,       40
IIV, 0.04255, 0.00181,       47,        2,       45
IIW, 0.11111, 0.01235,        9,        1,        8
IIY, 0.07692, 0.00592,       13,        1,       12
IKI, 0.05556, 0.00309,       36,        2,       34
IKK, 0.09167, 0.0084 ,      120,       11,      109
IKL, 0.0297 , 0.00088,      101,        3,       98
IKM, 0.13333, 0.01778,       30,        4,       26
IKN, 0.10667, 0.01138,       75,        8,       67
IKP, 0.03279, 0.00107,       61,        2,       59
IKQ, 0.05797, 0.00336,       69,        4,       65
IKR, 0.01429, 0.0002 ,       70,        1,       69
IKS, 0.05   , 0.0025 ,      100,        5,       95
IKT, 0.0411 , 0.00169,       73,        3,       70
IKV, 0.08411, 0.00707,      107,        9,       98
IKW, 0.15   , 0.0225 ,       20,        3,       17
IKY, 0.05   , 0.0025 ,       40,        2,       38
IK_, 0.14286, 0.02041,        7,        1,        6
ILI, 0.03846, 0.00148,       26,        1,       25
ILK, 0.07339, 0.00539,      109,        8,      101
ILL, 0.09375, 0.00879,       96,        9,       87
ILM, 0      , 0      ,       13,        0,       13
ILN, 0.0241 , 0.00058,       83,        2,       81
ILP, 0.09756, 0.00952,       82,        8,       74
ILQ, 0.04545, 0.00207,       66,        3,       63
ILR, 0.11268, 0.0127 ,       71,        8,       63
ILS, 0.10185, 0.01037,      108,       11,       97
ILT, 0.075  , 0.00562,       80,        6,       74
ILV, 0.0625 , 0.00391,       64,        4,       60
ILW, 0      , 0      ,       16,        0,       16
ILY, 0.09804, 0.00961,       51,        5,       46
IL_, 0.16667, 0.02778,        6,        1,        5
IMI, 0.1    , 0.01   ,       10,        1,        9
IMK, 0.09524, 0.00907,       42,        4,       38
IML, 0      , 0      ,       21,        0,       21
IMM, 0      , 0      ,        6,        0,        6
IMN, 0.05263, 0.00277,       19,        1,       18
IMP, 0.10526, 0.01108,       19,        2,       17
IMQ, 0.25   , 0.0625 ,       20,        5,       15
IMR, 0.09524, 0.00907,       21,        2,       19
IMS, 0.05   , 0.0025 ,       20,        1,       19
IMT, 0      , 0      ,       20,        0,       20
IMV, 0.08333, 0.00694,       12,        1,       11
IMW, 0      , 0      ,        3,        0,        3
IMY, 0.07143, 0.0051 ,       14,        1,       13
IM_, 0      , 0      ,        6,        0,        6
INI, 0.1    , 0.01   ,       30,        3,       27
INK, 0.07042, 0.00496,       71,        5,       66
INL, 0.03191, 0.00102,       94,        3,       91
INM, 0.09375, 0.00879,       32,        3,       29
INN, 0.06452, 0.00416,       62,        4,       58
INP, 0.09091, 0.00826,       55,        5,       50
INQ, 0.06667, 0.00444,       45,        3,       42
INR, 0.05263, 0.00277,       57,        3,       54
INS, 0.02857, 0.00082,       70,        2,       68
INT, 0.08197, 0.00672,       61,        5,       56
INV, 0.13158, 0.01731,       76,       10,       66
INW, 0.11765, 0.01384,       17,        2,       15
INY, 0.1    , 0.01   ,       40,        4,       36
IPI, 0.05556, 0.00309,       36,        2,       34
IPK, 0.05172, 0.00268,       58,        3,       55
IPL, 0.01111, 0.00012,       90,        1,       89
IPM, 0.17647, 0.03114,       17,        3,       14
IPN, 0.02703, 0.00073,       37,        1,       36
IPP, 0      , 0      ,       49,        0,       49
IPQ, 0.03333, 0.00111,       30,        1,       29
IPR, 0.05172, 0.00268,       58,        3,       55
IPS, 0.10959, 0.01201,       73,        8,       65
IPT, 0.03846, 0.00148,       52,        2,       50
IPV, 0.10526, 0.01108,       76,        8,       68
IPW, 0.1    , 0.01   ,       10,        1,        9
IPY, 0.08108, 0.00657,       37,        3,       34
IP_, 0      , 0      ,        5,        0,        5
IQI, 0.04   , 0.0016 ,       25,        1,       24
IQK, 0.07143, 0.0051 ,       70,        5,       65
IQL, 0.04286, 0.00184,       70,        3,       67
IQM, 0      , 0      ,       19,        0,       19
IQN, 0.0339 , 0.00115,       59,        2,       57
IQP, 0.07895, 0.00623,       38,        3,       35
IQQ, 0.0339 , 0.00115,       59,        2,       57
IQR, 0.08889, 0.0079 ,       45,        4,       41
IQS, 0.10811, 0.01169,       74,        8,       66
IQT, 0.12195, 0.01487,       41,        5,       36
IQV, 0.02222, 0.00049,       45,        1,       44
IQW, 0.2    , 0.04   ,        5,        1,        4
IQY, 0.08   , 0.0064 ,       25,        2,       23
IQ_, 0      , 0      ,        2,        0,        2
IRI, 0.16667, 0.02778,       30,        5,       25
IRK, 0.07071, 0.005  ,       99,        7,       92
IRL, 0.04598, 0.00211,       87,        4,       83
IRM, 0.16129, 0.02601,       31,        5,       26
IRN, 0.16981, 0.02884,       53,        9,       44
IRP, 0.09259, 0.00857,       54,        5,       49
IRQ, 0.06977, 0.00487,       43,        3,       40
IRR, 0.09091, 0.00826,       55,        5,       50
IRS, 0.06897, 0.00476,       87,        6,       81
IRT, 0.11765, 0.01384,       51,        6,       45
IRV, 0.08065, 0.0065 ,       62,        5,       57
IRW, 0.1    , 0.01   ,       10,        1,        9
IRY, 0.13725, 0.01884,       51,        7,       44
IR_, 0      , 0      ,        2,        0,        2
ISI, 0.12121, 0.01469,       33,        4,       29
ISK, 0.05952, 0.00354,       84,        5,       79
ISL, 0.06316, 0.00399,       95,        6,       89
ISM, 0.05405, 0.00292,       37,        2,       35
ISN, 0.03333, 0.00111,       60,        2,       58
ISP, 0.07692, 0.00592,       65,        5,       60
ISQ, 0.0339 , 0.00115,       59,        2,       57
ISR, 0.11688, 0.01366,       77,        9,       68
ISS, 0.06522, 0.00425,       92,        6,       86
IST, 0.02941, 0.00087,       68,        2,       66
ISV, 0.05333, 0.00284,       75,        4,       71
ISW, 0      , 0      ,       12,        0,       12
ISY, 0.09434, 0.0089 ,       53,        5,       48
IS_, 0.33333, 0.11111,        3,        1,        2
ITI, 0      , 0      ,       35,        0,       35
ITK, 0.03371, 0.00114,       89,        3,       86
ITL, 0.07407, 0.00549,      108,        8,      100
ITM, 0.06667, 0.00444,       30,        2,       28
ITN, 0.04082, 0.00167,       49,        2,       47
ITP, 0.07576, 0.00574,       66,        5,       61
ITQ, 0.02174, 0.00047,       46,        1,       45
ITR, 0.06897, 0.00476,       58,        4,       54
ITS, 0.02632, 0.00069,       76,        2,       74
ITT, 0.04762, 0.00227,       63,        3,       60
ITV, 0.04082, 0.00167,       98,        4,       94
ITW, 0.06667, 0.00444,       15,        1,       14
ITY, 0.03922, 0.00154,       51,        2,       49
IT_, 0      , 0      ,        2,        0,        2
IVI, 0.05263, 0.00277,       19,        1,       18
IVK, 0.08108, 0.00657,       74,        6,       68
IVL, 0.04545, 0.00207,       66,        3,       63
IVM, 0.25   , 0.0625 ,       20,        5,       15
IVN, 0.08772, 0.00769,       57,        5,       52
IVP, 0.06   , 0.0036 ,       50,        3,       47
IVQ, 0.09756, 0.00952,       41,        4,       37
IVR, 0.06557, 0.0043 ,       61,        4,       57
IVS, 0.05479, 0.003  ,       73,        4,       69
IVT, 0.0339 , 0.00115,       59,        2,       57
IVV, 0.08163, 0.00666,       49,        4,       45
IVW, 0      , 0      ,        7,        0,        7
IVY, 0.16667, 0.02778,       18,        3,       15
IV_, 0      , 0      ,        4,        0,        4
IWI, 0.125  , 0.01562,        8,        1,        7
IWK, 0.05556, 0.00309,       18,        1,       17
IWL, 0.10526, 0.01108,       19,        2,       17
IWM, 0.125  , 0.01562,        8,        1,        7
IWN, 0      , 0      ,       13,        0,       13
IWP, 0.0625 , 0.00391,       16,        1,       15
IWQ, 0.1    , 0.01   ,       10,        1,        9
IWR, 0      , 0      ,       11,        0,       11
IWS, 0      , 0      ,        9,        0,        9
IWT, 0.16   , 0.0256 ,       25,        4,       21
IWV, 0      , 0      ,       13,        0,       13
IWW, 0      , 0      ,        2,        0,        2
IWY, 0.28571, 0.08163,        7,        2,        5
IYI, 0.1875 , 0.03516,       16,        3,       13
IYK, 0.14634, 0.02142,       41,        6,       35
IYL, 0.13514, 0.01826,       37,        5,       32
IYM, 0.09091, 0.00826,       11,        1,       10
IYN, 0.15556, 0.0242 ,       45,        7,       38
IYP, 0.11765, 0.01384,       34,        4,       30
IYQ, 0.0625 , 0.00391,       32,        2,       30
IYR, 0.13043, 0.01701,       46,        6,       40
IYS, 0.16327, 0.02666,       49,        8,       41
IYT, 0.17857, 0.03189,       28,        5,       23
IYV, 0.05263, 0.00277,       38,        2,       36
IYW, 0      , 0      ,        5,        0,        5
IYY, 0.11538, 0.01331,       26,        3,       23
IY_, 0      , 0      ,        3,        0,        3
KAK, 0      , 0      ,       42,        0,       42
KAL, 0.04167, 0.00174,      144,        6,      138
KAM, 0      , 0      ,       43,        0,       43
KAN, 0.04348, 0.00189,       46,        2,       44
KAP, 0.03922, 0.00154,       51,        2,       49
KAQ, 0.025  , 0.00063,       40,        1,       39
KAR, 0.03125, 0.00098,       64,        2,       62
KAS, 0.0566 , 0.0032 ,       53,        3,       50
KAT, 0.0303 , 0.00092,       66,        2,       64
KAV, 0.08333, 0.00694,       96,        8,       88
KAW, 0      , 0      ,        7,        0,        7
KAY, 0.09375, 0.00879,       32,        3,       29
KA_, 0      , 0      ,       12,        0,       12
KCK, 0      , 0      ,       11,        0,       11
KCL, 0.03704, 0.00137,       27,        1,       26
KCM, 0      , 0      ,        7,        0,        7
KCN, 0      , 0      ,       11,        0,       11
KCP, 0.04545, 0.00207,       22,        1,       21
KCQ, 0      , 0      ,       14,        0,       14
KCR, 0      , 0      ,       18,        0,       18
KCS, 0      , 0      ,       17,        0,       17
KCT, 0      , 0      ,       10,        0,       10
KCV, 0.04545, 0.00207,       22,        1,       21
KCY, 0.09091, 0.00826,       11,        1,       10
KC_, 0      , 0      ,        1,        0,        1
KDK, 0.02041, 0.00042,       49,        1,       48
KDL, 0.02381, 0.00057,      168,        4,      164
KDM, 0.08824, 0.00779,       34,        3,       31
KDN, 0      , 0      ,       78,        0,       78
KDP, 0.05333, 0.00284,       75,        4,       71
KDQ, 0.02273, 0.00052,       44,        1,       43
KDR, 0.06349, 0.00403,       63,        4,       59
KDS, 0.03488, 0.00122,       86,        3,       83
KDT, 0.02299, 0.00053,       87,        2,       85
KDV, 0.03297, 0.00109,       91,        3,       88
KDW, 0.13043, 0.01701,       23,        3,       20
KDY, 0.03448, 0.00119,       58,        2,       56
KD_, 0      , 0      ,        8,        0,        8
KEK, 0      , 0      ,       69,        0,       69
KEL, 0.02917, 0.00085,      240,        7,      233
KEM, 0.02   , 0.0004 ,       50,        1,       49
KEN, 0.01429, 0.0002 ,       70,        1,       69
KEP, 0      , 0      ,       66,        0,       66
KEQ, 0.04   , 0.0016 ,       75,        3,       72
KER, 0.05747, 0.0033 ,       87,        5,       82
KES, 0.0198 , 0.00039,      101,        2,       99
KET, 0.02353, 0.00055,       85,        2,       83
KEV, 0.04027, 0.00162,      149,        6,      143
KEW, 0.04   , 0.0016 ,       25,        1,       24
KEY, 0.0339 , 0.00115,       59,        2,       57
KE_, 0.125  , 0.01562,        8,        1,        7
KFK, 0      , 0      ,       21,        0,       21
KFL, 0.13846, 0.01917,       65,        9,       56
KFM, 0.35714, 0.12755,       14,        5,        9
KFN, 0.03922, 0.00154,       51,        2,       49
KFP, 0.17647, 0.03114,       34,        6,       28
KFQ, 0.03226, 0.00104,       31,        1,       30
KFR, 0.18182, 0.03306,       33,        6,       27
KFS, 0.08511, 0.00724,       47,        4,       43
KFT, 0.08571, 0.00735,       35,        3,       32
KFV, 0.04348, 0.00189,       46,        2,       44
KFW, 0      , 0      ,        9,        0,        9
KFY, 0.2439 , 0.05949,       41,       10,       31
KF_, 0      , 0      ,        2,        0,        2
KGK, 0.07843, 0.00615,       51,        4,       47
KGL, 0.0297 , 0.00088,      101,        3,       98
KGM, 0.11429, 0.01306,       35,        4,       31
KGN, 0.03947, 0.00156,       76,        3,       73
KGP, 0.01818, 0.00033,       55,        1,       54
KGQ, 0.02041, 0.00042,       49,        1,       48
KGR, 0.05455, 0.00298,       55,        3,       52
KGS, 0.02198, 0.00048,       91,        2,       89
KGT, 0.02381, 0.00057,       84,        2,       82
KGV, 0.04762, 0.00227,       84,        4,       80
KGW, 0.07692, 0.00592,       13,        1,       12
KGY, 0.01786, 0.00032,       56,        1,       55
KG_, 0      , 0      ,       11,        0,       11
KHK, 0.06667, 0.00444,       15,        1,       14
KHL, 0.13725, 0.01884,       51,        7,       44
KHM, 0.05263, 0.00277,       19,        1,       18
KHN, 0.04545, 0.00207,       22,        1,       21
KHP, 0.05882, 0.00346,       17,        1,       16
KHQ, 0.0625 , 0.00391,       16,        1,       15
KHR, 0.04762, 0.00227,       21,        1,       20
KHS, 0.06452, 0.00416,       31,        2,       29
KHT, 0.11111, 0.01235,       18,        2,       16
KHV, 0.14706, 0.02163,       34,        5,       29
KHW, 0      , 0      ,        5,        0,        5
KHY, 0.07692, 0.00592,       26,        2,       24
KH_, 0      , 0      ,        3,        0,        3
KIK, 0.05128, 0.00263,       39,        2,       37
KIL, 0.09184, 0.00843,       98,        9,       89
KIM, 0.04167, 0.00174,       24,        1,       23
KIN, 0.12069, 0.01457,       58,        7,       51
KIP, 0.01961, 0.00038,       51,        1,       50
KIQ, 0.04444, 0.00198,       45,        2,       43
KIR, 0.01695, 0.00029,       59,        1,       58
KIS, 0.125  , 0.01562,       64,        8,       56
KIT, 0.04167, 0.00174,       48,        2,       46
KIV, 0.05479, 0.003  ,       73,        4,       69
KIW, 0.25   , 0.0625 ,       16,        4,       12
KIY, 0.1    , 0.01   ,       40,        4,       36
KI_, 0      , 0      ,        5,        0,        5
KKK, 0.05357, 0.00287,       56,        3,       53
KKL, 0.04   , 0.0016 ,      200,        8,      192
KKM, 0.06818, 0.00465,       44,        3,       41
KKN, 0.01515, 0.00023,       66,        1,       65
KKP, 0.04255, 0.00181,       47,        2,       45
KKQ, 0.04444, 0.00198,       45,        2,       43
KKR, 0.02857, 0.00082,       70,        2,       68
KKS, 0.01562, 0.00024,       64,        1,       63
KKT, 0.02703, 0.00073,       74,        2,       72
KKV, 0.03704, 0.00137,      108,        4,      104
KKW, 0.05263, 0.00277,       38,        2,       36
KKY, 0.07018, 0.00492,       57,        4,       53
KK_, 0      , 0      ,       15,        0,       15
KLK, 0.11475, 0.01317,       61,        7,       54
KLL, 0.1206 , 0.01455,      199,       24,      175
KLM, 0.07317, 0.00535,       41,        3,       38
KLN, 0.0404 , 0.00163,       99,        4,       95
KLP, 0.03797, 0.00144,       79,        3,       76
KLQ, 0.07143, 0.0051 ,       84,        6,       78
KLR, 0.02151, 0.00046,       93,        2,       91
KLS, 0.09322, 0.00869,      118,       11,      107
KLT, 0.06977, 0.00487,       86,        6,       80
KLV, 0.07857, 0.00617,      140,       11,      129
KLW, 0.11111, 0.01235,       18,        2,       16
KLY, 0.09231, 0.00852,       65,        6,       59
KL_, 0      , 0      ,       11,        0,       11
KMK, 0.25   , 0.0625 ,       24,        6,       18
KML, 0.025  , 0.00063,       40,        1,       39
KMM, 0.15385, 0.02367,       13,        2,       11
KMN, 0.11765, 0.01384,       17,        2,       15
KMP, 0      , 0      ,       13,        0,       13
KMQ, 0.11111, 0.01235,       18,        2,       16
KMR, 0.11765, 0.01384,       17,        2,       15
KMS, 0      , 0      ,       27,        0,       27
KMT, 0.09091, 0.00826,       22,        2,       20
KMV, 0      , 0      ,       27,        0,       27
KMW, 0      , 0      ,        3,        0,        3
KMY, 0.125  , 0.01562,        8,        1,        7
KM_, 0      , 0      ,       12,        0,       12
KNK, 0      , 0      ,       38,        0,       38
KNL, 0.02655, 0.0007 ,      113,        3,      110
KNM, 0.03125, 0.00098,       32,        1,       31
KNN, 0.06383, 0.00407,       47,        3,       44
KNP, 0.06122, 0.00375,       49,        3,       46
KNQ, 0.02381, 0.00057,       42,        1,       41
KNR, 0.02632, 0.00069,       38,        1,       37
KNS, 0.0597 , 0.00356,       67,        4,       63
KNT, 0.05769, 0.00333,       52,        3,       49
KNV, 0.05333, 0.00284,       75,        4,       71
KNW, 0.05882, 0.00346,       17,        1,       16
KNY, 0.08824, 0.00779,       34,        3,       31
KN_, 0      , 0      ,        6,        0,        6
KPK, 0      , 0      ,       25,        0,       25
KPL, 0.03125, 0.00098,       96,        3,       93
KPM, 0.07407, 0.00549,       27,        2,       25
KPN, 0.06383, 0.00407,       47,        3,       44
KPP, 0.025  , 0.00063,       40,        1,       39
KPQ, 0.07143, 0.0051 ,       28,        2,       26
KPR, 0.04444, 0.00198,       45,        2,       43
KPS, 0.03175, 0.00101,       63,        2,       61
KPT, 0.07843, 0.00615,       51,        4,       47
KPV, 0.01471, 0.00022,       68,        1,       67
KPW, 0.09091, 0.00826,       11,        1,       10
KPY, 0      , 0      ,       30,        0,       30
KP_, 0      , 0      ,        8,        0,        8
KQK, 0.05263, 0.00277,       19,        1,       18
KQL, 0.06731, 0.00453,      104,        7,       97
KQM, 0.14815, 0.02195,       27,        4,       23
KQN, 0.03125, 0.00098,       32,        1,       31
KQP, 0      , 0      ,       31,        0,       31
KQQ, 0.02041, 0.00042,       49,        1,       48
KQR, 0      , 0      ,       32,        0,       32
KQS, 0.05882, 0.00346,       51,        3,       48
KQT, 0.06667, 0.00444,       30,        2,       28
KQV, 0.06061, 0.00367,       66,        4,       62
KQW, 0.07692, 0.00592,       13,        1,       12
KQY, 0.07895, 0.00623,       38,        3,       35
KQ_, 0      , 0      ,        6,        0,        6
KRK, 0.075  , 0.00562,       40,        3,       37
KRL, 0.01724, 0.0003 ,      116,        2,      114
KRM, 0.03333, 0.00111,       30,        1,       29
KRN, 0.0625 , 0.00391,       32,        2,       30
KRP, 0.03226, 0.00104,       31,        1,       30
KRQ, 0.05882, 0.00346,       34,        2,       32
KRR, 0.01587, 0.00025,       63,        1,       62
KRS, 0.12121, 0.01469,       66,        8,       58
KRT, 0.0625 , 0.00391,       64,        4,       60
KRV, 0.04286, 0.00184,       70,        3,       67
KRW, 0.12903, 0.01665,       31,        4,       27
KRY, 0.075  , 0.00562,       40,        3,       37
KR_, 0.16667, 0.02778,       12,        2,       10
KSK, 0.02632, 0.00069,       38,        1,       37
KSL, 0.0229 , 0.00052,      131,        3,      128
KSM, 0.03704, 0.00137,       27,        1,       26
KSN, 0.08   , 0.0064 ,       50,        4,       46
KSP, 0.01587, 0.00025,       63,        1,       62
KSQ, 0.025  , 0.00063,       40,        1,       39
KSR, 0.05455, 0.00298,       55,        3,       52
KSS, 0.04   , 0.0016 ,       75,        3,       72
KST, 0.04286, 0.00184,       70,        3,       67
KSV, 0.01562, 0.00024,       64,        1,       63
KSW, 0      , 0      ,       16,        0,       16
KSY, 0.05455, 0.00298,       55,        3,       52
KS_, 0      , 0      ,        8,        0,        8
KTK, 0      , 0      ,       37,        0,       37
KTL, 0.06338, 0.00402,      142,        9,      133
KTM, 0      , 0      ,       24,        0,       24
KTN, 0.03922, 0.00154,       51,        2,       49
KTP, 0.01429, 0.0002 ,       70,        1,       69
KTQ, 0.06977, 0.00487,       43,        3,       40
KTR, 0.04   , 0.0016 ,       50,        2,       48
KTS, 0.05556, 0.00309,       54,        3,       51
KTT, 0.08824, 0.00779,       68,        6,       62
KTV, 0.07407, 0.00549,       81,        6,       75
KTW, 0      , 0      ,       20,        0,       20
KTY, 0.06897, 0.00476,       58,        4,       54
KT_, 0      , 0      ,        4,        0,        4
KVK, 0.15385, 0.02367,       39,        6,       33
KVL, 0.04545, 0.00207,      154,        7,      147
KVM, 0.13793, 0.01902,       29,        4,       25
KVN, 0.07018, 0.00492,       57,        4,       53
KVP, 0.05769, 0.00333,       52,        3,       49
KVQ, 0.05128, 0.00263,       39,        2,       37
KVR, 0.08929, 0.00797,       56,        5,       51
KVS, 0.03448, 0.00119,       87,        3,       84
KVT, 0.03896, 0.00152,       77,        3,       74
KVV, 0.08654, 0.00749,      104,        9,       95
KVW, 0.16667, 0.02778,       18,        3,       15
KVY, 0.075  , 0.00562,       40,        3,       37
KV_, 0      , 0      ,        2,        0,        2
KWK, 0.27273, 0.07438,       11,        3,        8
KWL, 0.04545, 0.00207,       22,        1,       21
KWM, 0.125  , 0.01562,        8,        1,        7
KWN, 0.15385, 0.02367,       13,        2,       11
KWP, 0      , 0      ,        7,        0,        7
KWQ, 0.125  , 0.01562,       16,        2,       14
KWR, 0.42857, 0.18367,       14,        6,        8
KWS, 0.05882, 0.00346,       17,        1,       16
KWT, 0.28571, 0.08163,        7,        2,        5
KWV, 0.27586, 0.0761 ,       29,        8,       21
KWW, 0.14286, 0.02041,        7,        1,        6
KWY, 0.13333, 0.01778,       15,        2,       13
KW_, 0      , 0      ,        2,        0,        2
KYK, 0.03846, 0.00148,       26,        1,       25
KYL, 0.06061, 0.00367,       66,        4,       62
KYM, 0      , 0      ,       11,        0,       11
KYN, 0.15385, 0.02367,       39,        6,       33
KYP, 0.07692, 0.00592,       26,        2,       24
KYQ, 0      , 0      ,       40,        0,       40
KYR, 0.22727, 0.05165,       44,       10,       34
KYS, 0.01887, 0.00036,       53,        1,       52
KYT, 0.06818, 0.00465,       44,        3,       41
KYV, 0.04255, 0.00181,       47,        2,       45
KYW, 0      , 0      ,       13,        0,       13
KYY, 0.15556, 0.0242 ,       45,        7,       38
LAL, 0.05333, 0.00284,       75,        4,       71
LAM, 0.06061, 0.00367,       33,        2,       31
LAN, 0.03191, 0.00102,       94,        3,       91
LAP, 0.10811, 0.01169,      111,       12,       99
LAQ, 0.05797, 0.00336,      138,        8,      130
LAR, 0.03448, 0.00119,      116,        4,      112
LAS, 0.05645, 0.00319,      124,        7,      117
LAT, 0.0495 , 0.00245,      101,        5,       96
LAV, 0.05455, 0.00298,      110,        6,      104
LAW, 0.04762, 0.00227,       21,        1,       20
LAY, 0.06818, 0.00465,       44,        3,       41
LA_, 0      , 0      ,        8,        0,        8
LCL, 0.13043, 0.01701,       23,        3,       20
LCM, 0      , 0      ,        7,        0,        7
LCN, 0.08   , 0.0064 ,       25,        2,       23
LCP, 0.15789, 0.02493,       19,        3,       16
LCQ, 0.04762, 0.00227,       21,        1,       20
LCR, 0.02941, 0.00087,       34,        1,       33
LCS, 0.06897, 0.00476,       29,        2,       27
LCT, 0.07692, 0.00592,       26,        2,       24
LCV, 0.08   , 0.0064 ,       25,        2,       23
LCW, 0      , 0      ,        1,        0,        1
LCY, 0      , 0      ,       23,        0,       23
LC_, 0      , 0      ,        2,        0,        2
LDL, 0.02985, 0.00089,       67,        2,       65
LDM, 0.09804, 0.00961,       51,        5,       46
LDN, 0.03125, 0.00098,       96,        3,       93
LDP, 0.06504, 0.00423,      123,        8,      115
LDQ, 0.05618, 0.00316,       89,        5,       84
LDR, 0.07258, 0.00527,      124,        9,      115
LDS, 0.09524, 0.00907,      147,       14,      133
LDT, 0.05825, 0.00339,      103,        6,       97
LDV, 0.07042, 0.00496,      142,       10,      132
LDW, 0.04167, 0.00174,       24,        1,       23
LDY, 0.09524, 0.00907,       63,        6,       57
LD_, 0      , 0      ,        6,        0,        6
LEL, 0.04545, 0.00207,      110,        5,      105
LEM, 0.03704, 0.00137,       54,        2,       52
LEN, 0.06   , 0.0036 ,      150,        9,      141
LEP, 0.06195, 0.00384,      113,        7,      106
LEQ, 0.08392, 0.00704,      143,       12,      131
LER, 0.04511, 0.00204,      133,        6,      127
LES, 0.04196, 0.00176,      143,        6,      137
LET, 0.05469, 0.00299,      128,        7,      121
LEV, 0.04545, 0.00207,      154,        7,      147
LEW, 0.04545, 0.00207,       22,        1,       21
LEY, 0.03333, 0.00111,       60,        2,       58
LE_, 0.05882, 0.00346,       17,        1,       16
LFL, 0.11111, 0.01235,       45,        5,       40
LFM, 0.06667, 0.00444,       15,        1,       14
LFN, 0.09302, 0.00865,       43,        4,       39
LFP, 0.12069, 0.01457,       58,        7,       51
LFQ, 0.0566 , 0.0032 ,       53,        3,       50
LFR, 0.10145, 0.01029,       69,        7,       62
LFS, 0.04545, 0.00207,       88,        4,       84
LFT, 0.06897, 0.00476,       58,        4,       54
LFV, 0.11594, 0.01344,       69,        8,       61
LFW, 0      , 0      ,        3,        0,        3
LFY, 0.10526, 0.01108,       38,        4,       34
LF_, 0.2    , 0.04   ,        5,        1,        4
LGL, 0.1039 , 0.01079,       77,        8,       69
LGM, 0.08571, 0.00735,       35,        3,       32
LGN, 0.04494, 0.00202,       89,        4,       85
LGP, 0.01515, 0.00023,       66,        1,       65
LGQ, 0.04   , 0.0016 ,       75,        3,       72
LGR, 0.03571, 0.00128,      112,        4,      108
LGS, 0.02158, 0.00047,      139,        3,      136
LGT, 0.04167, 0.00174,       96,        4,       92
LGV, 0.09302, 0.00865,       86,        8,       78
LGW, 0      , 0      ,       22,        0,       22
LGY, 0.06154, 0.00379,       65,        4,       61
LG_, 0      , 0      ,        9,        0,        9
LHL, 0.05   , 0.0025 ,       40,        2,       38
LHM, 0      , 0      ,       17,        0,       17
LHN, 0.08   , 0.0064 ,       50,        4,       46
LHP, 0.08333, 0.00694,       48,        4,       44
LHQ, 0.03846, 0.00148,       52,        2,       50
LHR, 0.03125, 0.00098,       64,        2,       62
LHS, 0.09259, 0.00857,       54,        5,       49
LHT, 0.05263, 0.00277,       38,        2,       36
LHV, 0.04   , 0.0016 ,       50,        2,       48
LHW, 0.28571, 0.08163,        7,        2,        5
LHY, 0.11111, 0.01235,       36,        4,       32
LH_, 0      , 0      ,        2,        0,        2
LIL, 0.16279, 0.0265 ,       43,        7,       36
LIM, 0      , 0      ,       23,        0,       23
LIN, 0.11268, 0.0127 ,       71,        8,       63
LIP, 0.06329, 0.00401,       79,        5,       74
LIQ, 0.07895, 0.00623,       76,        6,       70
LIR, 0.0625 , 0.00391,       80,        5,       75
LIS, 0.04274, 0.00183,      117,        5,      112
LIT, 0.03797, 0.00144,       79,        3,       76
LIV, 0.0625 , 0.00391,       64,        4,       60
LIW, 0.23077, 0.05325,       13,        3,       10
LIY, 0.08333, 0.00694,       36,        3,       33
LI_, 0.14286, 0.02041,        7,        1,        6
LKL, 0.05405, 0.00292,      111,        6,      105
LKM, 0.07317, 0.00535,       41,        3,       38
LKN, 0.10169, 0.01034,      118,       12,      106
LKP, 0.0241 , 0.00058,       83,        2,       81
LKQ, 0.05607, 0.00314,      107,        6,      101
LKR, 0.07752, 0.00601,      129,       10,      119
LKS, 0.0679 , 0.00461,      162,       11,      151
LKT, 0.02128, 0.00045,      141,        3,      138
LKV, 0.02878, 0.00083,      139,        4,      135
LKW, 0.07317, 0.00535,       41,        3,       38
LKY, 0.125  , 0.01562,       64,        8,       56
LK_, 0.05556, 0.00309,       18,        1,       17
LLL, 0.07071, 0.005  ,       99,        7,       92
LLM, 0.09302, 0.00865,       43,        4,       39
LLN, 0.04027, 0.00162,      149,        6,      143
LLP, 0.06667, 0.00444,      150,       10,      140
LLQ, 0.09677, 0.00937,      155,       15,      140
LLR, 0.08805, 0.00775,      159,       14,      145
LLS, 0.05464, 0.00299,      183,       10,      173
LLT, 0.09286, 0.00862,      140,       13,      127
LLV, 0.11607, 0.01347,      112,       13,       99
LLW, 0.05   , 0.0025 ,       20,        1,       19
LLY, 0.07692, 0.00592,       52,        4,       48
LL_, 0      , 0      ,        8,        0,        8
LML, 0.16667, 0.02778,       18,        3,       15
LMM, 0.35714, 0.12755,       14,        5,        9
LMN, 0.11111, 0.01235,       36,        4,       32
LMP, 0.03571, 0.00128,       28,        1,       27
LMQ, 0.06818, 0.00465,       44,        3,       41
LMR, 0.02632, 0.00069,       38,        1,       37
LMS, 0.08929, 0.00797,       56,        5,       51
LMT, 0.14286, 0.02041,       28,        4,       24
LMV, 0.17143, 0.02939,       35,        6,       29
LMW, 0      , 0      ,        6,        0,        6
LMY, 0      , 0      ,       13,        0,       13
LM_, 0.11111, 0.01235,        9,        1,        8
LNL, 0.02899, 0.00084,       69,        2,       67
LNM, 0.06452, 0.00416,       31,        2,       29
LNN, 0.04167, 0.00174,       96,        4,       92
LNP, 0.04082, 0.00167,       98,        4,       94
LNQ, 0.07407, 0.00549,       54,        4,       50
LNR, 0.06742, 0.00454,       89,        6,       83
LNS, 0.09649, 0.00931,      114,       11,      103
LNT, 0.04819, 0.00232,       83,        4,       79
LNV, 0.06122, 0.00375,       98,        6,       92
LNW, 0.15789, 0.02493,       19,        3,       16
LNY, 0.01887, 0.00036,       53,        1,       52
LN_, 0      , 0      ,        9,        0,        9
LPL, 0.0137 , 0.00019,       73,        1,       72
LPM, 0.05882, 0.00346,       17,        1,       16
LPN, 0.06757, 0.00457,       74,        5,       69
LPP, 0.03968, 0.00157,      126,        5,      121
LPQ, 0.01449, 0.00021,       69,        1,       68
LPR, 0.03896, 0.00152,       77,        3,       74
LPS, 0.03738, 0.0014 ,      107,        4,      103
LPT, 0.07447, 0.00555,       94,        7,       87
LPV, 0.024  , 0.00058,      125,        3,      122
LPW, 0.10714, 0.01148,       28,        3,       25
LPY, 0.05882, 0.00346,       51,        3,       48
LP_, 0.11111, 0.01235,        9,        1,        8
LQL, 0.12821, 0.01644,       78,       10,       68
LQM, 0      , 0      ,       37,        0,       37
LQN, 0.12048, 0.01452,       83,       10,       73
LQP, 0.03509, 0.00123,       57,        2,       55
LQQ, 0.0463 , 0.00214,      108,        5,      103
LQR, 0.04255, 0.00181,       94,        4,       90
LQS, 0.05217, 0.00272,      115,        6,      109
LQT, 0.02817, 0.00079,       71,        2,       69
LQV, 0.05085, 0.00259,      118,        6,      112
LQW, 0.04167, 0.00174,       24,        1,       23
LQY, 0.04918, 0.00242,       61,        3,       58
LQ_, 0      , 0      ,        3,        0,        3
LRL, 0.11   , 0.0121 ,      100,       11,       89
LRM, 0.1087 , 0.01181,       46,        5,       41
LRN, 0.08824, 0.00779,      102,        9,       93
LRP, 0.09783, 0.00957,       92,        9,       83
LRQ, 0.06061, 0.00367,       99,        6,       93
LRR, 0.11504, 0.01324,      113,       13,      100
LRS, 0.0596 , 0.00355,      151,        9,      142
LRT, 0.12088, 0.01461,       91,       11,       80
LRV, 0.02759, 0.00076,      145,        4,      141
LRW, 0.03333, 0.00111,       30,        1,       29
LRY, 0.08571, 0.00735,       70,        6,       64
LR_, 0      , 0      ,        5,        0,        5
LSL, 0.14286, 0.02041,       98,       14,       84
LSM, 0.02703, 0.00073,       37,        1,       36
LSN, 0.06522, 0.00425,       92,        6,       86
LSP, 0.03509, 0.00123,      114,        4,      110
LSQ, 0.01818, 0.00033,      110,        2,      108
LSR, 0.02362, 0.00056,      127,        3,      124
LSS, 0.08523, 0.00726,      176,       15,      161
LST, 0.09483, 0.00899,      116,       11,      105
LSV, 0.01724, 0.0003 ,      116,        2,      114
LSW, 0.0625 , 0.00391,       32,        2,       30
LSY, 0.05357, 0.00287,       56,        3,       53
LS_, 0.11765, 0.01384,       17,        2,       15
LTL, 0.03077, 0.00095,       65,        2,       63
LTM, 0.04651, 0.00216,       43,        2,       41
LTN, 0.05208, 0.00271,       96,        5,       91
LTP, 0      , 0      ,      129,        0,      129
LTQ, 0.03371, 0.00114,       89,        3,       86
LTR, 0.05376, 0.00289,       93,        5,       88
LTS, 0.09244, 0.00854,      119,       11,      108
LTT, 0.08   , 0.0064 ,      100,        8,       92
LTV, 0.06081, 0.0037 ,      148,        9,      139
LTW, 0.07692, 0.00592,       26,        2,       24
LTY, 0.03175, 0.00101,       63,        2,       61
LT_, 0      , 0      ,        2,        0,        2
LVL, 0.04   , 0.0016 ,       75,        3,       72
LVM, 0.09756, 0.00952,       41,        4,       37
LVN, 0.05556, 0.00309,       72,        4,       68
LVP, 0.02913, 0.00085,      103,        3,      100
LVQ, 0.05208, 0.00271,       96,        5,       91
LVR, 0.05185, 0.00269,      135,        7,      128
LVS, 0.072  , 0.00518,      125,        9,      116
LVT, 0.07143, 0.0051 ,      112,        8,      104
LVV, 0.09524, 0.00907,      105,       10,       95
LVW, 0      , 0      ,        9,        0,        9
LVY, 0.02778, 0.00077,       36,        1,       35
LV_, 0      , 0      ,        4,        0,        4
LWL, 0.07692, 0.00592,       13,        1,       12
LWM, 0      , 0      ,        6,        0,        6
LWN, 0.2    , 0.04   ,       20,        4,       16
LWP, 0.14286, 0.02041,       21,        3,       18
LWQ, 0.13636, 0.0186 ,       22,        3,       19
LWR, 0      , 0      ,       25,        0,       25
LWS, 0.25   , 0.0625 ,       24,        6,       18
LWT, 0.09524, 0.00907,       21,        2,       19
LWV, 0.3    , 0.09   ,       20,        6,       14
LWW, 0.11111, 0.01235,        9,        1,        8
LWY, 0.2    , 0.04   ,       15,        3,       12
LYL, 0.20455, 0.04184,       44,        9,       35
LYM, 0.2381 , 0.05669,       21,        5,       16
LYN, 0.1    , 0.01   ,       70,        7,       63
LYP, 0.13559, 0.01839,       59,        8,       51
LYQ, 0.05769, 0.00333,       52,        3,       49
LYR, 0.18182, 0.03306,       77,       14,       63
LYS, 0.09091, 0.00826,       88,        8,       80
LYT, 0.09836, 0.00967,       61,        6,       55
LYV, 0.08621, 0.00743,       58,        5,       53
LYW, 0.11111, 0.01235,        9,        1,        8
LYY, 0.19608, 0.03845,       51,       10,       41
LY_, 0      , 0      ,        5,        0,        5
MAM, 0      , 0      ,        4,        0,        4
MAN, 0      , 0      ,       15,        0,       15
MAP, 0.08   , 0.0064 ,       25,        2,       23
MAQ, 0      , 0      ,       26,        0,       26
MAR, 0      , 0      ,       29,        0,       29
MAS, 0      , 0      ,       32,        0,       32
MAT, 0.08   , 0.0064 ,       25,        2,       23
MAV, 0.06061, 0.00367,       33,        2,       31
MAW, 0      , 0      ,        6,        0,        6
MAY, 0.125  , 0.01562,       16,        2,       14
MA_, 0      , 0      ,       10,        0,       10
MCN, 0      , 0      ,        5,        0,        5
MCP, 0      , 0      ,        5,        0,        5
MCQ, 0      , 0      ,        5,        0,        5
MCR, 0.5    , 0.25   ,        4,        2,        2
MCS, 0      , 0      ,        6,        0,        6
MCT, 0      , 0      ,        5,        0,        5
MCV, 0      , 0      ,        4,        0,        4
MC_, 0.33333, 0.11111,        3,        1,        2
MDM, 0      , 0      ,        4,        0,        4
MDN, 0      , 0      ,       18,        0,       18
MDP, 0.03448, 0.00119,       29,        1,       28
MDQ, 0.0303 , 0.00092,       33,        1,       32
MDR, 0.13043, 0.01701,       46,        6,       40
MDS, 0.09375, 0.00879,       32,        3,       29
MDT, 0.03571, 0.00128,       28,        1,       27
MDV, 0.03571, 0.00128,       28,        1,       27
MDW, 0      , 0      ,        8,        0,        8
MDY, 0.05556, 0.00309,       18,        1,       17
MD_, 0      , 0      ,        1,        0,        1
MEM, 0.09091, 0.00826,       11,        1,       10
MEN, 0.03333, 0.00111,       30,        1,       29
MEP, 0.13043, 0.01701,       23,        3,       20
MEQ, 0      , 0      ,       34,        0,       34
MER, 0      , 0      ,       29,        0,       29
MES, 0.06452, 0.00416,       31,        2,       29
MET, 0.08696, 0.00756,       23,        2,       21
MEV, 0.04444, 0.00198,       45,        2,       43
MEW, 0.125  , 0.01562,        8,        1,        7
MEY, 0.08696, 0.00756,       23,        2,       21
ME_, 0      , 0      ,        1,        0,        1
MFM, 0      , 0      ,        2,        0,        2
MFN, 0.1875 , 0.03516,       16,        3,       13
MFP, 0.16667, 0.02778,        6,        1,        5
MFQ, 0      , 0      ,        6,        0,        6
MFR, 0.26316, 0.06925,       19,        5,       14
MFS, 0.09524, 0.00907,       21,        2,       19
MFT, 0.07143, 0.0051 ,       14,        1,       13
MFV, 0.14286, 0.02041,       14,        2,       12
MFW, 0.2    , 0.04   ,        5,        1,        4
MFY, 0.22222, 0.04938,        9,        2,        7
MF_, 0      , 0      ,        2,        0,        2
MGM, 0      , 0      ,        5,        0,        5
MGN, 0      , 0      ,       20,        0,       20
MGP, 0.15789, 0.02493,       38,        6,       32
MGQ, 0.08333, 0.00694,       24,        2,       22
MGR, 0      , 0      ,       15,        0,       15
MGS, 0.03333, 0.00111,       30,        1,       29
MGT, 0.22222, 0.04938,       27,        6,       21
MGV, 0.06061, 0.00367,       33,        2,       31
MGW, 0.3    , 0.09   ,       10,        3,        7
MGY, 0      , 0      ,        9,        0,        9
MG_, 0      , 0      ,        4,        0,        4
MHM, 0      , 0      ,        3,        0,        3
MHN, 0      , 0      ,        5,        0,        5
MHP, 0      , 0      ,       12,        0,       12
MHQ, 0.07143, 0.0051 ,       14,        1,       13
MHR, 0.08333, 0.00694,       12,        1,       11
MHS, 0      , 0      ,       27,        0,       27
MHT, 0      , 0      ,        7,        0,        7
MHV, 0      , 0      ,        8,        0,        8
MHW, 0.5    , 0.25   ,        4,        2,        2
MHY, 0      , 0      ,        6,        0,        6
MH_, 0      , 0      ,        7,        0,        7
MIM, 0      , 0      ,        2,        0,        2
MIN, 0.125  , 0.01562,       24,        3,       21
MIP, 0.05556, 0.00309,       18,        1,       17
MIQ, 0      , 0      ,       19,        0,       19
MIR, 0.13043, 0.01701,       23,        3,       20
MIS, 0.04167, 0.00174,       24,        1,       23
MIT, 0.04348, 0.00189,       23,        1,       22
MIV, 0.11111, 0.01235,       18,        2,       16
MIW, 0      , 0      ,        4,        0,        4
MIY, 0.16667, 0.02778,        6,        1,        5
MKM, 0.14286, 0.02041,        7,        1,        6
MKN, 0      , 0      ,       19,        0,       19
MKP, 0.03125, 0.00098,       32,        1,       31
MKQ, 0      , 0      ,       29,        0,       29
MKR, 0.0625 , 0.00391,       32,        2,       30
MKS, 0.03571, 0.00128,       28,        1,       27
MKT, 0.03704, 0.00137,       27,        1,       26
MKV, 0.03333, 0.00111,       30,        1,       29
MKW, 0      , 0      ,        6,        0,        6
MKY, 0      , 0      ,       16,        0,       16
MK_, 0      , 0      ,        2,        0,        2
MLM, 0      , 0      ,        8,        0,        8
MLN, 0.07692, 0.00592,       39,        3,       36
MLP, 0.09677, 0.00937,       31,        3,       28
MLQ, 0.125  , 0.01562,       32,        4,       28
MLR, 0      , 0      ,       31,        0,       31
MLS, 0      , 0      ,       36,        0,       36
MLT, 0.03704, 0.00137,       27,        1,       26
MLV, 0.0625 , 0.00391,       32,        2,       30
MLW, 0      , 0      ,        4,        0,        4
MLY, 0.11765, 0.01384,       17,        2,       15
ML_, 1      , 1      ,        2,        2,        0
MMM, 0      , 0      ,        1,        0,        1
MMN, 0.23077, 0.05325,       13,        3,       10
MMP, 0.25   , 0.0625 ,        4,        1,        3
MMQ, 0.46154, 0.21302,       13,        6,        7
MMR, 0.09091, 0.00826,       11,        1,       10
MMS, 0.16667, 0.02778,       12,        2,       10
MMT, 0.27273, 0.07438,       11,        3,        8
MMV, 0.23077, 0.05325,       13,        3,       10
MMW, 0      , 0      ,        1,        0,        1
MMY, 0.33333, 0.11111,        6,        2,        4
MM_, 0      , 0      ,        1,        0,        1
MNM, 0      , 0      ,        2,        0,        2
MNN, 0.28571, 0.08163,       14,        4,       10
MNP, 0      , 0      ,       17,        0,       17
MNQ, 0      , 0      ,       20,        0,       20
MNR, 0.05556, 0.00309,       18,        1,       17
MNS, 0.03226, 0.00104,       31,        1,       30
MNT, 0.13043, 0.01701,       23,        3,       20
MNV, 0      , 0      ,       18,        0,       18
MNW, 0      , 0      ,        4,        0,        4
MNY, 0      , 0      ,        8,        0,        8
MN_, 0      , 0      ,        2,        0,        2
MPM, 0.6    , 0.36   ,        5,        3,        2
MPN, 0      , 0      ,       20,        0,       20
MPP, 0.08333, 0.00694,       12,        1,       11
MPQ, 0      , 0      ,        8,        0,        8
MPR, 0.11111, 0.01235,       18,        2,       16
MPS, 0.03571, 0.00128,       28,        1,       27
MPT, 0.11111, 0.01235,       18,        2,       16
MPV, 0      , 0      ,       23,        0,       23
MPW, 0      , 0      ,        5,        0,        5
MPY, 0      , 0      ,        4,        0,        4
MP_, 0      , 0      ,        2,        0,        2
MQM, 0.28571, 0.08163,        7,        2,        5
MQN, 0      , 0      ,       18,        0,       18
MQP, 0.05263, 0.00277,       19,        1,       18
MQQ, 0.11111, 0.01235,       18,        2,       16
MQR, 0.2    , 0.04   ,       20,        4,       16
MQS, 0.09091, 0.00826,       22,        2,       20
MQT, 0.10526, 0.01108,       19,        2,       17
MQV, 0.1    , 0.01   ,       30,        3,       27
MQW, 0      , 0      ,        4,        0,        4
MQY, 0      , 0      ,       11,        0,       11
MQ_, 0      , 0      ,        4,        0,        4
MRM, 0      , 0      ,        7,        0,        7
MRN, 0.14286, 0.02041,       14,        2,       12
MRP, 0.06667, 0.00444,       15,        1,       14
MRQ, 0.07407, 0.00549,       27,        2,       25
MRR, 0.16129, 0.02601,       31,        5,       26
MRS, 0.04545, 0.00207,       22,        1,       21
MRT, 0.11765, 0.01384,       17,        2,       15
MRV, 0.09677, 0.00937,       31,        3,       28
MRW, 0      , 0      ,        5,        0,        5
MRY, 0.125  , 0.01562,       16,        2,       14
MR_, 0      , 0      ,        1,        0,        1
MSM, 0      , 0      ,        4,        0,        4
MSN, 0      , 0      ,       15,        0,       15
MSP, 0      , 0      ,       26,        0,       26
MSQ, 0.05882, 0.00346,       17,        1,       16
MSR, 0.06667, 0.00444,       30,        2,       28
MSS, 0.11111, 0.01235,       36,        4,       32
MST, 0.16129, 0.02601,       31,        5,       26
MSV, 0.06061, 0.00367,       33,        2,       31
MSW, 0      , 0      ,        4,        0,        4
MSY, 0.13793, 0.01902,       29,        4,       25
MS_, 0      , 0      ,        5,        0,        5
MTM, 0.11111, 0.01235,        9,        1,        8
MTN, 0      , 0      ,       17,        0,       17
MTP, 0      , 0      ,       17,        0,       17
MTQ, 0.07143, 0.0051 ,       14,        1,       13
MTR, 0.09524, 0.00907,       21,        2,       19
MTS, 0.03846, 0.00148,       26,        1,       25
MTT, 0      , 0      ,       16,        0,       16
MTV, 0.08333, 0.00694,       24,        2,       22
MTW, 0      , 0      ,        3,        0,        3
MTY, 0.15385, 0.02367,       13,        2,       11
MT_, 0      , 0      ,        2,        0,        2
MVM, 0      , 0      ,        6,        0,        6
MVN, 0      , 0      ,       12,        0,       12
MVP, 0      , 0      ,       26,        0,       26
MVQ, 0.0625 , 0.00391,       16,        1,       15
MVR, 0      , 0      ,       15,        0,       15
MVS, 0.07407, 0.00549,       27,        2,       25
MVT, 0.10345, 0.0107 ,       29,        3,       26
MVV, 0      , 0      ,       21,        0,       21
MVW, 0.28571, 0.08163,        7,        2,        5
MVY, 0.14286, 0.02041,       14,        2,       12
MWN, 0.5    , 0.25   ,        6,        3,        3
MWP, 0.5    , 0.25   ,        4,        2,        2
MWQ, 0.25   , 0.0625 ,        4,        1,        3
MWR, 0      , 0      ,        4,        0,        4
MWS, 0      , 0      ,        4,        0,        4
MWT, 0      , 0      ,        4,        0,        4
MWV, 0.25   , 0.0625 ,        4,        1,        3
MWW, 0.5    , 0.25   ,        2,        1,        1
MWY, 0.25   , 0.0625 ,        4,        1,        3
MYM, 0      , 0      ,        1,        0,        1
MYN, 0.11111, 0.01235,        9,        1,        8
MYP, 0.15385, 0.02367,       13,        2,       11
MYQ, 0.2    , 0.04   ,       10,        2,        8
MYR, 0      , 0      ,       13,        0,       13
MYS, 0.19048, 0.03628,       21,        4,       17
MYT, 0.25   , 0.0625 ,        8,        2,        6
MYV, 0.1    , 0.01   ,       10,        1,        9
MYW, 0.66667, 0.44444,        3,        2,        1
MYY, 0.1    , 0.01   ,       10,        1,        9
NAN, 0.04545, 0.00207,       22,        1,       21
NAP, 0      , 0      ,       41,        0,       41
NAQ, 0.07895, 0.00623,       38,        3,       35
NAR, 0.03448, 0.00119,       29,        1,       28
NAS, 0.08955, 0.00802,       67,        6,       61
NAT, 0.06818, 0.00465,       44,        3,       41
NAV, 0.02128, 0.00045,       47,        1,       46
NAW, 0      , 0      ,       16,        0,       16
NAY, 0.0303 , 0.00092,       33,        1,       32
NA_, 0      , 0      ,        4,        0,        4
NCN, 0      , 0      ,        3,        0,        3
NCP, 0      , 0      ,       10,        0,       10
NCQ, 0      , 0      ,       12,        0,       12
NCR, 0      , 0      ,       17,        0,       17
NCS, 0      , 0      ,       16,        0,       16
NCT, 0      , 0      ,       16,        0,       16
NCV, 0      , 0      ,       15,        0,       15
NCW, 0.25   , 0.0625 ,        4,        1,        3
NCY, 0.07692, 0.00592,       13,        1,       12
NDN, 0      , 0      ,       14,        0,       14
NDP, 0.05172, 0.00268,       58,        3,       55
NDQ, 0.02632, 0.00069,       38,        1,       37
NDR, 0.02174, 0.00047,       46,        1,       45
NDS, 0.01887, 0.00036,       53,        1,       52
NDT, 0.05556, 0.00309,       36,        2,       34
NDV, 0.03175, 0.00101,       63,        2,       61
NDW, 0.11765, 0.01384,       17,        2,       15
NDY, 0.14634, 0.02142,       41,        6,       35
ND_, 0      , 0      ,        2,        0,        2
NEN, 0.09091, 0.00826,       22,        2,       20
NEP, 0.04615, 0.00213,       65,        3,       62
NEQ, 0.025  , 0.00063,       40,        1,       39
NER, 0.03571, 0.00128,       56,        2,       54
NES, 0      , 0      ,       74,        0,       74
NET, 0.03226, 0.00104,       62,        2,       60
NEV, 0.02353, 0.00055,       85,        2,       83
NEW, 0.05556, 0.00309,       18,        1,       17
NEY, 0.03922, 0.00154,       51,        2,       49
NE_, 0      , 0      ,        6,        0,        6
NFN, 0      , 0      ,       19,        0,       19
NFP, 0.06061, 0.00367,       33,        2,       31
NFQ, 0.0303 , 0.00092,       33,        1,       32
NFR, 0.07895, 0.00623,       38,        3,       35
NFS, 0.07143, 0.0051 ,       56,        4,       52
NFT, 0.07143, 0.0051 ,       42,        3,       39
NFV, 0.08108, 0.00657,       37,        3,       34
NFW, 0.18182, 0.03306,       11,        2,        9
NFY, 0.2381 , 0.05669,       21,        5,       16
NF_, 0.33333, 0.11111,        3,        1,        2
NGN, 0.03226, 0.00104,       31,        1,       30
NGP, 0.05128, 0.00263,       39,        2,       37
NGQ, 0.02083, 0.00043,       48,        1,       47
NGR, 0.01562, 0.00024,       64,        1,       63
NGS, 0.05435, 0.00295,       92,        5,       87
NGT, 0.02632, 0.00069,       76,        2,       74
NGV, 0.07407, 0.00549,       81,        6,       75
NGW, 0.11111, 0.01235,       18,        2,       16
NGY, 0.13636, 0.0186 ,       44,        6,       38
NG_, 0      , 0      ,        5,        0,        5
NHN, 0.11111, 0.01235,        9,        1,        8
NHP, 0.04762, 0.00227,       21,        1,       20
NHQ, 0.14286, 0.02041,       14,        2,       12
NHR, 0.13333, 0.01778,       15,        2,       13
NHS, 0.1    , 0.01   ,       20,        2,       18
NHT, 0.04545, 0.00207,       22,        1,       21
NHV, 0.09091, 0.00826,       22,        2,       20
NHW, 0      , 0      ,        4,        0,        4
NHY, 0.09091, 0.00826,       11,        1,       10
NIN, 0.04   , 0.0016 ,       25,        1,       24
NIP, 0.03846, 0.00148,       52,        2,       50
NIQ, 0.06667, 0.00444,       30,        2,       28
NIR, 0.09091, 0.00826,       44,        4,       40
NIS, 0.09459, 0.00895,       74,        7,       67
NIT, 0.08065, 0.0065 ,       62,        5,       57
NIV, 0.07463, 0.00557,       67,        5,       62
NIW, 0.06667, 0.00444,       15,        1,       14
NIY, 0.15625, 0.02441,       32,        5,       27
NI_, 0      , 0      ,        6,        0,        6
NKN, 0.03846, 0.00148,       26,        1,       25
NKP, 0.02564, 0.00066,       39,        1,       38
NKQ, 0      , 0      ,       33,        0,       33
NKR, 0.0339 , 0.00115,       59,        2,       57
NKS, 0.11538, 0.01331,       52,        6,       46
NKT, 0.05   , 0.0025 ,       60,        3,       57
NKV, 0.0625 , 0.00391,       80,        5,       75
NKW, 0.09091, 0.00826,       11,        1,       10
NKY, 0.06383, 0.00407,       47,        3,       44
NK_, 0      , 0      ,        3,        0,        3
NLN, 0      , 0      ,       22,        0,       22
NLP, 0.08475, 0.00718,       59,        5,       54
NLQ, 0      , 0      ,       52,        0,       52
NLR, 0.03279, 0.00107,       61,        2,       59
NLS, 0.13636, 0.0186 ,       88,       12,       76
NLT, 0.05128, 0.00263,       78,        4,       74
NLV, 0.04651, 0.00216,       86,        4,       82
NLW, 0.125  , 0.01562,        8,        1,        7
NLY, 0.03846, 0.00148,       52,        2,       50
NL_, 0      , 0      ,        5,        0,        5
NMN, 0.14286, 0.02041,        7,        1,        6
NMP, 0.26316, 0.06925,       19,        5,       14
NMQ, 0.25   , 0.0625 ,       12,        3,        9
NMR, 0      , 0      ,       14,        0,       14
NMS, 0      , 0      ,       16,        0,       16
NMT, 0.0625 , 0.00391,       16,        1,       15
NMV, 0.15   , 0.0225 ,       20,        3,       17
NMW, 0.16667, 0.02778,        6,        1,        5
NMY, 0.09091, 0.00826,       11,        1,       10
NM_, 0.125  , 0.01562,        8,        1,        7
NNN, 0.05556, 0.00309,       18,        1,       17
NNP, 0.09756, 0.00952,       41,        4,       37
NNQ, 0      , 0      ,       26,        0,       26
NNR, 0.08333, 0.00694,       48,        4,       44
NNS, 0.02   , 0.0004 ,       50,        1,       49
NNT, 0.02778, 0.00077,       36,        1,       35
NNV, 0.05263, 0.00277,       57,        3,       54
NNW, 0.08333, 0.00694,       12,        1,       11
NNY, 0.06522, 0.00425,       46,        3,       43
NN_, 0      , 0      ,        5,        0,        5
NPN, 0.04878, 0.00238,       41,        2,       39
NPP, 0      , 0      ,       52,        0,       52
NPQ, 0.06667, 0.00444,       30,        2,       28
NPR, 0.04   , 0.0016 ,       25,        1,       24
NPS, 0.01429, 0.0002 ,       70,        1,       69
NPT, 0.03636, 0.00132,       55,        2,       53
NPV, 0.04167, 0.00174,       48,        2,       46
NPW, 0      , 0      ,        5,        0,        5
NPY, 0.07407, 0.00549,       27,        2,       25
NP_, 0      , 0      ,        3,        0,        3
NQN, 0.07143, 0.0051 ,       14,        1,       13
NQP, 0      , 0      ,       18,        0,       18
NQQ, 0      , 0      ,       35,        0,       35
NQR, 0.05882, 0.00346,       34,        2,       32
NQS, 0.1087 , 0.01181,       46,        5,       41
NQT, 0.06897, 0.00476,       29,        2,       27
NQV, 0.04651, 0.00216,       43,        2,       41
NQW, 0      , 0      ,        8,        0,        8
NQY, 0      , 0      ,       21,        0,       21
NRN, 0.05   , 0.0025 ,       20,        1,       19
NRP, 0.05556, 0.00309,       36,        2,       34
NRQ, 0.04545, 0.00207,       22,        1,       21
NRR, 0.04651, 0.00216,       43,        2,       41
NRS, 0.16327, 0.02666,       49,        8,       41
NRT, 0.1    , 0.01   ,       40,        4,       36
NRV, 0.0303 , 0.00092,       66,        2,       64
NRW, 0.15385, 0.02367,       13,        2,       11
NRY, 0.15217, 0.02316,       46,        7,       39
NR_, 0      , 0      ,        1,        0,        1
NSN, 0.07407, 0.00549,       27,        2,       25
NSP, 0.03846, 0.00148,       52,        2,       50
NSQ, 0.05882, 0.00346,       34,        2,       32
NSR, 0      , 0      ,       54,        0,       54
NSS, 0.04348, 0.00189,       92,        4,       88
NST, 0.03571, 0.00128,       56,        2,       54
NSV, 0.0597 , 0.00356,       67,        4,       63
NSW, 0      , 0      ,       13,        0,       13
NSY, 0      , 0      ,       30,        0,       30
NS_, 0.14286, 0.02041,        7,        1,        6
NTN, 0      , 0      ,       14,        0,       14
NTP, 0.04444, 0.00198,       45,        2,       43
NTQ, 0.03571, 0.00128,       28,        1,       27
NTR, 0      , 0      ,       30,        0,       30
NTS, 0.05769, 0.00333,       52,        3,       49
NTT, 0.08696, 0.00756,       46,        4,       42
NTV, 0.01471, 0.00022,       68,        1,       67
NTW, 0.06667, 0.00444,       15,        1,       14
NTY, 0.05263, 0.00277,       38,        2,       36
NVN, 0.125  , 0.01562,       24,        3,       21
NVP, 0.05128, 0.00263,       78,        4,       74
NVQ, 0.05   , 0.0025 ,       40,        2,       38
NVR, 0.04651, 0.00216,       43,        2,       41
NVS, 0.0303 , 0.00092,       66,        2,       64
NVT, 0.1129 , 0.01275,       62,        7,       55
NVV, 0.04412, 0.00195,       68,        3,       65
NVW, 0      , 0      ,       10,        0,       10
NVY, 0.06061, 0.00367,       33,        2,       31
NWN, 0.1    , 0.01   ,       10,        1,        9
NWP, 0      , 0      ,       11,        0,       11
NWQ, 0      , 0      ,        6,        0,        6
NWR, 0.06667, 0.00444,       15,        1,       14
NWS, 0      , 0      ,       20,        0,       20
NWT, 0.07692, 0.00592,       13,        1,       12
NWV, 0.125  , 0.01562,       16,        2,       14
NWW, 0      , 0      ,        4,        0,        4
NWY, 0.46154, 0.21302,       13,        6,        7
NYN, 0      , 0      ,       12,        0,       12
NYP, 0.11111, 0.01235,       36,        4,       32
NYQ, 0.17857, 0.03189,       28,        5,       23
NYR, 0.02564, 0.00066,       39,        1,       38
NYS, 0.09677, 0.00937,       31,        3,       28
NYT, 0.03125, 0.00098,       32,        1,       31
NYV, 0.21569, 0.04652,       51,       11,       40
NYW, 0      , 0      ,       14,        0,       14
NYY, 0.25   , 0.0625 ,       28,        7,       21
NY_, 0      , 0      ,        1,        0,        1
PAP, 0.03846, 0.00148,       26,        1,       25
PAQ, 0.02778, 0.00077,       36,        1,       35
PAR, 0.09091, 0.00826,       44,        4,       40
PAS, 0.01493, 0.00022,       67,        1,       66
PAT, 0.01852, 0.00034,       54,        1,       53
PAV, 0.03175, 0.00101,       63,        2,       61
PAW, 0.1    , 0.01   ,       10,        1,        9
PAY, 0.02632, 0.00069,       38,        1,       37
PA_, 0      , 0      ,        6,        0,        6
PCP, 0.07143, 0.0051 ,       14,        1,       13
PCQ, 0.08696, 0.00756,       23,        2,       21
PCR, 0.1    , 0.01   ,       10,        1,        9
PCS, 0.04348, 0.00189,       23,        1,       22
PCT, 0.14286, 0.02041,       21,        3,       18
PCV, 0.11765, 0.01384,       17,        2,       15
PCW, 0      , 0      ,        5,        0,        5
PCY, 0      , 0      ,        4,        0,        4
PDP, 0.12121, 0.01469,       33,        4,       29
PDQ, 0.07692, 0.00592,       52,        4,       48
PDR, 0.07692, 0.00592,       52,        4,       48
PDS, 0.04054, 0.00164,       74,        3,       71
PDT, 0      , 0      ,       68,        0,       68
PDV, 0.04054, 0.00164,       74,        3,       71
PDW, 0      , 0      ,       18,        0,       18
PDY, 0.07018, 0.00492,       57,        4,       53
PD_, 0      , 0      ,        7,        0,        7
PEP, 0.06897, 0.00476,       29,        2,       27
PEQ, 0.04878, 0.00238,       41,        2,       39
PER, 0.01515, 0.00023,       66,        1,       65
PES, 0.05128, 0.00263,       78,        4,       74
PET, 0.03175, 0.00101,       63,        2,       61
PEV, 0.09524, 0.00907,       84,        8,       76
PEW, 0.125  , 0.01562,       32,        4,       28
PEY, 0.09091, 0.00826,       44,        4,       40
PE_, 0      , 0      ,       15,        0,       15
PFP, 0.125  , 0.01562,       24,        3,       21
PFQ, 0.16667, 0.02778,       36,        6,       30
PFR, 0      , 0      ,       48,        0,       48
PFS, 0      , 0      ,       47,        0,       47
PFT, 0.10204, 0.01041,       49,        5,       44
PFV, 0.14286, 0.02041,       42,        6,       36
PFW, 0.14286, 0.02041,        7,        1,        6
PFY, 0      , 0      ,       18,        0,       18
PF_, 0      , 0      ,        1,        0,        1
PGP, 0      , 0      ,       21,        0,       21
PGQ, 0.04651, 0.00216,       43,        2,       41
PGR, 0.02128, 0.00045,       47,        1,       46
PGS, 0.02857, 0.00082,      105,        3,      102
PGT, 0.04545, 0.00207,       66,        3,       63
PGV, 0.02941, 0.00087,       68,        2,       66
PGW, 0.04545, 0.00207,       22,        1,       21
PGY, 0.02941, 0.00087,       34,        1,       33
PG_, 0      , 0      ,       24,        0,       24
PHP, 0.09091, 0.00826,       11,        1,       10
PHQ, 0.07143, 0.0051 ,       14,        1,       13
PHR, 0.09524, 0.00907,       21,        2,       19
PHS, 0.08696, 0.00756,       23,        2,       21
PHT, 0.06452, 0.00416,       31,        2,       29
PHV, 0.06061, 0.00367,       33,        2,       31
PHW, 0      , 0      ,        5,        0,        5
PHY, 0.11111, 0.01235,        9,        1,        8
PH_, 0      , 0      ,        2,        0,        2
PIP, 0.0625 , 0.00391,       32,        2,       30
PIQ, 0.12821, 0.01644,       39,        5,       34
PIR, 0      , 0      ,       47,        0,       47
PIS, 0.08772, 0.00769,       57,        5,       52
PIT, 0.10204, 0.01041,       49,        5,       44
PIV, 0.02941, 0.00087,       68,        2,       66
PIW, 0      , 0      ,        8,        0,        8
PIY, 0.07407, 0.00549,       27,        2,       25
PI_, 0      , 0      ,        5,        0,        5
PKP, 0      , 0      ,       19,        0,       19
PKQ, 0.02778, 0.00077,       36,        1,       35
PKR, 0.0566 , 0.0032 ,       53,        3,       50
PKS, 0.04545, 0.00207,       66,        3,       63
PKT, 0.03774, 0.00142,       53,        2,       51
PKV, 0.05814, 0.00338,       86,        5,       81
PKW, 0      , 0      ,       19,        0,       19
PKY, 0.02857, 0.00082,       35,        1,       34
PK_, 0      , 0      ,       11,        0,       11
PLP, 0.02778, 0.00077,       72,        2,       70
PLQ, 0.04545, 0.00207,       66,        3,       63
PLR, 0.07246, 0.00525,       69,        5,       64
PLS, 0.02778, 0.00077,      108,        3,      105
PLT, 0.02804, 0.00079,      107,        3,      104
PLV, 0.05208, 0.00271,       96,        5,       91
PLW, 0      , 0      ,       25,        0,       25
PLY, 0.13333, 0.01778,       45,        6,       39
PL_, 0      , 0      ,        1,        0,        1
PMP, 0      , 0      ,        9,        0,        9
PMQ, 0.16667, 0.02778,       12,        2,       10
PMR, 0.25   , 0.0625 ,       16,        4,       12
PMS, 0      , 0      ,       16,        0,       16
PMT, 0.17391, 0.03025,       23,        4,       19
PMV, 0.26087, 0.06805,       23,        6,       17
PMW, 0      , 0      ,        2,        0,        2
PMY, 0      , 0      ,       12,        0,       12
PM_, 0      , 0      ,        5,        0,        5
PNP, 0      , 0      ,       20,        0,       20
PNQ, 0.09677, 0.00937,       31,        3,       28
PNR, 0.07317, 0.00535,       41,        3,       38
PNS, 0.06   , 0.0036 ,       50,        3,       47
PNT, 0.05128, 0.00263,       39,        2,       37
PNV, 0.03846, 0.00148,       52,        2,       50
PNW, 0.09091, 0.00826,       11,        1,       10
PNY, 0.09804, 0.00961,       51,        5,       46
PN_, 0      , 0      ,        2,        0,        2
PPP, 0.04255, 0.00181,       47,        2,       45
PPQ, 0.02326, 0.00054,       43,        1,       42
PPR, 0.025  , 0.00063,       40,        1,       39
PPS, 0      , 0      ,       56,        0,       56
PPT, 0.04   , 0.0016 ,       50,        2,       48
PPV, 0      , 0      ,       52,        0,       52
PPW, 0.1    , 0.01   ,       10,        1,        9
PPY, 0.08333, 0.00694,       24,        2,       22
PP_, 0      , 0      ,        9,        0,        9
PQP, 0      , 0      ,       19,        0,       19
PQQ, 0.02857, 0.00082,       35,        1,       34
PQR, 0.06667, 0.00444,       30,        2,       28
PQS, 0.02439, 0.00059,       41,        1,       40
PQT, 0.07895, 0.00623,       38,        3,       35
PQV, 0.1    , 0.01   ,       50,        5,       45
PQW, 0.125  , 0.01562,        8,        1,        7
PQY, 0.1    , 0.01   ,       20,        2,       18
PQ_, 0      , 0      ,        1,        0,        1
PRP, 0.07692, 0.00592,       26,        2,       24
PRQ, 0.10345, 0.0107 ,       29,        3,       26
PRR, 0.05263, 0.00277,       38,        2,       36
PRS, 0.0339 , 0.00115,       59,        2,       57
PRT, 0.14286, 0.02041,       49,        7,       42
PRV, 0.12903, 0.01665,       62,        8,       54
PRW, 0      , 0      ,       12,        0,       12
PRY, 0.09524, 0.00907,       42,        4,       38
PR_, 0.1    , 0.01   ,       10,        1,        9
PSP, 0.03333, 0.00111,       30,        1,       29
PSQ, 0.09302, 0.00865,       43,        4,       39
PSR, 0      , 0      ,       47,        0,       47
PSS, 0.04396, 0.00193,       91,        4,       87
PST, 0.04651, 0.00216,       43,        2,       41
PSV, 0.01299, 0.00017,       77,        1,       76
PSW, 0      , 0      ,       10,        0,       10
PSY, 0      , 0      ,       36,        0,       36
PS_, 0      , 0      ,       15,        0,       15
PTP, 0.05263, 0.00277,       38,        2,       36
PTQ, 0.03125, 0.00098,       32,        1,       31
PTR, 0.05128, 0.00263,       39,        2,       37
PTS, 0.0303 , 0.00092,       66,        2,       64
PTT, 0.02083, 0.00043,       48,        1,       47
PTV, 0.01538, 0.00024,       65,        1,       64
PTW, 0.11765, 0.01384,       17,        2,       15
PTY, 0.06383, 0.00407,       47,        3,       44
PT_, 0      , 0      ,        2,        0,        2
PVP, 0.02857, 0.00082,       35,        1,       34
PVQ, 0.1087 , 0.01181,       46,        5,       41
PVR, 0.02632, 0.00069,       38,        1,       37
PVS, 0.00962, 0.00009,      104,        1,      103
PVT, 0.03896, 0.00152,       77,        3,       74
PVV, 0.0411 , 0.00169,       73,        3,       70
PVW, 0      , 0      ,       18,        0,       18
PVY, 0.09091, 0.00826,       33,        3,       30
PV_, 0      , 0      ,        2,        0,        2
PWP, 0      , 0      ,        8,        0,        8
PWQ, 0      , 0      ,        7,        0,        7
PWR, 0      , 0      ,       11,        0,       11
PWS, 0.16667, 0.02778,       18,        3,       15
PWT, 0.125  , 0.01562,       16,        2,       14
PWV, 0      , 0      ,        7,        0,        7
PWW, 0      , 0      ,        1,        0,        1
PWY, 0.06667, 0.00444,       15,        1,       14
PYP, 0.10526, 0.01108,       19,        2,       17
PYQ, 0      , 0      ,       25,        0,       25
PYR, 0.04762, 0.00227,       21,        1,       20
PYS, 0.16667, 0.02778,       36,        6,       30
PYT, 0.16129, 0.02601,       31,        5,       26
PYV, 0.08   , 0.0064 ,       50,        4,       46
PYW, 0.2    , 0.04   ,       10,        2,        8
PYY, 0.27586, 0.0761 ,       29,        8,       21
PY_, 0      , 0      ,        1,        0,        1
QAQ, 0      , 0      ,       17,        0,       17
QAR, 0.04878, 0.00238,       41,        2,       39
QAS, 0.01887, 0.00036,       53,        1,       52
QAT, 0.07843, 0.00615,       51,        4,       47
QAV, 0.04478, 0.002  ,       67,        3,       64
QAW, 0.09091, 0.00826,       11,        1,       10
QAY, 0      , 0      ,       31,        0,       31
QA_, 0      , 0      ,        7,        0,        7
QCQ, 0      , 0      ,       11,        0,       11
QCR, 0.11765, 0.01384,       17,        2,       15
QCS, 0      , 0      ,        9,        0,        9
QCT, 0.06667, 0.00444,       15,        1,       14
QCV, 0      , 0      ,        7,        0,        7
QCW, 0      , 0      ,        3,        0,        3
QCY, 0      , 0      ,        7,        0,        7
QDQ, 0      , 0      ,       18,        0,       18
QDR, 0.02857, 0.00082,       35,        1,       34
QDS, 0.03125, 0.00098,       32,        1,       31
QDT, 0.02174, 0.00047,       46,        1,       45
QDV, 0.09677, 0.00937,       62,        6,       56
QDW, 0      , 0      ,       14,        0,       14
QDY, 0      , 0      ,       41,        0,       41
QD_, 0.14286, 0.02041,        7,        1,        6
QEQ, 0.03333, 0.00111,       30,        1,       29
QER, 0.03571, 0.00128,       56,        2,       54
QES, 0.10145, 0.01029,       69,        7,       62
QET, 0.02326, 0.00054,       43,        1,       42
QEV, 0.02667, 0.00071,       75,        2,       73
QEW, 0.05263, 0.00277,       19,        1,       18
QEY, 0.02564, 0.00066,       39,        1,       38
QE_, 0      , 0      ,        8,        0,        8
QFQ, 0      , 0      ,       11,        0,       11
QFR, 0.07692, 0.00592,       26,        2,       24
QFS, 0.10811, 0.01169,       37,        4,       33
QFT, 0.09091, 0.00826,       44,        4,       40
QFV, 0.06452, 0.00416,       31,        2,       29
QFW, 0      , 0      ,        4,        0,        4
QFY, 0.07407, 0.00549,       27,        2,       25
QF_, 0      , 0      ,        2,        0,        2
QGQ, 0.0303 , 0.00092,       33,        1,       32
QGR, 0.04545, 0.00207,       44,        2,       42
QGS, 0.02899, 0.00084,       69,        2,       67
QGT, 0.03636, 0.00132,       55,        2,       53
QGV, 0.07317, 0.00535,       41,        3,       38
QGW, 0.07692, 0.00592,       13,        1,       12
QGY, 0.04762, 0.00227,       21,        1,       20
QG_, 0      , 0      ,        1,        0,        1
QHQ, 0.2    , 0.04   ,        5,        1,        4
QHR, 0.05   , 0.0025 ,       20,        1,       19
QHS, 0.2    , 0.04   ,       15,        3,       12
QHT, 0.17647, 0.03114,       17,        3,       14
QHV, 0.04   , 0.0016 ,       25,        1,       24
QHW, 0      , 0      ,        7,        0,        7
QHY, 0.04545, 0.00207,       22,        1,       21
QIQ, 0.05556, 0.00309,       18,        1,       17
QIR, 0.11628, 0.01352,       43,        5,       38
QIS, 0.04762, 0.00227,       42,        2,       40
QIT, 0.11765, 0.01384,       34,        4,       30
QIV, 0.06122, 0.00375,       49,        3,       46
QIW, 0      , 0      ,       13,        0,       13
QIY, 0.06667, 0.00444,       30,        2,       28
QI_, 0      , 0      ,        1,        0,        1
QKQ, 0.07692, 0.00592,       13,        1,       12
QKR, 0.04878, 0.00238,       41,        2,       39
QKS, 0.0566 , 0.0032 ,       53,        3,       50
QKT, 0.02857, 0.00082,       35,        1,       34
QKV, 0.01299, 0.00017,       77,        1,       76
QKW, 0      , 0      ,       22,        0,       22
QKY, 0.02941, 0.00087,       34,        1,       33
QK_, 0      , 0      ,        4,        0,        4
QLQ, 0.02941, 0.00087,       34,        1,       33
QLR, 0.0597 , 0.00356,       67,        4,       63
QLS, 0.04762, 0.00227,       84,        4,       80
QLT, 0.05   , 0.0025 ,       80,        4,       76
QLV, 0.06329, 0.00401,       79,        5,       74
QLW, 0.125  , 0.01562,        8,        1,        7
QLY, 0.05882, 0.00346,       34,        2,       32
QL_, 0      , 0      ,        4,        0,        4
QMQ, 0      , 0      ,        5,        0,        5
QMR, 0      , 0      ,       19,        0,       19
QMS, 0      , 0      ,       15,        0,       15
QMT, 0.05263, 0.00277,       19,        1,       18
QMV, 0.13793, 0.01902,       29,        4,       25
QMW, 0      , 0      ,        3,        0,        3
QMY, 0      , 0      ,        8,        0,        8
QM_, 0      , 0      ,        8,        0,        8
QNQ, 0.09091, 0.00826,       11,        1,       10
QNR, 0.09375, 0.00879,       32,        3,       29
QNS, 0.11364, 0.01291,       44,        5,       39
QNT, 0.12121, 0.01469,       33,        4,       29
QNV, 0.06522, 0.00425,       46,        3,       43
QNW, 0.07143, 0.0051 ,       14,        1,       13
QNY, 0.07143, 0.0051 ,       28,        2,       26
QN_, 0      , 0      ,        3,        0,        3
QPQ, 0      , 0      ,       11,        0,       11
QPR, 0.04545, 0.00207,       22,        1,       21
QPS, 0.02381, 0.00057,       42,        1,       41
QPT, 0      , 0      ,       36,        0,       36
QPV, 0.06122, 0.00375,       49,        3,       46
QPW, 0.11111, 0.01235,        9,        1,        8
QPY, 0      , 0      ,       21,        0,       21
QP_, 0.2    , 0.04   ,       10,        2,        8
QQQ, 0.04545, 0.00207,       22,        1,       21
QQR, 0.04444, 0.00198,       45,        2,       43
QQS, 0.05405, 0.00292,       37,        2,       35
QQT, 0      , 0      ,       39,        0,       39
QQV, 0.11111, 0.01235,       63,        7,       56
QQW, 0.0625 , 0.00391,       16,        1,       15
QQY, 0.02703, 0.00073,       37,        1,       36
QQ_, 0      , 0      ,        6,        0,        6
QRQ, 0.1    , 0.01   ,       10,        1,        9
QRR, 0.06383, 0.00407,       47,        3,       44
QRS, 0.08108, 0.00657,       37,        3,       34
QRT, 0.02128, 0.00045,       47,        1,       46
QRV, 0.04286, 0.00184,       70,        3,       67
QRW, 0      , 0      ,       12,        0,       12
QRY, 0.06667, 0.00444,       30,        2,       28
QSQ, 0      , 0      ,       22,        0,       22
QSR, 0.02703, 0.00073,       37,        1,       36
QSS, 0.05455, 0.00298,       55,        3,       52
QST, 0.0566 , 0.0032 ,       53,        3,       50
QSV, 0.10145, 0.01029,       69,        7,       62
QSW, 0      , 0      ,       13,        0,       13
QSY, 0.04   , 0.0016 ,       25,        1,       24
QS_, 0      , 0      ,        4,        0,        4
QTQ, 0.11111, 0.01235,        9,        1,        8
QTR, 0.05714, 0.00327,       35,        2,       33
QTS, 0.06522, 0.00425,       46,        3,       43
QTT, 0.10256, 0.01052,       39,        4,       35
QTV, 0.06897, 0.00476,       58,        4,       54
QTW, 0      , 0      ,        7,        0,        7
QTY, 0      , 0      ,       26,        0,       26
QT_, 0.5    , 0.25   ,        4,        2,        2
QVQ, 0.05556, 0.00309,       18,        1,       17
QVR, 0.09091, 0.00826,       33,        3,       30
QVS, 0.06667, 0.00444,       45,        3,       42
QVT, 0.12281, 0.01508,       57,        7,       50
QVV, 0.05714, 0.00327,       70,        4,       66
QVW, 0.27273, 0.07438,       11,        3,        8
QVY, 0.02778, 0.00077,       36,        1,       35
QV_, 0      , 0      ,       10,        0,       10
QWQ, 0.09091, 0.00826,       11,        1,       10
QWR, 0.06667, 0.00444,       15,        1,       14
QWS, 0.15385, 0.02367,       13,        2,       11
QWT, 0.27273, 0.07438,       11,        3,        8
QWV, 0.15789, 0.02493,       19,        3,       16
QWW, 0.25   , 0.0625 ,        4,        1,        3
QWY, 0.2    , 0.04   ,       10,        2,        8
QYQ, 0.05263, 0.00277,       19,        1,       18
QYR, 0.03448, 0.00119,       29,        1,       28
QYS, 0.03571, 0.00128,       28,        1,       27
QYT, 0.07143, 0.0051 ,       28,        2,       26
QYV, 0.08108, 0.00657,       37,        3,       34
QYW, 0      , 0      ,       11,        0,       11
QYY, 0.02778, 0.00077,       36,        1,       35
QY_, 0.5    , 0.25   ,        2,        1,        1
RAR, 0      , 0      ,       30,        0,       30
RAS, 0.03509, 0.00123,       57,        2,       55
RAT, 0.02222, 0.00049,       45,        1,       44
RAV, 0.02632, 0.00069,       76,        2,       74
RAW, 0      , 0      ,       13,        0,       13
RAY, 0.09677, 0.00937,       31,        3,       28
RA_, 0      , 0      ,        7,        0,        7
RCR, 0      , 0      ,        6,        0,        6
RCS, 0      , 0      ,       23,        0,       23
RCT, 0      , 0      ,       10,        0,       10
RCV, 0      , 0      ,       15,        0,       15
RCW, 0.33333, 0.11111,        3,        1,        2
RCY, 0      , 0      ,       11,        0,       11
RC_, 0      , 0      ,        6,        0,        6
RDR, 0.04545, 0.00207,       22,        1,       21
RDS, 0.07595, 0.00577,       79,        6,       73
RDT, 0.08511, 0.00724,       47,        4,       43
RDV, 0.06849, 0.00469,       73,        5,       68
RDW, 0      , 0      ,       18,        0,       18
RDY, 0.05405, 0.00292,       37,        2,       35
RD_, 0      , 0      ,        8,        0,        8
RER, 0.04545, 0.00207,       44,        2,       42
RES, 0      , 0      ,       70,        0,       70
RET, 0.01613, 0.00026,       62,        1,       61
REV, 0.00943, 0.00009,      106,        1,      105
REW, 0.03846, 0.00148,       26,        1,       25
REY, 0.03774, 0.00142,       53,        2,       51
RE_, 0      , 0      ,        5,        0,        5
RFR, 0      , 0      ,       14,        0,       14
RFS, 0.11321, 0.01282,       53,        6,       47
RFT, 0.08333, 0.00694,       36,        3,       33
RFV, 0.11111, 0.01235,       36,        4,       32
RFW, 0.07692, 0.00592,       13,        1,       12
RFY, 0.16   , 0.0256 ,       25,        4,       21
RF_, 0      , 0      ,        6,        0,        6
RGR, 0.08   , 0.0064 ,       25,        2,       23
RGS, 0.03297, 0.00109,       91,        3,       88
RGT, 0.06061, 0.00367,       66,        4,       62
RGV, 0.05797, 0.00336,       69,        4,       65
RGW, 0.38889, 0.15123,       18,        7,       11
RGY, 0.02778, 0.00077,       36,        1,       35
RG_, 0      , 0      ,        6,        0,        6
RHR, 0      , 0      ,        6,        0,        6
RHS, 0.03704, 0.00137,       27,        1,       26
RHT, 0.1    , 0.01   ,       20,        2,       18
RHV, 0.07407, 0.00549,       27,        2,       25
RHW, 0      , 0      ,        5,        0,        5
RHY, 0.04167, 0.00174,       24,        1,       23
RH_, 0      , 0      ,        3,        0,        3
RIR, 0.16667, 0.02778,       24,        4,       20
RIS, 0.08621, 0.00743,       58,        5,       53
RIT, 0.075  , 0.00562,       40,        3,       37
RIV, 0      , 0      ,       54,        0,       54
RIW, 0      , 0      ,       10,        0,       10
RIY, 0.1    , 0.01   ,       30,        3,       27
RI_, 0      , 0      ,        4,        0,        4
RKR, 0.0303 , 0.00092,       33,        1,       32
RKS, 0.04762, 0.00227,       63,        3,       60
RKT, 0.04615, 0.00213,       65,        3,       62
RKV, 0.03125, 0.00098,       64,        2,       62
RKW, 0.21429, 0.04592,       14,        3,       11
RKY, 0.05263, 0.00277,       38,        2,       36
RK_, 0      , 0      ,        6,        0,        6
RLR, 0.02703, 0.00073,       37,        1,       36
RLS, 0.07292, 0.00532,       96,        7,       89
RLT, 0.07778, 0.00605,       90,        7,       83
RLV, 0.08511, 0.00724,       94,        8,       86
RLW, 0      , 0      ,       20,        0,       20
RLY, 0.05455, 0.00298,       55,        3,       52
RL_, 0.14286, 0.02041,        7,        1,        6
RMR, 0.18182, 0.03306,       11,        2,        9
RMS, 0.07143, 0.0051 ,       28,        2,       26
RMT, 0.05556, 0.00309,       18,        1,       17
RMV, 0.12   , 0.0144 ,       25,        3,       22
RMW, 0.16667, 0.02778,        6,        1,        5
RMY, 0.09091, 0.00826,       11,        1,       10
RM_, 0.2    , 0.04   ,        5,        1,        4
RNR, 0.11111, 0.01235,       18,        2,       16
RNS, 0.14286, 0.02041,       42,        6,       36
RNT, 0.16129, 0.02601,       31,        5,       26
RNV, 0.08475, 0.00718,       59,        5,       54
RNW, 0      , 0      ,        7,        0,        7
RNY, 0.03226, 0.00104,       31,        1,       30
RN_, 0      , 0      ,        4,        0,        4
RPR, 0.07407, 0.00549,       27,        2,       25
RPS, 0.01961, 0.00038,       51,        1,       50
RPT, 0.08   , 0.0064 ,       50,        4,       46
RPV, 0.04478, 0.002  ,       67,        3,       64
RPW, 0      , 0      ,        9,        0,        9
RPY, 0      , 0      ,       20,        0,       20
RP_, 0.16667, 0.02778,        6,        1,        5
RQR, 0      , 0      ,       16,        0,       16
RQS, 0.06818, 0.00465,       44,        3,       41
RQT, 0.05556, 0.00309,       36,        2,       34
RQV, 0.09434, 0.0089 ,       53,        5,       48
RQW, 0      , 0      ,       10,        0,       10
RQY, 0.15   , 0.0225 ,       20,        3,       17
RQ_, 0      , 0      ,        6,        0,        6
RRR, 0.09375, 0.00879,       32,        3,       29
RRS, 0.22581, 0.05099,       62,       14,       48
RRT, 0.14894, 0.02218,       47,        7,       40
RRV, 0.02667, 0.00071,       75,        2,       73
RRW, 0      , 0      ,       12,        0,       12
RRY, 0.13636, 0.0186 ,       44,        6,       38
RR_, 0      , 0      ,        6,        0,        6
RSR, 0.08   , 0.0064 ,       25,        2,       23
RSS, 0.02469, 0.00061,       81,        2,       79
RST, 0.04918, 0.00242,       61,        3,       58
RSV, 0.02326, 0.00054,       86,        2,       84
RSW, 0      , 0      ,       16,        0,       16
RSY, 0.06818, 0.00465,       44,        3,       41
RS_, 0      , 0      ,        9,        0,        9
RTR, 0.13043, 0.01701,       23,        3,       20
RTS, 0.08065, 0.0065 ,       62,        5,       57
RTT, 0.10811, 0.01169,       37,        4,       33
RTV, 0.10714, 0.01148,       84,        9,       75
RTW, 0.07692, 0.00592,       13,        1,       12
RTY, 0.12821, 0.01644,       39,        5,       34
RT_, 0.28571, 0.08163,        7,        2,        5
RVR, 0.125  , 0.01562,       32,        4,       28
RVS, 0.05263, 0.00277,       57,        3,       54
RVT, 0.07692, 0.00592,       65,        5,       60
RVV, 0.08602, 0.0074 ,       93,        8,       85
RVW, 0.14286, 0.02041,       14,        2,       12
RVY, 0.05263, 0.00277,       38,        2,       36
RV_, 0.33333, 0.11111,        6,        2,        4
RWR, 0      , 0      ,        6,        0,        6
RWS, 0.26316, 0.06925,       19,        5,       14
RWT, 0.19048, 0.03628,       21,        4,       17
RWV, 0.05   , 0.0025 ,       20,        1,       19
RWW, 0.25   , 0.0625 ,        4,        1,        3
RWY, 0.11111, 0.01235,        9,        1,        8
RW_, 0      , 0      ,        1,        0,        1
RYR, 0.13043, 0.01701,       23,        3,       20
RYS, 0.08929, 0.00797,       56,        5,       51
RYT, 0.07895, 0.00623,       38,        3,       35
RYV, 0.15686, 0.02461,       51,        8,       43
RYW, 0.25   , 0.0625 ,       12,        3,        9
RYY, 0.15385, 0.02367,       26,        4,       22
SAS, 0.03774, 0.00142,       53,        2,       51
SAT, 0.01538, 0.00024,       65,        1,       64
SAV, 0.01124, 0.00013,       89,        1,       88
SAW, 0.04348, 0.00189,       23,        1,       22
SAY, 0.05769, 0.00333,       52,        3,       49
SA_, 0      , 0      ,       10,        0,       10
SCS, 0      , 0      ,        7,        0,        7
SCT, 0.09091, 0.00826,       22,        2,       20
SCV, 0      , 0      ,       26,        0,       26
SCW, 0.25   , 0.0625 ,        4,        1,        3
SCY, 0.11111, 0.01235,        9,        1,        8
SC_, 0      , 0      ,        1,        0,        1
SDS, 0.04878, 0.00238,       41,        2,       39
SDT, 0.06154, 0.00379,       65,        4,       61
SDV, 0.05051, 0.00255,       99,        5,       94
SDW, 0.07407, 0.00549,       27,        2,       25
SDY, 0.07843, 0.00615,       51,        4,       47
SD_, 0      , 0      ,        4,        0,        4
SES, 0.08333, 0.00694,       36,        3,       33
SET, 0      , 0      ,       66,        0,       66
SEV, 0.07447, 0.00555,       94,        7,       87
SEW, 0      , 0      ,       16,        0,       16
SEY, 0.01887, 0.00036,       53,        1,       52
SE_, 0.25   , 0.0625 ,        4,        1,        3
SFS, 0.1    , 0.01   ,       40,        4,       36
SFT, 0.01961, 0.00038,       51,        1,       50
SFV, 0.12308, 0.01515,       65,        8,       57
SFW, 0.14286, 0.02041,        7,        1,        6
SFY, 0.19355, 0.03746,       31,        6,       25
SGS, 0.0678 , 0.0046 ,       59,        4,       55
SGT, 0.05319, 0.00283,       94,        5,       89
SGV, 0.05155, 0.00266,       97,        5,       92
SGW, 0.05   , 0.0025 ,       20,        1,       19
SGY, 0.04918, 0.00242,       61,        3,       58
SG_, 0.02326, 0.00054,       43,        1,       42
SHS, 0.05   , 0.0025 ,       20,        1,       19
SHT, 0.05714, 0.00327,       35,        2,       33
SHV, 0.08571, 0.00735,       35,        3,       32
SHW, 0.42857, 0.18367,       14,        6,        8
SHY, 0.11111, 0.01235,       18,        2,       16
SH_, 0      , 0      ,        2,        0,        2
SIS, 0.2    , 0.04   ,       40,        8,       32
SIT, 0.06667, 0.00444,       75,        5,       70
SIV, 0.11111, 0.01235,       63,        7,       56
SIW, 0.05882, 0.00346,       17,        1,       16
SIY, 0.06897, 0.00476,       29,        2,       27
SI_, 0      , 0      ,        3,        0,        3
SKS, 0.09302, 0.00865,       43,        4,       39
SKT, 0.07246, 0.00525,       69,        5,       64
SKV, 0.04396, 0.00193,       91,        4,       87
SKW, 0.10526, 0.01108,       19,        2,       17
SKY, 0.07547, 0.0057 ,       53,        4,       49
SK_, 0      , 0      ,        3,        0,        3
SLS, 0.075  , 0.00562,       80,        6,       74
SLT, 0.07447, 0.00555,       94,        7,       87
SLV, 0.05128, 0.00263,      117,        6,      111
SLW, 0.07143, 0.0051 ,       14,        1,       13
SLY, 0.01493, 0.00022,       67,        1,       66
SL_, 0.14286, 0.02041,        7,        1,        6
SMS, 0.1    , 0.01   ,       20,        2,       18
SMT, 0.04348, 0.00189,       23,        1,       22
SMV, 0.07407, 0.00549,       27,        2,       25
SMW, 0.125  , 0.01562,        8,        1,        7
SMY, 0.06667, 0.00444,       15,        1,       14
SM_, 0      , 0      ,       12,        0,       12
SNS, 0.04545, 0.00207,       22,        1,       21
SNT, 0      , 0      ,       42,        0,       42
SNV, 0.08333, 0.00694,       72,        6,       66
SNW, 0.04348, 0.00189,       23,        1,       22
SNY, 0.225  , 0.05063,       40,        9,       31
SN_, 0      , 0      ,        9,        0,        9
SPS, 0      , 0      ,       36,        0,       36
SPT, 0      , 0      ,       55,        0,       55
SPV, 0.04878, 0.00238,       82,        4,       78
SPW, 0.08333, 0.00694,       12,        1,       11
SPY, 0.02632, 0.00069,       38,        1,       37
SP_, 0.2    , 0.04   ,        5,        1,        4
SQS, 0.02564, 0.00066,       39,        1,       38
SQT, 0.02326, 0.00054,       43,        1,       42
SQV, 0.04762, 0.00227,       63,        3,       60
SQW, 0.11765, 0.01384,       17,        2,       15
SQY, 0.05405, 0.00292,       37,        2,       35
SQ_, 0      , 0      ,        7,        0,        7
SRS, 0.05714, 0.00327,       35,        2,       33
SRT, 0.01887, 0.00036,       53,        1,       52
SRV, 0.11236, 0.01262,       89,       10,       79
SRW, 0      , 0      ,       22,        0,       22
SRY, 0.0678 , 0.0046 ,       59,        4,       55
SR_, 0      , 0      ,        6,        0,        6
SSS, 0.08772, 0.00769,       57,        5,       52
SST, 0.07865, 0.00619,       89,        7,       82
SSV, 0.07463, 0.00557,      134,       10,      124
SSW, 0.09091, 0.00826,       22,        2,       20
SSY, 0.11667, 0.01361,       60,        7,       53
SS_, 0.05882, 0.00346,       17,        1,       16
STS, 0.04878, 0.00238,       41,        2,       39
STT, 0.10606, 0.01125,       66,        7,       59
STV, 0.02381, 0.00057,       84,        2,       82
STW, 0.14286, 0.02041,       14,        2,       12
STY, 0.075  , 0.00562,       40,        3,       37
ST_, 0      , 0      ,        8,        0,        8
SVS, 0.02381, 0.00057,       42,        1,       41
SVT, 0.1    , 0.01   ,       70,        7,       63
SVV, 0.03659, 0.00134,       82,        3,       79
SVW, 0.06667, 0.00444,       15,        1,       14
SVY, 0.02326, 0.00054,       43,        1,       42
SV_, 0.07692, 0.00592,       13,        1,       12
SWS, 0.15385, 0.02367,       13,        2,       11
SWT, 0.08696, 0.00756,       23,        2,       21
SWV, 0.10526, 0.01108,       19,        2,       17
SWW, 0      , 0      ,        3,        0,        3
SWY, 0.25   , 0.0625 ,       12,        3,        9
SW_, 1      , 1      ,        1,        1,        0
SYS, 0.12   , 0.0144 ,       25,        3,       22
SYT, 0.07143, 0.0051 ,       56,        4,       52
SYV, 0.14035, 0.0197 ,       57,        8,       49
SYW, 0.09091, 0.00826,       11,        1,       10
SYY, 0.07895, 0.00623,       38,        3,       35
SY_, 1      , 1      ,        1,        1,        0
TAT, 0.05   , 0.0025 ,       40,        2,       38
TAV, 0.02985, 0.00089,       67,        2,       65
TAW, 0      , 0      ,       10,        0,       10
TAY, 0.125  , 0.01562,       32,        4,       28
TA_, 0.125  , 0.01562,        8,        1,        7
TCT, 0      , 0      ,        6,        0,        6
TCV, 0.21429, 0.04592,       14,        3,       11
TCW, 0      , 0      ,        5,        0,        5
TCY, 0.4    , 0.16   ,        5,        2,        3
TDT, 0.03448, 0.00119,       29,        1,       28
TDV, 0.07143, 0.0051 ,       70,        5,       65
TDW, 0.17647, 0.03114,       17,        3,       14
TDY, 0.11321, 0.01282,       53,        6,       47
TD_, 0.125  , 0.01562,        8,        1,        7
TET, 0.02778, 0.00077,       36,        1,       35
TEV, 0.04938, 0.00244,       81,        4,       77
TEW, 0.25   , 0.0625 ,       12,        3,        9
TEY, 0.06522, 0.00425,       46,        3,       43
TE_, 0      , 0      ,        6,        0,        6
TFT, 0.06452, 0.00416,       31,        2,       29
TFV, 0.15909, 0.02531,       44,        7,       37
TFW, 0      , 0      ,        3,        0,        3
TFY, 0.0625 , 0.00391,       32,        2,       30
TF_, 0      , 0      ,        3,        0,        3
TGT, 0.08   , 0.0064 ,       50,        4,       46
TGV, 0.02857, 0.00082,       70,        2,       68
TGW, 0.07692, 0.00592,       13,        1,       12
TGY, 0.04651, 0.00216,       43,        2,       41
TG_, 0      , 0      ,        8,        0,        8
THT, 0.2    , 0.04   ,       10,        2,        8
THV, 0.05714, 0.00327,       35,        2,       33
THW, 0.2    , 0.04   ,        5,        1,        4
THY, 0.17647, 0.03114,       17,        3,       14
TIT, 0.09524, 0.00907,       42,        4,       38
TIV, 0.02128, 0.00045,       47,        1,       46
TIW, 0      , 0      ,        9,        0,        9
TIY, 0.1875 , 0.03516,       32,        6,       26
TI_, 0      , 0      ,        2,        0,        2
TKT, 0.14286, 0.02041,       35,        5,       30
TKV, 0.06897, 0.00476,       87,        6,       81
TKW, 0      , 0      ,       10,        0,       10
TKY, 0      , 0      ,       44,        0,       44
TK_, 0      , 0      ,        2,        0,        2
TLT, 0.07407, 0.00549,       54,        4,       50
TLV, 0.05505, 0.00303,      109,        6,      103
TLW, 0.11111, 0.01235,        9,        1,        8
TLY, 0.04082, 0.00167,       49,        2,       47
TL_, 0      , 0      ,        3,        0,        3
TMT, 0.5    , 0.25   ,        6,        3,        3
TMV, 0.10526, 0.01108,       19,        2,       17
TMW, 0      , 0      ,        3,        0,        3
TMY, 0      , 0      ,       11,        0,       11
TM_, 0      , 0      ,        6,        0,        6
TNT, 0.07407, 0.00549,       27,        2,       25
TNV, 0.125  , 0.01562,       64,        8,       56
TNW, 0      , 0      ,        6,        0,        6
TNY, 0.02632, 0.00069,       38,        1,       37
TN_, 0      , 0      ,        3,        0,        3
TPT, 0.11429, 0.01306,       35,        4,       31
TPV, 0.04167, 0.00174,       72,        3,       69
TPW, 0.125  , 0.01562,       16,        2,       14
TPY, 0.09091, 0.00826,       33,        3,       30
TP_, 0      , 0      ,        7,        0,        7
TQT, 0.06667, 0.00444,       30,        2,       28
TQV, 0.06897, 0.00476,       58,        4,       54
TQW, 0.16667, 0.02778,       18,        3,       15
TQY, 0.09677, 0.00937,       31,        3,       28
TQ_, 0.16667, 0.02778,        6,        1,        5
TRT, 0.07143, 0.0051 ,       28,        2,       26
TRV, 0.10526, 0.01108,       76,        8,       68
TRW, 0.15385, 0.02367,       13,        2,       11
TRY, 0.05556, 0.00309,       36,        2,       34
TR_, 0      , 0      ,        9,        0,        9
TST, 0.06897, 0.00476,       29,        2,       27
TSV, 0.06977, 0.00487,       86,        6,       80
TSW, 0.08333, 0.00694,       12,        1,       11
TSY, 0.04545, 0.00207,       44,        2,       42
TS_, 0      , 0      ,        6,        0,        6
TTT, 0.13636, 0.0186 ,       44,        6,       38
TTV, 0.0411 , 0.00169,       73,        3,       70
TTW, 0.04762, 0.00227,       21,        1,       20
TTY, 0.0625 , 0.00391,       32,        2,       30
TT_, 0.44444, 0.19753,        9,        4,        5
TVT, 0.0625 , 0.00391,       32,        2,       30
TVV, 0.025  , 0.00063,       80,        2,       78
TVW, 0      , 0      ,       13,        0,       13
TVY, 0.07143, 0.0051 ,       28,        2,       26
TV_, 0      , 0      ,        9,        0,        9
TWT, 0      , 0      ,        9,        0,        9
TWV, 0.125  , 0.01562,       16,        2,       14
TWW, 0.25   , 0.0625 ,        4,        1,        3
TWY, 0.5    , 0.25   ,        2,        1,        1
TW_, 0      , 0      ,        1,        0,        1
TYT, 0.04762, 0.00227,       21,        1,       20
TYV, 0.10256, 0.01052,       39,        4,       35
TYW, 0      , 0      ,        7,        0,        7
TYY, 0.14286, 0.02041,       35,        5,       30
TY_, 0      , 0      ,        2,        0,        2
VAV, 0.04082, 0.00167,       49,        2,       47
VAW, 0.05263, 0.00277,       19,        1,       18
VAY, 0.09091, 0.00826,       44,        4,       40
VA_, 0      , 0      ,        6,        0,        6
VCV, 0.16667, 0.02778,        6,        1,        5
VCW, 0      , 0      ,        4,        0,        4
VCY, 0.16667, 0.02778,       12,        2,       10
VDV, 0.08475, 0.00718,       59,        5,       54
VDW, 0.08824, 0.00779,       34,        3,       31
VDY, 0.0625 , 0.00391,       64,        4,       60
VD_, 0      , 0      ,        7,        0,        7
VEV, 0.04918, 0.00242,       61,        3,       58
VEW, 0      , 0      ,       20,        0,       20
VEY, 0.09524, 0.00907,       84,        8,       76
VE_, 0      , 0      ,        5,        0,        5
VFV, 0.13636, 0.0186 ,       22,        3,       19
VFW, 0.11111, 0.01235,        9,        1,        8
VFY, 0.10345, 0.0107 ,       29,        3,       26
VF_, 0.25   , 0.0625 ,        4,        1,        3
VGV, 0.0566 , 0.0032 ,       53,        3,       50
VGW, 0.22222, 0.04938,        9,        2,        7
VGY, 0.0625 , 0.00391,       48,        3,       45
VG_, 0      , 0      ,        3,        0,        3
VHV, 0.16   , 0.0256 ,       25,        4,       21
VHW, 0.14286, 0.02041,        7,        1,        6
VHY, 0.08   , 0.0064 ,       25,        2,       23
VH_, 0      , 0      ,        1,        0,        1
VIV, 0.03448, 0.00119,       29,        1,       28
VIW, 0.16667, 0.02778,        6,        1,        5
VIY, 0.14286, 0.02041,       28,        4,       24
VI_, 0      , 0      ,        3,        0,        3
VKV, 0.03448, 0.00119,       58,        2,       56
VKW, 0      , 0      ,       18,        0,       18
VKY, 0.03571, 0.00128,       56,        2,       54
VK_, 0      , 0      ,        8,        0,        8
VLV, 0.02273, 0.00052,       44,        1,       43
VLW, 0.05263, 0.00277,       19,        1,       18
VLY, 0      , 0      ,       49,        0,       49
VL_, 0      , 0      ,        4,        0,        4
VMV, 0.04167, 0.00174,       24,        1,       23
VMW, 0.16667, 0.02778,        6,        1,        5
VMY, 0.28571, 0.08163,        7,        2,        5
VM_, 0.09091, 0.00826,       11,        1,       10
VNV, 0.10204, 0.01041,       49,        5,       44
VNW, 0.11765, 0.01384,       17,        2,       15
VNY, 0      , 0      ,       31,        0,       31
VN_, 0.25   , 0.0625 ,        4,        1,        3
VPV, 0.08889, 0.0079 ,       45,        4,       41
VPW, 0      , 0      ,       10,        0,       10
VPY, 0.08696, 0.00756,       46,        4,       42
VP_, 0      , 0      ,        7,        0,        7
VQV, 0.06818, 0.00465,       44,        3,       41
VQW, 0      , 0      ,       18,        0,       18
VQY, 0      , 0      ,       30,        0,       30
VQ_, 0      , 0      ,        5,        0,        5
VRV, 0.06   , 0.0036 ,       50,        3,       47
VRW, 0.04   , 0.0016 ,       25,        1,       24
VRY, 0.12281, 0.01508,       57,        7,       50
VR_, 0      , 0      ,        5,        0,        5
VSV, 0.04651, 0.00216,       43,        2,       41
VSW, 0.33333, 0.11111,       15,        5,       10
VSY, 0.07812, 0.0061 ,       64,        5,       59
VS_, 0      , 0      ,        9,        0,        9
VTV, 0.01471, 0.00022,       68,        1,       67
VTW, 0      , 0      ,       13,        0,       13
VTY, 0.05263, 0.00277,       38,        2,       36
VT_, 0.2    , 0.04   ,        5,        1,        4
VVV, 0.11111, 0.01235,       45,        5,       40
VVW, 0.08333, 0.00694,       12,        1,       11
VVY, 0.11429, 0.01306,       35,        4,       31
VV_, 0      , 0      ,        5,        0,        5
VWV, 0.28571, 0.08163,        7,        2,        5
VWW, 0      , 0      ,        3,        0,        3
VWY, 0.1    , 0.01   ,       10,        1,        9
VW_, 0      , 0      ,        1,        0,        1
VYV, 0.08   , 0.0064 ,       25,        2,       23
VYW, 0      , 0      ,        6,        0,        6
VYY, 0.125  , 0.01562,       24,        3,       21
VY_, 0      , 0      ,        1,        0,        1
WAW, 0      , 0      ,        2,        0,        2
WAY, 0      , 0      ,        5,        0,        5
WC_, 0      , 0      ,        1,        0,        1
WDW, 0      , 0      ,        2,        0,        2
WDY, 0.125  , 0.01562,       16,        2,       14
WD_, 0      , 0      ,        2,        0,        2
WEW, 0      , 0      ,        2,        0,        2
WEY, 0.125  , 0.01562,       24,        3,       21
WE_, 0      , 0      ,        1,        0,        1
WFY, 0.33333, 0.11111,        6,        2,        4
WF_, 0      , 0      ,        1,        0,        1
WGW, 0      , 0      ,        1,        0,        1
WGY, 0.09091, 0.00826,       11,        1,       10
WG_, 0      , 0      ,        2,        0,        2
WHY, 0.14286, 0.02041,        7,        1,        6
WH_, 0      , 0      ,        1,        0,        1
WIW, 0      , 0      ,        1,        0,        1
WIY, 0      , 0      ,        6,        0,        6
WKW, 0      , 0      ,        2,        0,        2
WKY, 0      , 0      ,        9,        0,        9
WK_, 0      , 0      ,        1,        0,        1
WLW, 0      , 0      ,        2,        0,        2
WLY, 0.1    , 0.01   ,       10,        1,        9
WMW, 0      , 0      ,        1,        0,        1
WMY, 0      , 0      ,        2,        0,        2
WNW, 0      , 0      ,        4,        0,        4
WNY, 0      , 0      ,       12,        0,       12
WN_, 0      , 0      ,        1,        0,        1
WPW, 0      , 0      ,        1,        0,        1
WPY, 0      , 0      ,        9,        0,        9
WP_, 0      , 0      ,        3,        0,        3
WQW, 1      , 1      ,        1,        1,        0
WQY, 0.33333, 0.11111,        3,        1,        2
WQ_, 0      , 0      ,        1,        0,        1
WRW, 0      , 0      ,        2,        0,        2
WRY, 0      , 0      ,       11,        0,       11
WSW, 0      , 0      ,        4,        0,        4
WSY, 0.1875 , 0.03516,       16,        3,       13
WS_, 0      , 0      ,        2,        0,        2
WTW, 0      , 0      ,        3,        0,        3
WTY, 0      , 0      ,       11,        0,       11
WVY, 0.25   , 0.0625 ,        4,        1,        3
WWY, 0      , 0      ,        1,        0,        1
WYW, 0      , 0      ,        2,        0,        2
WYY, 0      , 0      ,        6,        0,        6
YAY, 0      , 0      ,       12,        0,       12
YA_, 0      , 0      ,        2,        0,        2
YCY, 0.4    , 0.16   ,        5,        2,        3
YDY, 0.09677, 0.00937,       31,        3,       28
YD_, 0      , 0      ,        5,        0,        5
YEY, 0.14286, 0.02041,        7,        1,        6
YE_, 0      , 0      ,        2,        0,        2
YFY, 0.09091, 0.00826,       11,        1,       10
YF_, 0      , 0      ,        1,        0,        1
YGY, 0.21053, 0.04432,       19,        4,       15
YG_, 0      , 0      ,        3,        0,        3
YHY, 0.2    , 0.04   ,        5,        1,        4
YH_, 0      , 0      ,        2,        0,        2
YIY, 0.125  , 0.01562,        8,        1,        7
YI_, 0      , 0      ,        3,        0,        3
YKY, 0      , 0      ,       15,        0,       15
YK_, 0      , 0      ,        1,        0,        1
YLY, 0.07692, 0.00592,       13,        1,       12
YL_, 0      , 0      ,        1,        0,        1
YMY, 0.2    , 0.04   ,        5,        1,        4
YM_, 0      , 0      ,        2,        0,        2
YNY, 0.11111, 0.01235,       18,        2,       16
YN_, 0      , 0      ,        4,        0,        4
YPY, 0.15385, 0.02367,       13,        2,       11
YP_, 0      , 0      ,        4,        0,        4
YQY, 0      , 0      ,       11,        0,       11
YRY, 0.27273, 0.07438,       11,        3,        8
YR_, 0      , 0      ,        1,        0,        1
YSY, 0.1    , 0.01   ,       10,        1,        9
YS_, 0      , 0      ,        7,        0,        7
YTY, 0      , 0      ,       12,        0,       12
YT_, 0      , 0      ,        1,        0,        1
YVY, 0.21429, 0.04592,       14,        3,       11
YV_, 0      , 0      ,        3,        0,        3
YWY, 1      , 1      ,        1,        1,        0
YYY, 0      , 0      ,       14,        0,       14
YY_, 0      , 0      ,        1,        0,        1
