key, propensity, propensity^2, count, pos, neg
AAA, 0.01111, 0.00012,      180,        2,      178
AAC, 0      , 0      ,       27,        0,       27
AAD, 0.02752, 0.00076,      109,        3,      106
AAE, 0.06393, 0.00409,      219,       14,      205
AAF, 0.02778, 0.00077,       72,        2,       70
AAG, 0.09868, 0.00974,      152,       15,      137
AAH, 0.16216, 0.0263 ,       37,        6,       31
AAI, 0.03226, 0.00104,      186,        6,      180
AAK, 0.09137, 0.00835,      197,       18,      179
AAL, 0.04213, 0.00178,      356,       15,      341
AAM, 0.15493, 0.024  ,       71,       11,       60
AAN, 0.03846, 0.00148,       78,        3,       75
AAP, 0.1068 , 0.01141,      103,       11,       92
AAQ, 0.03759, 0.00141,      133,        5,      128
AAR, 0.10294, 0.0106 ,      204,       21,      183
AAS, 0.03911, 0.00153,      179,        7,      172
AAT, 0.00855, 0.00007,      117,        1,      116
AAV, 0.12834, 0.01647,      187,       24,      163
AAW, 0      , 0      ,       19,        0,       19
AAY, 0.07143, 0.0051 ,       56,        4,       52
AA_, 0      , 0      ,       11,        0,       11
ACA, 0      , 0      ,       15,        0,       15
ACC, 0      , 0      ,        1,        0,        1
ACD, 0      , 0      ,       28,        0,       28
ACE, 0      , 0      ,       19,        0,       19
ACF, 0      , 0      ,        8,        0,        8
ACG, 0      , 0      ,       25,        0,       25
ACH, 0.33333, 0.11111,        3,        1,        2
ACI, 0.61538, 0.3787 ,       13,        8,        5
ACK, 0.05882, 0.00346,       34,        2,       32
ACL, 0      , 0      ,       45,        0,       45
ACM, 0.16667, 0.02778,        6,        1,        5
ACN, 0      , 0      ,        6,        0,        6
ACP, 0.4375 , 0.19141,       16,        7,        9
ACQ, 0.125  , 0.01562,        8,        1,        7
ACR, 0      , 0      ,       28,        0,       28
ACS, 0.1    , 0.01   ,       20,        2,       18
ACT, 0      , 0      ,        9,        0,        9
ACV, 0.0625 , 0.00391,       16,        1,       15
ACW, 0      , 0      ,        5,        0,        5
ACY, 0      , 0      ,       24,        0,       24
AC_, 0      , 0      ,        1,        0,        1
ADA, 0.03488, 0.00122,       86,        3,       83
ADC, 0.07692, 0.00592,       26,        2,       24
ADD, 0.01333, 0.00018,      150,        2,      148
ADE, 0.06667, 0.00444,      135,        9,      126
ADF, 0.0198 , 0.00039,      101,        2,       99
ADG, 0.05505, 0.00303,      109,        6,      103
ADH, 0      , 0      ,       37,        0,       37
ADI, 0      , 0      ,      132,        0,      132
ADK, 0.06803, 0.00463,      147,       10,      137
ADL, 0.01375, 0.00019,      291,        4,      287
ADM, 0      , 0      ,       30,        0,       30
ADN, 0      , 0      ,       65,        0,       65
ADP, 0.01075, 0.00012,       93,        1,       92
ADQ, 0      , 0      ,       65,        0,       65
ADR, 0.02158, 0.00047,      139,        3,      136
ADS, 0.04348, 0.00189,       92,        4,       88
ADT, 0.17544, 0.03078,       57,       10,       47
ADV, 0.02778, 0.00077,      180,        5,      175
ADW, 0.11429, 0.01306,       35,        4,       31
ADY, 0.01449, 0.00021,       69,        1,       68
AD_, 0      , 0      ,       13,        0,       13
AEA, 0.00741, 0.00005,      135,        1,      134
AEC, 0.06   , 0.0036 ,       50,        3,       47
AED, 0.02941, 0.00087,      204,        6,      198
AEE, 0.01449, 0.00021,      207,        3,      204
AEF, 0.03378, 0.00114,      148,        5,      143
AEG, 0.07075, 0.00501,      212,       15,      197
AEH, 0.04902, 0.0024 ,      102,        5,       97
AEI, 0.05991, 0.00359,      217,       13,      204
AEK, 0.00448, 0.00002,      223,        1,      222
AEL, 0.02755, 0.00076,      363,       10,      353
AEM, 0.01835, 0.00034,      109,        2,      107
AEN, 0.03125, 0.00098,      128,        4,      124
AEP, 0.04587, 0.0021 ,      109,        5,      104
AEQ, 0.01205, 0.00015,      166,        2,      164
AER, 0.02016, 0.00041,      248,        5,      243
AES, 0.11058, 0.01223,      208,       23,      185
AET, 0      , 0      ,      123,        0,      123
AEV, 0.00402, 0.00002,      249,        1,      248
AEW, 0      , 0      ,       36,        0,       36
AEY, 0.00971, 0.00009,      103,        1,      102
AE_, 0.1    , 0.01   ,       10,        1,        9
AFA, 0.02857, 0.00082,       35,        1,       34
AFC, 0.1    , 0.01   ,       20,        2,       18
AFD, 0.06897, 0.00476,       58,        4,       54
AFE, 0      , 0      ,       67,        0,       67
AFF, 0      , 0      ,       46,        0,       46
AFG, 0.06452, 0.00416,       93,        6,       87
AFH, 0      , 0      ,       26,        0,       26
AFI, 0.05714, 0.00327,       35,        2,       33
AFK, 0.11628, 0.01352,       86,       10,       76
AFL, 0.11029, 0.01216,      136,       15,      121
AFM, 0.375  , 0.14062,       24,        9,       15
AFN, 0.63107, 0.39825,      103,       65,       38
AFP, 0.26471, 0.07007,       68,       18,       50
AFQ, 0.08   , 0.0064 ,       50,        4,       46
AFR, 0.18841, 0.0355 ,       69,       13,       56
AFS, 0.52344, 0.27399,      128,       67,       61
AFT, 0.1    , 0.01   ,       60,        6,       54
AFV, 0.27273, 0.07438,       77,       21,       56
AFW, 0.05   , 0.0025 ,       20,        1,       19
AFY, 0.02381, 0.00057,       42,        1,       41
AF_, 0      , 0      ,        2,        0,        2
AGA, 0      , 0      ,      104,        0,      104
AGC, 0.06452, 0.00416,       31,        2,       29
AGD, 0.05747, 0.0033 ,       87,        5,       82
AGE, 0      , 0      ,      156,        0,      156
AGF, 0.12281, 0.01508,      114,       14,      100
AGG, 0.22807, 0.05202,      114,       26,       88
AGH, 0.17241, 0.02973,       29,        5,       24
AGI, 0.0493 , 0.00243,      142,        7,      135
AGK, 0.17021, 0.02897,      141,       24,      117
AGL, 0.095  , 0.00903,      200,       19,      181
AGM, 0      , 0      ,       40,        0,       40
AGN, 0.03158, 0.001  ,       95,        3,       92
AGP, 0.11818, 0.01397,      110,       13,       97
AGQ, 0.0202 , 0.00041,       99,        2,       97
AGR, 0.15108, 0.02282,      139,       21,      118
AGS, 0.12698, 0.01612,      126,       16,      110
AGT, 0.08   , 0.0064 ,       75,        6,       69
AGV, 0.09459, 0.00895,      148,       14,      134
AGW, 0.30769, 0.09467,       26,        8,       18
AGY, 0.02632, 0.00069,       76,        2,       74
AG_, 0.06667, 0.00444,       15,        1,       14
AHA, 0      , 0      ,       34,        0,       34
AHC, 0      , 0      ,       16,        0,       16
AHD, 0      , 0      ,       19,        0,       19
AHE, 0      , 0      ,       75,        0,       75
AHF, 0      , 0      ,       48,        0,       48
AHG, 0.05455, 0.00298,      110,        6,      104
AHH, 0      , 0      ,       16,        0,       16
AHI, 0.09804, 0.00961,       51,        5,       46
AHK, 0.08451, 0.00714,       71,        6,       65
AHL, 0.07143, 0.0051 ,       70,        5,       65
AHM, 0.11111, 0.01235,        9,        1,        8
AHN, 0.15789, 0.02493,       19,        3,       16
AHP, 0.14286, 0.02041,       42,        6,       36
AHQ, 0.12903, 0.01665,       31,        4,       27
AHR, 0.16949, 0.02873,       59,       10,       49
AHS, 0.22642, 0.05126,       53,       12,       41
AHT, 0.21429, 0.04592,       56,       12,       44
AHV, 0.18919, 0.03579,       37,        7,       30
AHW, 0      , 0      ,       21,        0,       21
AHY, 0.17857, 0.03189,       28,        5,       23
AH_, 0      , 0      ,        8,        0,        8
AIA, 0.10345, 0.0107 ,       58,        6,       52
AIC, 0.38462, 0.14793,       13,        5,        8
AID, 0.03604, 0.0013 ,      111,        4,      107
AIE, 0.05161, 0.00266,      155,        8,      147
AIF, 0.05263, 0.00277,       76,        4,       72
AIG, 0.15385, 0.02367,       91,       14,       77
AIH, 0.05769, 0.00333,       52,        3,       49
AII, 0      , 0      ,       58,        0,       58
AIK, 0.02817, 0.00079,      142,        4,      138
AIL, 0.01399, 0.0002 ,      143,        2,      141
AIM, 0      , 0      ,       44,        0,       44
AIN, 0.01408, 0.0002 ,       71,        1,       70
AIP, 0.19231, 0.03698,       52,       10,       42
AIQ, 0.06742, 0.00454,       89,        6,       83
AIR, 0.06977, 0.00487,      129,        9,      120
AIS, 0.11881, 0.01412,      101,       12,       89
AIT, 0.07407, 0.00549,       54,        4,       50
AIV, 0.02941, 0.00087,      102,        3,       99
AIW, 0      , 0      ,       10,        0,       10
AIY, 0.05435, 0.00295,       92,        5,       87
AI_, 0.16667, 0.02778,        6,        1,        5
AKA, 0.27434, 0.07526,      113,       31,       82
AKC, 0.10345, 0.0107 ,       29,        3,       26
AKD, 0.21849, 0.04774,      119,       26,       93
AKE, 0.09312, 0.00867,      247,       23,      224
AKF, 0.55738, 0.31067,      122,       68,       54
AKG, 0.18132, 0.03288,      182,       33,      149
AKH, 0.39535, 0.1563 ,       43,       17,       26
AKI, 0.10897, 0.01188,      156,       17,      139
AKK, 0.06024, 0.00363,      166,       10,      156
AKL, 0.0922 , 0.0085 ,      282,       26,      256
AKM, 0.05   , 0.0025 ,       60,        3,       57
AKN, 0.11111, 0.01235,      108,       12,       96
AKP, 0.23913, 0.05718,       92,       22,       70
AKQ, 0.06803, 0.00463,      147,       10,      137
AKR, 0.11707, 0.01371,      205,       24,      181
AKS, 0.19079, 0.0364 ,      152,       29,      123
AKT, 0.20787, 0.04321,      178,       37,      141
AKV, 0.20225, 0.0409 ,      178,       36,      142
AKW, 0.69231, 0.47929,       91,       63,       28
AKY, 0.09091, 0.00826,       77,        7,       70
AK_, 0      , 0      ,       28,        0,       28
ALA, 0.03356, 0.00113,      149,        5,      144
ALC, 0      , 0      ,       20,        0,       20
ALD, 0.00467, 0.00002,      214,        1,      213
ALE, 0.04833, 0.00234,      269,       13,      256
ALF, 0.02655, 0.0007 ,      113,        3,      110
ALG, 0.08718, 0.0076 ,      195,       17,      178
ALH, 0.07407, 0.00549,       81,        6,       75
ALI, 0.02083, 0.00043,      144,        3,      141
ALK, 0.02299, 0.00053,      174,        4,      170
ALL, 0.017  , 0.00029,      353,        6,      347
ALM, 0.02174, 0.00047,       92,        2,       90
ALN, 0      , 0      ,      173,        0,      173
ALP, 0.08108, 0.00657,      148,       12,      136
ALQ, 0.01227, 0.00015,      163,        2,      161
ALR, 0.02655, 0.0007 ,      226,        6,      220
ALS, 0.06452, 0.00416,      186,       12,      174
ALT, 0.05587, 0.00312,      179,       10,      169
ALV, 0.01739, 0.0003 ,      230,        4,      226
ALW, 0      , 0      ,       45,        0,       45
ALY, 0      , 0      ,       90,        0,       90
AL_, 0      , 0      ,        6,        0,        6
AMA, 0      , 0      ,       34,        0,       34
AMC, 0      , 0      ,        6,        0,        6
AMD, 0.05714, 0.00327,       35,        2,       33
AME, 0.01562, 0.00024,       64,        1,       63
AMF, 0      , 0      ,       27,        0,       27
AMG, 0.18333, 0.03361,       60,       11,       49
AMH, 0      , 0      ,        7,        0,        7
AMI, 0      , 0      ,       29,        0,       29
AMK, 0.18919, 0.03579,       37,        7,       30
AML, 0.02105, 0.00044,       95,        2,       93
AMM, 0      , 0      ,       11,        0,       11
AMN, 0.2    , 0.04   ,       45,        9,       36
AMP, 0      , 0      ,       30,        0,       30
AMQ, 0.07143, 0.0051 ,       14,        1,       13
AMR, 0.08108, 0.00657,       74,        6,       68
AMS, 0.06452, 0.00416,       31,        2,       29
AMT, 0.02222, 0.00049,       45,        1,       44
AMV, 0.02083, 0.00043,       48,        1,       47
AMW, 0      , 0      ,        3,        0,        3
AMY, 0.03704, 0.00137,       27,        1,       26
AM_, 0.25   , 0.0625 ,       12,        3,        9
ANA, 0.06522, 0.00425,       46,        3,       43
ANC, 0.25   , 0.0625 ,       16,        4,       12
AND, 0.125  , 0.01562,       40,        5,       35
ANE, 0.0375 , 0.00141,       80,        3,       77
ANF, 0.01099, 0.00012,      182,        2,      180
ANG, 0.33871, 0.11472,       62,       21,       41
ANH, 0.56   , 0.3136 ,       25,       14,       11
ANI, 0.15315, 0.02346,      111,       17,       94
ANK, 0.14   , 0.0196 ,      100,       14,       86
ANL, 0.0791 , 0.00626,      177,       14,      163
ANM, 0.37931, 0.14388,       29,       11,       18
ANN, 0.15873, 0.0252 ,       63,       10,       53
ANP, 0.01626, 0.00026,      123,        2,      121
ANQ, 0      , 0      ,       63,        0,       63
ANR, 0.18919, 0.03579,       74,       14,       60
ANS, 0.16438, 0.02702,       73,       12,       61
ANT, 0.28814, 0.08302,       59,       17,       42
ANV, 0.18056, 0.0326 ,       72,       13,       59
ANW, 0      , 0      ,        7,        0,        7
ANY, 0.02632, 0.00069,       38,        1,       37
AN_, 0      , 0      ,        8,        0,        8
APA, 0      , 0      ,       65,        0,       65
APC, 0.17391, 0.03025,       23,        4,       19
APD, 0.01351, 0.00018,       74,        1,       73
APE, 0.024  , 0.00058,      125,        3,      122
APF, 0.025  , 0.00063,       40,        1,       39
APG, 0.04651, 0.00216,      129,        6,      123
APH, 0.03846, 0.00148,       52,        2,       50
API, 0.10227, 0.01046,       88,        9,       79
APK, 0.07692, 0.00592,       91,        7,       84
APL, 0.09489, 0.009  ,      137,       13,      124
APM, 0.04762, 0.00227,       21,        1,       20
APN, 0.01852, 0.00034,       54,        1,       53
APP, 0      , 0      ,       57,        0,       57
APQ, 0.03704, 0.00137,       27,        1,       26
APR, 0.11628, 0.01352,       86,       10,       76
APS, 0.20183, 0.04074,      109,       22,       87
APT, 0.1875 , 0.03516,       96,       18,       78
APV, 0.06202, 0.00385,      129,        8,      121
APW, 0      , 0      ,       16,        0,       16
APY, 0.02041, 0.00042,       49,        1,       48
AP_, 0.125  , 0.01562,        8,        1,        7
AQA, 0.13793, 0.01902,       87,       12,       75
AQC, 0      , 0      ,       57,        0,       57
AQD, 0.07143, 0.0051 ,       56,        4,       52
AQE, 0.02055, 0.00042,      146,        3,      143
AQF, 0.32353, 0.10467,       34,       11,       23
AQG, 0.0396 , 0.00157,      101,        4,       97
AQH, 0.2    , 0.04   ,       35,        7,       28
AQI, 0.06579, 0.00433,       76,        5,       71
AQK, 0.30435, 0.09263,      161,       49,      112
AQL, 0.05911, 0.00349,      203,       12,      191
AQM, 0      , 0      ,       47,        0,       47
AQN, 0.01205, 0.00015,       83,        1,       82
AQP, 0.29167, 0.08507,       48,       14,       34
AQQ, 0.02158, 0.00047,      139,        3,      136
AQR, 0.13873, 0.01925,      173,       24,      149
AQS, 0.05376, 0.00289,       93,        5,       88
AQT, 0.04918, 0.00242,       61,        3,       58
AQV, 0.14019, 0.01965,      107,       15,       92
AQW, 0      , 0      ,      100,        0,      100
AQY, 0.05882, 0.00346,       34,        2,       32
AQ_, 0      , 0      ,        5,        0,        5
ARA, 0.4589 , 0.21059,      146,       67,       79
ARC, 0.15   , 0.0225 ,       40,        6,       34
ARD, 0.11475, 0.01317,      122,       14,      108
ARE, 0.14354, 0.0206 ,      209,       30,      179
ARF, 0.04762, 0.00227,       63,        3,       60
ARG, 0.12281, 0.01508,      114,       14,      100
ARH, 0.22078, 0.04874,       77,       17,       60
ARI, 0.1713 , 0.02934,      216,       37,      179
ARK, 0.16509, 0.02726,      212,       35,      177
ARL, 0.06309, 0.00398,      317,       20,      297
ARM, 0.25   , 0.0625 ,       96,       24,       72
ARN, 0.54815, 0.30047,      135,       74,       61
ARP, 0.13095, 0.01715,       84,       11,       73
ARQ, 0.18978, 0.03602,      137,       26,      111
ARR, 0.2562 , 0.06564,      242,       62,      180
ARS, 0.25767, 0.06639,      163,       42,      121
ART, 0.09375, 0.00879,      128,       12,      116
ARV, 0.11043, 0.01219,      163,       18,      145
ARW, 0.06818, 0.00465,       44,        3,       41
ARY, 0.08571, 0.00735,       70,        6,       64
AR_, 0.21429, 0.04592,       14,        3,       11
ASA, 0.01923, 0.00037,       52,        1,       51
ASC, 0      , 0      ,       22,        0,       22
ASD, 0.16084, 0.02587,      143,       23,      120
ASE, 0.04575, 0.00209,      153,        7,      146
ASF, 0.3012 , 0.09072,       83,       25,       58
ASG, 0.05797, 0.00336,      138,        8,      130
ASH, 0.09434, 0.0089 ,       53,        5,       48
ASI, 0.12222, 0.01494,      180,       22,      158
ASK, 0.02362, 0.00056,      127,        3,      124
ASL, 0.13389, 0.01793,      239,       32,      207
ASM, 0.1194 , 0.01426,       67,        8,       59
ASN, 0.02174, 0.00047,       92,        2,       90
ASP, 0.09524, 0.00907,       84,        8,       76
ASQ, 0.19512, 0.03807,       82,       16,       66
ASR, 0.13534, 0.01832,      133,       18,      115
ASS, 0.10227, 0.01046,       88,        9,       79
AST, 0.11538, 0.01331,      130,       15,      115
ASV, 0.38028, 0.14461,      213,       81,      132
ASW, 0      , 0      ,       26,        0,       26
ASY, 0.08571, 0.00735,       35,        3,       32
AS_, 0.04545, 0.00207,       22,        1,       21
ATA, 0.03226, 0.00104,       93,        3,       90
ATC, 0.23529, 0.05536,       17,        4,       13
ATD, 0.0531 , 0.00282,      113,        6,      107
ATE, 0.05217, 0.00272,      115,        6,      109
ATF, 0.05797, 0.00336,       69,        4,       65
ATG, 0.07746, 0.006  ,      142,       11,      131
ATH, 0.05882, 0.00346,       34,        2,       32
ATI, 0.12389, 0.01535,      113,       14,       99
ATK, 0.23762, 0.05647,      101,       24,       77
ATL, 0.06608, 0.00437,      227,       15,      212
ATM, 0.14634, 0.02142,       41,        6,       35
ATN, 0.11765, 0.01384,       68,        8,       60
ATP, 0.0875 , 0.00766,       80,        7,       73
ATQ, 0      , 0      ,       50,        0,       50
ATR, 0.21053, 0.04432,      114,       24,       90
ATS, 0.07843, 0.00615,      102,        8,       94
ATT, 0.22581, 0.05099,       93,       21,       72
ATV, 0.12214, 0.01492,      131,       16,      115
ATW, 0.09615, 0.00925,       52,        5,       47
ATY, 0.21951, 0.04819,       41,        9,       32
AT_, 0      , 0      ,        3,        0,        3
AVA, 0.0339 , 0.00115,       59,        2,       57
AVC, 0      , 0      ,       31,        0,       31
AVD, 0.06034, 0.00364,      116,        7,      109
AVE, 0      , 0      ,      120,        0,      120
AVF, 0.12162, 0.01479,       74,        9,       65
AVG, 0.16667, 0.02778,      108,       18,       90
AVH, 0.16216, 0.0263 ,       37,        6,       31
AVI, 0      , 0      ,      139,        0,      139
AVK, 0.08491, 0.00721,      106,        9,       97
AVL, 0.00772, 0.00006,      259,        2,      257
AVM, 0.04762, 0.00227,       21,        1,       20
AVN, 0.04918, 0.00242,       61,        3,       58
AVP, 0.05921, 0.00351,      152,        9,      143
AVQ, 0.12698, 0.01612,       63,        8,       55
AVR, 0.01242, 0.00015,      161,        2,      159
AVS, 0.06475, 0.00419,      139,        9,      130
AVT, 0.0375 , 0.00141,      160,        6,      154
AVV, 0.05618, 0.00316,      178,       10,      168
AVW, 0      , 0      ,       29,        0,       29
AVY, 0.0625 , 0.00391,       48,        3,       45
AV_, 0      , 0      ,        5,        0,        5
AWA, 0      , 0      ,        8,        0,        8
AWC, 0.66667, 0.44444,        3,        2,        1
AWD, 0      , 0      ,       21,        0,       21
AWE, 0      , 0      ,       33,        0,       33
AWF, 0      , 0      ,        5,        0,        5
AWG, 0.16667, 0.02778,       36,        6,       30
AWH, 0      , 0      ,       20,        0,       20
AWI, 0.08333, 0.00694,       12,        1,       11
AWK, 0.09091, 0.00826,       33,        3,       30
AWL, 0.0625 , 0.00391,       64,        4,       60
AWM, 0.2    , 0.04   ,        5,        1,        4
AWN, 0.23529, 0.05536,       17,        4,       13
AWP, 0      , 0      ,        6,        0,        6
AWQ, 0.07692, 0.00592,       26,        2,       24
AWR, 0.2619 , 0.06859,       42,       11,       31
AWS, 0.19231, 0.03698,       26,        5,       21
AWT, 0.13158, 0.01731,       38,        5,       33
AWV, 0.0625 , 0.00391,       16,        1,       15
AWW, 0      , 0      ,        3,        0,        3
AWY, 0.10714, 0.01148,       28,        3,       25
AW_, 0      , 0      ,        4,        0,        4
AYA, 0.10256, 0.01052,       39,        4,       35
AYC, 0      , 0      ,        5,        0,        5
AYD, 0.06452, 0.00416,       31,        2,       29
AYE, 0.1573 , 0.02474,       89,       14,       75
AYF, 0.1194 , 0.01426,       67,        8,       59
AYG, 0.20202, 0.04081,       99,       20,       79
AYH, 0.45833, 0.21007,       24,       11,       13
AYI, 0.01923, 0.00037,       52,        1,       51
AYK, 0.07767, 0.00603,      103,        8,       95
AYL, 0.10526, 0.01108,       95,       10,       85
AYM, 0.33333, 0.11111,       39,       13,       26
AYN, 0.25581, 0.06544,       43,       11,       32
AYP, 0.10204, 0.01041,       49,        5,       44
AYQ, 0.18462, 0.03408,       65,       12,       53
AYR, 0.15504, 0.02404,      129,       20,      109
AYS, 0.13043, 0.01701,       46,        6,       40
AYT, 0.26923, 0.07249,       26,        7,       19
AYV, 0.03409, 0.00116,       88,        3,       85
AYW, 0.54545, 0.29752,       11,        6,        5
AYY, 0.07143, 0.0051 ,       28,        2,       26
CAC, 0.57143, 0.32653,       14,        8,        6
CAD, 0.35714, 0.12755,       14,        5,        9
CAE, 0      , 0      ,       38,        0,       38
CAF, 0      , 0      ,        5,        0,        5
CAG, 0.02439, 0.00059,       41,        1,       40
CAH, 0      , 0      ,        4,        0,        4
CAI, 0.16667, 0.02778,       12,        2,       10
CAK, 0      , 0      ,       13,        0,       13
CAL, 0      , 0      ,       26,        0,       26
CAM, 0      , 0      ,        5,        0,        5
CAN, 0.16667, 0.02778,       18,        3,       15
CAP, 0      , 0      ,       18,        0,       18
CAQ, 0      , 0      ,       14,        0,       14
CAR, 0.19048, 0.03628,       21,        4,       17
CAS, 0.10714, 0.01148,       28,        3,       25
CAT, 0.07692, 0.00592,       13,        1,       12
CAV, 0      , 0      ,       16,        0,       16
CAW, 0.5    , 0.25   ,        4,        2,        2
CAY, 0      , 0      ,       29,        0,       29
CA_, 0      , 0      ,        1,        0,        1
CCD, 0      , 0      ,        1,        0,        1
CCE, 0.4    , 0.16   ,        5,        2,        3
CCF, 0      , 0      ,        3,        0,        3
CCG, 0      , 0      ,        3,        0,        3
CCH, 0      , 0      ,        5,        0,        5
CCK, 0      , 0      ,       12,        0,       12
CCL, 0      , 0      ,        2,        0,        2
CCN, 0      , 0      ,        2,        0,        2
CCQ, 0.5    , 0.25   ,        4,        2,        2
CCR, 0.25   , 0.0625 ,        4,        1,        3
CCS, 0      , 0      ,        1,        0,        1
CCT, 0      , 0      ,        8,        0,        8
CCV, 0      , 0      ,       10,        0,       10
CDC, 0      , 0      ,        1,        0,        1
CDD, 0      , 0      ,       58,        0,       58
CDE, 0      , 0      ,       27,        0,       27
CDF, 0      , 0      ,       28,        0,       28
CDG, 0.11765, 0.01384,       17,        2,       15
CDH, 0      , 0      ,        7,        0,        7
CDI, 0      , 0      ,       12,        0,       12
CDK, 0      , 0      ,       32,        0,       32
CDL, 0.09375, 0.00879,       32,        3,       29
CDM, 0      , 0      ,       11,        0,       11
CDN, 0      , 0      ,       18,        0,       18
CDP, 0      , 0      ,       15,        0,       15
CDQ, 0      , 0      ,       19,        0,       19
CDR, 0.05714, 0.00327,       35,        2,       33
CDS, 0.19048, 0.03628,       21,        4,       17
CDT, 0      , 0      ,        7,        0,        7
CDV, 0.05263, 0.00277,       19,        1,       18
CDW, 0      , 0      ,        2,        0,        2
CDY, 0      , 0      ,       14,        0,       14
CEC, 0.75   , 0.5625 ,        4,        3,        1
CED, 0      , 0      ,       10,        0,       10
CEE, 0      , 0      ,       38,        0,       38
CEF, 0      , 0      ,       20,        0,       20
CEG, 0.13793, 0.01902,       58,        8,       50
CEH, 0      , 0      ,        4,        0,        4
CEI, 0      , 0      ,       27,        0,       27
CEK, 0.04255, 0.00181,       47,        2,       45
CEL, 0      , 0      ,       28,        0,       28
CEM, 0      , 0      ,       15,        0,       15
CEN, 0.07692, 0.00592,       13,        1,       12
CEP, 0      , 0      ,       42,        0,       42
CEQ, 0      , 0      ,       26,        0,       26
CER, 0.02778, 0.00077,       36,        1,       35
CES, 0.06061, 0.00367,       33,        2,       31
CET, 0      , 0      ,       14,        0,       14
CEV, 0      , 0      ,       42,        0,       42
CEW, 0      , 0      ,        2,        0,        2
CEY, 0.06667, 0.00444,       15,        1,       14
CE_, 0      , 0      ,        2,        0,        2
CFC, 0      , 0      ,        1,        0,        1
CFD, 0      , 0      ,        8,        0,        8
CFE, 0      , 0      ,       30,        0,       30
CFF, 0.2    , 0.04   ,        5,        1,        4
CFG, 0.6    , 0.36   ,        5,        3,        2
CFH, 0      , 0      ,        7,        0,        7
CFI, 0.09524, 0.00907,       21,        2,       19
CFK, 0      , 0      ,       25,        0,       25
CFL, 0      , 0      ,       23,        0,       23
CFM, 0      , 0      ,        2,        0,        2
CFN, 0.0625 , 0.00391,       16,        1,       15
CFP, 0      , 0      ,        6,        0,        6
CFQ, 0      , 0      ,        5,        0,        5
CFR, 0.05882, 0.00346,       17,        1,       16
CFS, 0.22222, 0.04938,       18,        4,       14
CFT, 0.08333, 0.00694,       24,        2,       22
CFV, 0      , 0      ,       19,        0,       19
CFW, 0      , 0      ,        2,        0,        2
CFY, 0      , 0      ,        5,        0,        5
CGC, 0      , 0      ,       14,        0,       14
CGD, 0.06667, 0.00444,       30,        2,       28
CGE, 0.48571, 0.23592,       35,       17,       18
CGF, 0.11538, 0.01331,       26,        3,       23
CGG, 0      , 0      ,       25,        0,       25
CGH, 0      , 0      ,       26,        0,       26
CGI, 0.26667, 0.07111,       15,        4,       11
CGK, 0.03175, 0.00101,       63,        2,       61
CGL, 0      , 0      ,       33,        0,       33
CGM, 0      , 0      ,        5,        0,        5
CGN, 0.03226, 0.00104,       31,        1,       30
CGP, 0.07692, 0.00592,       13,        1,       12
CGQ, 0      , 0      ,       19,        0,       19
CGR, 0.0303 , 0.00092,       33,        1,       32
CGS, 0.2    , 0.04   ,       60,       12,       48
CGT, 0      , 0      ,       26,        0,       26
CGV, 0.26923, 0.07249,       26,        7,       19
CGW, 0      , 0      ,        7,        0,        7
CGY, 0      , 0      ,        6,        0,        6
CHC, 0      , 0      ,        8,        0,        8
CHD, 0      , 0      ,        3,        0,        3
CHE, 0      , 0      ,       11,        0,       11
CHF, 0.14286, 0.02041,        7,        1,        6
CHG, 0      , 0      ,       13,        0,       13
CHH, 0      , 0      ,        6,        0,        6
CHI, 0      , 0      ,        8,        0,        8
CHK, 0      , 0      ,       10,        0,       10
CHL, 0.08696, 0.00756,       23,        2,       21
CHM, 0      , 0      ,        7,        0,        7
CHN, 0.18182, 0.03306,       11,        2,        9
CHP, 0      , 0      ,        5,        0,        5
CHQ, 0.18182, 0.03306,       11,        2,        9
CHR, 0      , 0      ,       15,        0,       15
CHS, 0.14286, 0.02041,       14,        2,       12
CHT, 0      , 0      ,       16,        0,       16
CHV, 0      , 0      ,       16,        0,       16
CHW, 0      , 0      ,        2,        0,        2
CHY, 0.58333, 0.34028,       12,        7,        5
CID, 0      , 0      ,       12,        0,       12
CIE, 0      , 0      ,       38,        0,       38
CIF, 0      , 0      ,       10,        0,       10
CIG, 0      , 0      ,        7,        0,        7
CIH, 0      , 0      ,        7,        0,        7
CII, 0      , 0      ,       17,        0,       17
CIK, 0      , 0      ,       14,        0,       14
CIL, 0      , 0      ,       35,        0,       35
CIM, 0      , 0      ,        2,        0,        2
CIN, 0      , 0      ,        7,        0,        7
CIP, 0      , 0      ,        9,        0,        9
CIQ, 0.5    , 0.25   ,       10,        5,        5
CIR, 0      , 0      ,       10,        0,       10
CIS, 0      , 0      ,        9,        0,        9
CIT, 0.05263, 0.00277,       19,        1,       18
CIV, 0      , 0      ,        4,        0,        4
CIW, 0      , 0      ,        1,        0,        1
CIY, 0      , 0      ,        7,        0,        7
CKC, 0      , 0      ,        1,        0,        1
CKD, 0      , 0      ,       28,        0,       28
CKE, 0.0625 , 0.00391,       64,        4,       60
CKF, 0.17857, 0.03189,       28,        5,       23
CKG, 0.37778, 0.14272,       45,       17,       28
CKH, 0      , 0      ,       15,        0,       15
CKI, 0.21053, 0.04432,       19,        4,       15
CKK, 0.17742, 0.03148,       62,       11,       51
CKL, 0.19231, 0.03698,       52,       10,       42
CKM, 0.11111, 0.01235,        9,        1,        8
CKN, 0.26316, 0.06925,       19,        5,       14
CKP, 0.15   , 0.0225 ,       20,        3,       17
CKQ, 0.11765, 0.01384,       17,        2,       15
CKR, 0.45   , 0.2025 ,       40,       18,       22
CKS, 0      , 0      ,       15,        0,       15
CKT, 0.45833, 0.21007,       24,       11,       13
CKV, 0.19355, 0.03746,       62,       12,       50
CKW, 0.5    , 0.25   ,        6,        3,        3
CKY, 0.0625 , 0.00391,       32,        2,       30
CK_, 0      , 0      ,        5,        0,        5
CLC, 0      , 0      ,        1,        0,        1
CLD, 0.02439, 0.00059,       41,        1,       40
CLE, 0.01887, 0.00036,       53,        1,       52
CLF, 0      , 0      ,        9,        0,        9
CLG, 0      , 0      ,       31,        0,       31
CLH, 0      , 0      ,        4,        0,        4
CLI, 0      , 0      ,       18,        0,       18
CLK, 0      , 0      ,       44,        0,       44
CLL, 0      , 0      ,       40,        0,       40
CLM, 0.3    , 0.09   ,       10,        3,        7
CLN, 0.07692, 0.00592,       26,        2,       24
CLP, 0      , 0      ,       22,        0,       22
CLQ, 0.02439, 0.00059,       41,        1,       40
CLR, 0      , 0      ,       29,        0,       29
CLS, 0.02941, 0.00087,       34,        1,       33
CLT, 0.07143, 0.0051 ,       14,        1,       13
CLV, 0      , 0      ,       51,        0,       51
CLW, 0      , 0      ,        9,        0,        9
CLY, 0      , 0      ,       17,        0,       17
CL_, 0      , 0      ,        2,        0,        2
CME, 0      , 0      ,        4,        0,        4
CMF, 0.07692, 0.00592,       13,        1,       12
CMG, 0.2    , 0.04   ,        5,        1,        4
CMI, 0      , 0      ,        2,        0,        2
CMK, 0      , 0      ,       10,        0,       10
CML, 0      , 0      ,       12,        0,       12
CMN, 0.42857, 0.18367,        7,        3,        4
CMP, 0      , 0      ,        3,        0,        3
CMQ, 0      , 0      ,        8,        0,        8
CMR, 0      , 0      ,        6,        0,        6
CMS, 0.14286, 0.02041,        7,        1,        6
CMT, 0      , 0      ,       14,        0,       14
CMV, 0      , 0      ,        3,        0,        3
CMW, 0      , 0      ,        3,        0,        3
CMY, 0      , 0      ,        2,        0,        2
CNC, 0      , 0      ,        4,        0,        4
CND, 0      , 0      ,        7,        0,        7
CNE, 0      , 0      ,       26,        0,       26
CNF, 0.25   , 0.0625 ,        4,        1,        3
CNG, 0      , 0      ,       16,        0,       16
CNH, 0      , 0      ,        7,        0,        7
CNI, 0      , 0      ,       32,        0,       32
CNK, 0.23333, 0.05444,       30,        7,       23
CNL, 0.05714, 0.00327,       35,        2,       33
CNM, 0      , 0      ,       11,        0,       11
CNN, 0      , 0      ,        4,        0,        4
CNP, 0      , 0      ,       10,        0,       10
CNQ, 0      , 0      ,       13,        0,       13
CNR, 0.33333, 0.11111,       21,        7,       14
CNS, 0.56522, 0.31947,       23,       13,       10
CNT, 0.3    , 0.09   ,       10,        3,        7
CNV, 0.14286, 0.02041,       14,        2,       12
CNW, 0.5    , 0.25   ,        4,        2,        2
CNY, 0      , 0      ,        4,        0,        4
CPC, 1      , 1      ,        2,        2,        0
CPD, 0      , 0      ,       16,        0,       16
CPE, 0      , 0      ,       16,        0,       16
CPF, 0.05882, 0.00346,       17,        1,       16
CPG, 0      , 0      ,       22,        0,       22
CPH, 0.08333, 0.00694,       12,        1,       11
CPI, 0      , 0      ,       19,        0,       19
CPK, 0      , 0      ,       15,        0,       15
CPL, 0      , 0      ,       11,        0,       11
CPN, 0.03333, 0.00111,       30,        1,       29
CPP, 0.06667, 0.00444,       15,        1,       14
CPQ, 0      , 0      ,        8,        0,        8
CPR, 0      , 0      ,       14,        0,       14
CPS, 0.03846, 0.00148,       26,        1,       25
CPT, 0      , 0      ,       14,        0,       14
CPV, 0      , 0      ,       17,        0,       17
CPW, 0      , 0      ,        1,        0,        1
CPY, 0      , 0      ,        3,        0,        3
CQC, 0      , 0      ,        3,        0,        3
CQD, 0      , 0      ,        2,        0,        2
CQE, 0.13514, 0.01826,       37,        5,       32
CQF, 0      , 0      ,       10,        0,       10
CQG, 0      , 0      ,        7,        0,        7
CQH, 0      , 0      ,        5,        0,        5
CQI, 0      , 0      ,       18,        0,       18
CQK, 0.35   , 0.1225 ,       20,        7,       13
CQL, 0.09091, 0.00826,       33,        3,       30
CQM, 0.33333, 0.11111,        3,        1,        2
CQN, 0      , 0      ,       15,        0,       15
CQP, 0.07143, 0.0051 ,       14,        1,       13
CQQ, 0      , 0      ,        6,        0,        6
CQR, 0.14286, 0.02041,       21,        3,       18
CQS, 0      , 0      ,        9,        0,        9
CQT, 0      , 0      ,       24,        0,       24
CQV, 0      , 0      ,       15,        0,       15
CQY, 0.13043, 0.01701,       23,        3,       20
CQ_, 0      , 0      ,        2,        0,        2
CRC, 0.4    , 0.16   ,        5,        2,        3
CRD, 0.38889, 0.15123,       18,        7,       11
CRE, 0.1129 , 0.01275,       62,        7,       55
CRF, 0.4    , 0.16   ,       35,       14,       21
CRG, 0.38462, 0.14793,       26,       10,       16
CRH, 0      , 0      ,        8,        0,        8
CRI, 0      , 0      ,       23,        0,       23
CRK, 0.06897, 0.00476,       29,        2,       27
CRL, 0.24528, 0.06016,       53,       13,       40
CRM, 0.09091, 0.00826,       11,        1,       10
CRN, 0.25   , 0.0625 ,       20,        5,       15
CRP, 0.20833, 0.0434 ,       24,        5,       19
CRQ, 0.09524, 0.00907,       21,        2,       19
CRR, 0.25   , 0.0625 ,       32,        8,       24
CRS, 0.41379, 0.17122,       29,       12,       17
CRT, 0.16667, 0.02778,       12,        2,       10
CRV, 0.11765, 0.01384,       17,        2,       15
CRW, 0      , 0      ,        3,        0,        3
CRY, 0.34615, 0.11982,       26,        9,       17
CR_, 0      , 0      ,        1,        0,        1
CSD, 0.07692, 0.00592,       13,        1,       12
CSE, 0.03125, 0.00098,       32,        1,       31
CSF, 0.05714, 0.00327,       35,        2,       33
CSG, 0.43478, 0.18904,       23,       10,       13
CSH, 0      , 0      ,        1,        0,        1
CSI, 0      , 0      ,       22,        0,       22
CSK, 0.0625 , 0.00391,       16,        1,       15
CSL, 0.27778, 0.07716,       18,        5,       13
CSM, 0      , 0      ,       12,        0,       12
CSN, 0.09524, 0.00907,       21,        2,       19
CSP, 0      , 0      ,       25,        0,       25
CSQ, 0.24138, 0.05826,       29,        7,       22
CSR, 0.14286, 0.02041,       14,        2,       12
CSS, 0.41667, 0.17361,       36,       15,       21
CST, 0.13333, 0.01778,       15,        2,       13
CSV, 0      , 0      ,       31,        0,       31
CSW, 0.5    , 0.25   ,        4,        2,        2
CSY, 0.04348, 0.00189,       23,        1,       22
CS_, 0      , 0      ,        1,        0,        1
CTC, 0      , 0      ,        2,        0,        2
CTD, 0      , 0      ,       10,        0,       10
CTE, 0      , 0      ,       33,        0,       33
CTF, 0      , 0      ,       13,        0,       13
CTG, 0.0625 , 0.00391,       32,        2,       30
CTH, 0.11111, 0.01235,       18,        2,       16
CTI, 0      , 0      ,       18,        0,       18
CTK, 0      , 0      ,       37,        0,       37
CTL, 0.09375, 0.00879,       32,        3,       29
CTM, 0      , 0      ,       11,        0,       11
CTN, 0.09091, 0.00826,       11,        1,       10
CTP, 0.22222, 0.04938,        9,        2,        7
CTQ, 0.5    , 0.25   ,       14,        7,        7
CTR, 0      , 0      ,       20,        0,       20
CTS, 0.2    , 0.04   ,       10,        2,        8
CTT, 0.27273, 0.07438,       11,        3,        8
CTV, 0.04348, 0.00189,       23,        1,       22
CTY, 0      , 0      ,        6,        0,        6
CT_, 0      , 0      ,        2,        0,        2
CVC, 0      , 0      ,        8,        0,        8
CVD, 0      , 0      ,        6,        0,        6
CVE, 0.04348, 0.00189,       23,        1,       22
CVF, 0      , 0      ,       30,        0,       30
CVG, 0.14286, 0.02041,       28,        4,       24
CVH, 0      , 0      ,        6,        0,        6
CVI, 0      , 0      ,       10,        0,       10
CVK, 0.09091, 0.00826,       11,        1,       10
CVL, 0      , 0      ,       36,        0,       36
CVM, 0      , 0      ,        3,        0,        3
CVN, 0      , 0      ,       10,        0,       10
CVP, 0      , 0      ,       30,        0,       30
CVQ, 0      , 0      ,        8,        0,        8
CVR, 0      , 0      ,       13,        0,       13
CVS, 0.03333, 0.00111,       30,        1,       29
CVT, 0.1    , 0.01   ,       20,        2,       18
CVV, 0.0303 , 0.00092,       33,        1,       32
CVW, 0      , 0      ,        8,        0,        8
CVY, 0.02857, 0.00082,       35,        1,       34
CV_, 0      , 0      ,        1,        0,        1
CWD, 0.16667, 0.02778,        6,        1,        5
CWE, 0      , 0      ,       15,        0,       15
CWG, 0      , 0      ,        5,        0,        5
CWI, 0      , 0      ,        9,        0,        9
CWK, 0.44444, 0.19753,        9,        4,        5
CWL, 0      , 0      ,        2,        0,        2
CWM, 0      , 0      ,        2,        0,        2
CWN, 0      , 0      ,        6,        0,        6
CWP, 0      , 0      ,        3,        0,        3
CWQ, 0      , 0      ,        3,        0,        3
CWR, 0      , 0      ,        3,        0,        3
CWS, 0      , 0      ,        2,        0,        2
CWT, 1      , 1      ,        2,        2,        0
CWV, 0      , 0      ,        1,        0,        1
CWW, 0      , 0      ,        3,        0,        3
CYC, 0      , 0      ,        1,        0,        1
CYD, 0.22222, 0.04938,        9,        2,        7
CYE, 0      , 0      ,       22,        0,       22
CYF, 0      , 0      ,       30,        0,       30
CYG, 0.33333, 0.11111,        9,        3,        6
CYH, 0      , 0      ,        2,        0,        2
CYI, 0      , 0      ,        6,        0,        6
CYK, 0.05   , 0.0025 ,       20,        1,       19
CYL, 0.07143, 0.0051 ,       14,        1,       13
CYM, 0      , 0      ,        1,        0,        1
CYN, 0      , 0      ,        8,        0,        8
CYP, 0      , 0      ,        2,        0,        2
CYQ, 0      , 0      ,        7,        0,        7
CYR, 0      , 0      ,        6,        0,        6
CYS, 0.27273, 0.07438,       22,        6,       16
CYT, 0.10526, 0.01108,       19,        2,       17
CYV, 0      , 0      ,       15,        0,       15
CYW, 0      , 0      ,        5,        0,        5
CYY, 0.1    , 0.01   ,       10,        1,        9
DAD, 0.04082, 0.00167,       49,        2,       47
DAE, 0.10638, 0.01132,      141,       15,      126
DAF, 0.01299, 0.00017,       77,        1,       76
DAG, 0.00943, 0.00009,      106,        1,      105
DAH, 0.10526, 0.01108,       19,        2,       17
DAI, 0.01149, 0.00013,       87,        1,       86
DAK, 0.02439, 0.00059,      123,        3,      120
DAL, 0.06   , 0.0036 ,      200,       12,      188
DAM, 0.14815, 0.02195,       27,        4,       23
DAN, 0      , 0      ,       55,        0,       55
DAP, 0.02247, 0.0005 ,       89,        2,       87
DAQ, 0      , 0      ,       73,        0,       73
DAR, 0.01176, 0.00014,       85,        1,       84
DAS, 0.07447, 0.00555,       94,        7,       87
DAT, 0.12048, 0.01452,       83,       10,       73
DAV, 0.02844, 0.00081,      211,        6,      205
DAW, 0      , 0      ,       18,        0,       18
DAY, 0      , 0      ,       57,        0,       57
DA_, 0      , 0      ,       12,        0,       12
DCD, 0      , 0      ,        2,        0,        2
DCE, 0      , 0      ,        3,        0,        3
DCF, 0      , 0      ,       32,        0,       32
DCG, 0      , 0      ,       36,        0,       36
DCH, 0      , 0      ,        9,        0,        9
DCI, 0      , 0      ,       21,        0,       21
DCK, 0.09375, 0.00879,       32,        3,       29
DCL, 0      , 0      ,       37,        0,       37
DCM, 0      , 0      ,        7,        0,        7
DCN, 0      , 0      ,        9,        0,        9
DCP, 0      , 0      ,       23,        0,       23
DCQ, 0      , 0      ,        8,        0,        8
DCR, 0      , 0      ,       21,        0,       21
DCS, 0      , 0      ,       13,        0,       13
DCT, 0      , 0      ,       11,        0,       11
DCV, 0      , 0      ,       25,        0,       25
DCW, 0      , 0      ,        1,        0,        1
DCY, 0      , 0      ,        1,        0,        1
DDD, 0.0625 , 0.00391,       64,        4,       60
DDE, 0      , 0      ,      118,        0,      118
DDF, 0      , 0      ,       83,        0,       83
DDG, 0.125  , 0.01562,       88,       11,       77
DDH, 0.0303 , 0.00092,       33,        1,       32
DDI, 0      , 0      ,      109,        0,      109
DDK, 0.01333, 0.00018,       75,        1,       74
DDL, 0.01681, 0.00028,      238,        4,      234
DDM, 0.11765, 0.01384,       17,        2,       15
DDN, 0      , 0      ,       67,        0,       67
DDP, 0      , 0      ,       82,        0,       82
DDQ, 0      , 0      ,       30,        0,       30
DDR, 0      , 0      ,       67,        0,       67
DDS, 0.075  , 0.00562,       80,        6,       74
DDT, 0.05882, 0.00346,       68,        4,       64
DDV, 0.0292 , 0.00085,      137,        4,      133
DDW, 0.02778, 0.00077,       36,        1,       35
DDY, 0      , 0      ,       52,        0,       52
DD_, 0      , 0      ,        7,        0,        7
DED, 0      , 0      ,       73,        0,       73
DEE, 0.01923, 0.00037,      156,        3,      153
DEF, 0.02941, 0.00087,      102,        3,       99
DEG, 0.025  , 0.00063,       80,        2,       78
DEH, 0.02222, 0.00049,       45,        1,       44
DEI, 0.02339, 0.00055,      171,        4,      167
DEK, 0.04138, 0.00171,      145,        6,      139
DEL, 0.01606, 0.00026,      249,        4,      245
DEM, 0      , 0      ,       57,        0,       57
DEN, 0.08333, 0.00694,       96,        8,       88
DEP, 0      , 0      ,      132,        0,      132
DEQ, 0.02128, 0.00045,       47,        1,       46
DER, 0.04615, 0.00213,      130,        6,      124
DES, 0.02804, 0.00079,      107,        3,      104
DET, 0.04098, 0.00168,      122,        5,      117
DEV, 0.03268, 0.00107,      153,        5,      148
DEW, 0      , 0      ,       20,        0,       20
DEY, 0.01205, 0.00015,       83,        1,       82
DE_, 0      , 0      ,        9,        0,        9
DFD, 0      , 0      ,       59,        0,       59
DFE, 0      , 0      ,       67,        0,       67
DFF, 0.02083, 0.00043,       48,        1,       47
DFG, 0.13158, 0.01731,       76,       10,       66
DFH, 0      , 0      ,       22,        0,       22
DFI, 0.12   , 0.0144 ,      100,       12,       88
DFK, 0.0303 , 0.00092,       66,        2,       64
DFL, 0.05714, 0.00327,      105,        6,       99
DFM, 0.14706, 0.02163,       34,        5,       29
DFN, 0.12766, 0.0163 ,       47,        6,       41
DFP, 0.03226, 0.00104,       62,        2,       60
DFQ, 0.0625 , 0.00391,       48,        3,       45
DFR, 0.02105, 0.00044,       95,        2,       93
DFS, 0.03659, 0.00134,       82,        3,       79
DFT, 0.14474, 0.02095,       76,       11,       65
DFV, 0.01205, 0.00015,       83,        1,       82
DFW, 0      , 0      ,       17,        0,       17
DFY, 0      , 0      ,       27,        0,       27
DF_, 0      , 0      ,        1,        0,        1
DGD, 0      , 0      ,       31,        0,       31
DGE, 0.1573 , 0.02474,       89,       14,       75
DGF, 0.11268, 0.0127 ,       71,        8,       63
DGG, 0.25882, 0.06699,       85,       22,       63
DGH, 0.16   , 0.0256 ,       25,        4,       21
DGI, 0.09434, 0.0089 ,      106,       10,       96
DGK, 0.09483, 0.00899,      116,       11,      105
DGL, 0.0625 , 0.00391,      144,        9,      135
DGM, 0.125  , 0.01562,       56,        7,       49
DGN, 0.05195, 0.0027 ,       77,        4,       73
DGP, 0.05333, 0.00284,       75,        4,       71
DGQ, 0.06349, 0.00403,       63,        4,       59
DGR, 0.04762, 0.00227,      105,        5,      100
DGS, 0.11538, 0.01331,       78,        9,       69
DGT, 0.07353, 0.00541,       68,        5,       63
DGV, 0.04065, 0.00165,      123,        5,      118
DGW, 0.04545, 0.00207,       22,        1,       21
DGY, 0      , 0      ,       34,        0,       34
DHD, 0.25   , 0.0625 ,        8,        2,        6
DHE, 0.05714, 0.00327,       35,        2,       33
DHF, 0.07407, 0.00549,       27,        2,       25
DHG, 0.17647, 0.03114,       34,        6,       28
DHH, 0.13043, 0.01701,       23,        3,       20
DHI, 0.02439, 0.00059,       41,        1,       40
DHK, 0.2    , 0.04   ,       15,        3,       12
DHL, 0.0274 , 0.00075,       73,        2,       71
DHM, 0      , 0      ,        7,        0,        7
DHN, 0.08696, 0.00756,       23,        2,       21
DHP, 0.18519, 0.03429,       27,        5,       22
DHQ, 0      , 0      ,       21,        0,       21
DHR, 0      , 0      ,       44,        0,       44
DHS, 0.18519, 0.03429,       27,        5,       22
DHT, 0.14286, 0.02041,       21,        3,       18
DHV, 0.36111, 0.1304 ,       36,       13,       23
DHW, 0.1    , 0.01   ,       20,        2,       18
DHY, 0.13636, 0.0186 ,       22,        3,       19
DID, 0.05556, 0.00309,       54,        3,       51
DIE, 0.0155 , 0.00024,      129,        2,      127
DIF, 0      , 0      ,       53,        0,       53
DIG, 0.06557, 0.0043 ,      122,        8,      114
DIH, 0.075  , 0.00562,       40,        3,       37
DII, 0      , 0      ,      118,        0,      118
DIK, 0.0989 , 0.00978,       91,        9,       82
DIL, 0.01156, 0.00013,      173,        2,      171
DIM, 0.04545, 0.00207,       44,        2,       42
DIN, 0.02083, 0.00043,       96,        2,       94
DIP, 0.07143, 0.0051 ,       56,        4,       52
DIQ, 0.04082, 0.00167,       49,        2,       47
DIR, 0.04688, 0.0022 ,       64,        3,       61
DIS, 0.08434, 0.00711,       83,        7,       76
DIT, 0      , 0      ,       62,        0,       62
DIV, 0.04124, 0.0017 ,       97,        4,       93
DIW, 0      , 0      ,       23,        0,       23
DIY, 0      , 0      ,       59,        0,       59
DI_, 0      , 0      ,        3,        0,        3
DKD, 0      , 0      ,       43,        0,       43
DKE, 0.07031, 0.00494,      128,        9,      119
DKF, 0.03947, 0.00156,       76,        3,       73
DKG, 0.25   , 0.0625 ,       84,       21,       63
DKH, 0      , 0      ,       48,        0,       48
DKI, 0.08046, 0.00647,      174,       14,      160
DKK, 0.08929, 0.00797,      112,       10,      102
DKL, 0.10959, 0.01201,      292,       32,      260
DKM, 0.14286, 0.02041,       42,        6,       36
DKN, 0.16867, 0.02845,       83,       14,       69
DKP, 0.14103, 0.01989,       78,       11,       67
DKQ, 0.17073, 0.02915,       41,        7,       34
DKR, 0.2585 , 0.06682,      147,       38,      109
DKS, 0.17117, 0.0293 ,      111,       19,       92
DKT, 0.16667, 0.02778,       84,       14,       70
DKV, 0.18018, 0.03246,      111,       20,       91
DKW, 0.12   , 0.0144 ,       25,        3,       22
DKY, 0.05263, 0.00277,       95,        5,       90
DK_, 0.07143, 0.0051 ,       14,        1,       13
DLD, 0      , 0      ,       63,        0,       63
DLE, 0.0221 , 0.00049,      181,        4,      177
DLF, 0.02439, 0.00059,      123,        3,      120
DLG, 0.07432, 0.00552,      148,       11,      137
DLH, 0.04225, 0.00179,       71,        3,       68
DLI, 0.02646, 0.0007 ,      189,        5,      184
DLK, 0.05096, 0.0026 ,      157,        8,      149
DLL, 0.01231, 0.00015,      325,        4,      321
DLM, 0      , 0      ,       51,        0,       51
DLN, 0.02239, 0.0005 ,      134,        3,      131
DLP, 0.00885, 0.00008,      113,        1,      112
DLQ, 0      , 0      ,      112,        0,      112
DLR, 0.11966, 0.01432,      117,       14,      103
DLS, 0.05325, 0.00284,      169,        9,      160
DLT, 0.07285, 0.00531,      151,       11,      140
DLV, 0.04494, 0.00202,      178,        8,      170
DLW, 0      , 0      ,       34,        0,       34
DLY, 0      , 0      ,       50,        0,       50
DL_, 0      , 0      ,        5,        0,        5
DMD, 0      , 0      ,       16,        0,       16
DME, 0      , 0      ,       14,        0,       14
DMF, 0.05405, 0.00292,       37,        2,       35
DMG, 0.04545, 0.00207,       44,        2,       42
DMH, 0      , 0      ,        7,        0,        7
DMI, 0      , 0      ,       45,        0,       45
DMK, 0.19512, 0.03807,       41,        8,       33
DML, 0      , 0      ,       37,        0,       37
DMM, 0.07692, 0.00592,       13,        1,       12
DMN, 0.23529, 0.05536,       17,        4,       13
DMP, 0.15152, 0.02296,       33,        5,       28
DMQ, 0      , 0      ,       13,        0,       13
DMR, 0.11111, 0.01235,       18,        2,       16
DMS, 0.05882, 0.00346,       17,        1,       16
DMT, 0.06897, 0.00476,       29,        2,       27
DMV, 0      , 0      ,       22,        0,       22
DMW, 0      , 0      ,        3,        0,        3
DMY, 0.13333, 0.01778,       15,        2,       13
DM_, 0.08333, 0.00694,       12,        1,       11
DND, 0      , 0      ,       15,        0,       15
DNE, 0.03   , 0.0009 ,      100,        3,       97
DNF, 0.13333, 0.01778,       30,        4,       26
DNG, 0.0122 , 0.00015,       82,        1,       81
DNH, 0      , 0      ,       28,        0,       28
DNI, 0      , 0      ,       55,        0,       55
DNK, 0.04706, 0.00221,       85,        4,       81
DNL, 0.05594, 0.00313,      143,        8,      135
DNM, 0.16667, 0.02778,        6,        1,        5
DNN, 0.05714, 0.00327,       35,        2,       33
DNP, 0.06452, 0.00416,       62,        4,       58
DNQ, 0.19512, 0.03807,       41,        8,       33
DNR, 0.15854, 0.02513,       82,       13,       69
DNS, 0.03279, 0.00107,       61,        2,       59
DNT, 0.02381, 0.00057,       42,        1,       41
DNV, 0.05556, 0.00309,       54,        3,       51
DNW, 0.13333, 0.01778,       15,        2,       13
DNY, 0      , 0      ,       45,        0,       45
DN_, 0      , 0      ,        6,        0,        6
DPD, 0      , 0      ,       32,        0,       32
DPE, 0.01639, 0.00027,      122,        2,      120
DPF, 0.15873, 0.0252 ,       63,       10,       53
DPG, 0.01266, 0.00016,       79,        1,       78
DPH, 0      , 0      ,       51,        0,       51
DPI, 0.08571, 0.00735,       70,        6,       64
DPK, 0.09346, 0.00873,      107,       10,       97
DPL, 0.00752, 0.00006,      133,        1,      132
DPM, 0.125  , 0.01562,       24,        3,       21
DPN, 0.07865, 0.00619,       89,        7,       82
DPP, 0.03448, 0.00119,       29,        1,       28
DPQ, 0      , 0      ,       82,        0,       82
DPR, 0.02469, 0.00061,       81,        2,       79
DPS, 0.04167, 0.00174,       96,        4,       92
DPT, 0      , 0      ,       85,        0,       85
DPV, 0.01538, 0.00024,       65,        1,       64
DPW, 0.06667, 0.00444,       30,        2,       28
DPY, 0.07547, 0.0057 ,       53,        4,       49
DP_, 0      , 0      ,       15,        0,       15
DQD, 0      , 0      ,       18,        0,       18
DQE, 0.03488, 0.00122,       86,        3,       83
DQF, 0.07547, 0.0057 ,       53,        4,       49
DQG, 0.16667, 0.02778,       48,        8,       40
DQH, 0.03846, 0.00148,       26,        1,       25
DQI, 0.02062, 0.00043,       97,        2,       95
DQK, 0.02703, 0.00073,       74,        2,       72
DQL, 0.0813 , 0.00661,      123,       10,      113
DQM, 0      , 0      ,       16,        0,       16
DQN, 0.10526, 0.01108,       19,        2,       17
DQP, 0.03774, 0.00142,       53,        2,       51
DQQ, 0      , 0      ,       18,        0,       18
DQR, 0.15625, 0.02441,       32,        5,       27
DQS, 0.01923, 0.00037,       52,        1,       51
DQT, 0.05556, 0.00309,       36,        2,       34
DQV, 0      , 0      ,       42,        0,       42
DQW, 0      , 0      ,       13,        0,       13
DQY, 0.22917, 0.05252,       48,       11,       37
DQ_, 0      , 0      ,        5,        0,        5
DRD, 0.1875 , 0.03516,       32,        6,       26
DRE, 0.07143, 0.0051 ,      126,        9,      117
DRF, 0.22951, 0.05267,      122,       28,       94
DRG, 0.21698, 0.04708,      106,       23,       83
DRH, 0.28   , 0.0784 ,       25,        7,       18
DRI, 0.13178, 0.01737,      129,       17,      112
DRK, 0.13187, 0.01739,       91,       12,       79
DRL, 0.13672, 0.01869,      256,       35,      221
DRM, 0.03636, 0.00132,       55,        2,       53
DRN, 0.11864, 0.01408,       59,        7,       52
DRP, 0.12   , 0.0144 ,       75,        9,       66
DRQ, 0.21311, 0.04542,       61,       13,       48
DRR, 0.31061, 0.09648,      132,       41,       91
DRS, 0.11111, 0.01235,       99,       11,       88
DRT, 0.23529, 0.05536,       68,       16,       52
DRV, 0.09859, 0.00972,      142,       14,      128
DRW, 0.10638, 0.01132,       47,        5,       42
DRY, 0.11765, 0.01384,       85,       10,       75
DR_, 0      , 0      ,        1,        0,        1
DSD, 0      , 0      ,       45,        0,       45
DSE, 0.03226, 0.00104,      124,        4,      120
DSF, 0.06173, 0.00381,       81,        5,       76
DSG, 0.0119 , 0.00014,       84,        1,       83
DSH, 0.43333, 0.18778,       30,       13,       17
DSI, 0.16923, 0.02864,      130,       22,      108
DSK, 0.18349, 0.03367,      109,       20,       89
DSL, 0.02871, 0.00082,      209,        6,      203
DSM, 0.04545, 0.00207,       22,        1,       21
DSN, 0.18919, 0.03579,       74,       14,       60
DSP, 0.08182, 0.00669,      110,        9,      101
DSQ, 0.01351, 0.00018,       74,        1,       73
DSR, 0.22581, 0.05099,       62,       14,       48
DSS, 0.09375, 0.00879,       96,        9,       87
DST, 0.09459, 0.00895,       74,        7,       67
DSV, 0.07595, 0.00577,      158,       12,      146
DSW, 0      , 0      ,       17,        0,       17
DSY, 0.05556, 0.00309,       36,        2,       34
DS_, 0      , 0      ,       14,        0,       14
DTD, 0.05   , 0.0025 ,       40,        2,       38
DTE, 0      , 0      ,       61,        0,       61
DTF, 0      , 0      ,       65,        0,       65
DTG, 0.14085, 0.01984,       71,       10,       61
DTH, 0      , 0      ,       32,        0,       32
DTI, 0.03922, 0.00154,      102,        4,       98
DTK, 0.10294, 0.0106 ,       68,        7,       61
DTL, 0.02105, 0.00044,      190,        4,      186
DTM, 0.07143, 0.0051 ,       14,        1,       13
DTN, 0.04255, 0.00181,       47,        2,       45
DTP, 0.11111, 0.01235,       54,        6,       48
DTQ, 0.15   , 0.0225 ,       20,        3,       17
DTR, 0.15873, 0.0252 ,       63,       10,       53
DTS, 0.02985, 0.00089,       67,        2,       65
DTT, 0.13725, 0.01884,       51,        7,       44
DTV, 0.05479, 0.003  ,       73,        4,       69
DTW, 0.05882, 0.00346,       34,        2,       32
DTY, 0      , 0      ,       33,        0,       33
DT_, 0      , 0      ,        2,        0,        2
DVD, 0      , 0      ,       37,        0,       37
DVE, 0.02055, 0.00042,      146,        3,      143
DVF, 0      , 0      ,       68,        0,       68
DVG, 0.00885, 0.00008,      113,        1,      112
DVH, 0      , 0      ,       32,        0,       32
DVI, 0.02381, 0.00057,       84,        2,       82
DVK, 0      , 0      ,       93,        0,       93
DVL, 0.0051 , 0.00003,      196,        1,      195
DVM, 0      , 0      ,       28,        0,       28
DVN, 0.025  , 0.00063,       80,        2,       78
DVP, 0.09174, 0.00842,      109,       10,       99
DVQ, 0.01852, 0.00034,       54,        1,       53
DVR, 0.24194, 0.05853,       62,       15,       47
DVS, 0.01709, 0.00029,      117,        2,      115
DVT, 0.05319, 0.00283,       94,        5,       89
DVV, 0.01724, 0.0003 ,      116,        2,      114
DVW, 0      , 0      ,       23,        0,       23
DVY, 0.1    , 0.01   ,       60,        6,       54
DV_, 0      , 0      ,        7,        0,        7
DWD, 0      , 0      ,        5,        0,        5
DWE, 0.07143, 0.0051 ,       14,        1,       13
DWF, 0.03846, 0.00148,       26,        1,       25
DWG, 0.04348, 0.00189,       23,        1,       22
DWH, 0.5    , 0.25   ,       12,        6,        6
DWI, 0      , 0      ,       19,        0,       19
DWK, 0.22222, 0.04938,       18,        4,       14
DWL, 0      , 0      ,       42,        0,       42
DWM, 0      , 0      ,       14,        0,       14
DWN, 0      , 0      ,       18,        0,       18
DWP, 0      , 0      ,       10,        0,       10
DWQ, 0      , 0      ,       23,        0,       23
DWR, 0      , 0      ,       31,        0,       31
DWS, 0.25   , 0.0625 ,       32,        8,       24
DWT, 0.21429, 0.04592,       14,        3,       11
DWV, 0.05263, 0.00277,       19,        1,       18
DWW, 0.25   , 0.0625 ,        8,        2,        6
DWY, 0      , 0      ,       13,        0,       13
DW_, 0      , 0      ,        2,        0,        2
DYD, 0.06452, 0.00416,       31,        2,       29
DYE, 0.05   , 0.0025 ,       60,        3,       57
DYF, 0.12766, 0.0163 ,       47,        6,       41
DYG, 0.16667, 0.02778,       84,       14,       70
DYH, 0.22222, 0.04938,        9,        2,        7
DYI, 0.09524, 0.00907,       63,        6,       57
DYK, 0.09302, 0.00865,       86,        8,       78
DYL, 0.06329, 0.00401,      158,       10,      148
DYM, 0      , 0      ,       23,        0,       23
DYN, 0.38596, 0.14897,       57,       22,       35
DYP, 0.08163, 0.00666,       49,        4,       45
DYQ, 0.08108, 0.00657,       37,        3,       34
DYR, 0.10345, 0.0107 ,       58,        6,       52
DYS, 0.0339 , 0.00115,       59,        2,       57
DYT, 0.26667, 0.07111,       30,        8,       22
DYV, 0.14035, 0.0197 ,       57,        8,       49
DYW, 0.125  , 0.01562,        8,        1,        7
DYY, 0.32258, 0.10406,       31,       10,       21
DY_, 0      , 0      ,        1,        0,        1
EAE, 0      , 0      ,       92,        0,       92
EAF, 0      , 0      ,      111,        0,      111
EAG, 0.00481, 0.00002,      208,        1,      207
EAH, 0      , 0      ,       19,        0,       19
EAI, 0.01717, 0.00029,      233,        4,      229
EAK, 0.02899, 0.00084,      138,        4,      134
EAL, 0.02632, 0.00069,      380,       10,      370
EAM, 0.05128, 0.00263,       78,        4,       74
EAN, 0.07246, 0.00525,       69,        5,       64
EAP, 0.19101, 0.03649,       89,       17,       72
EAQ, 0      , 0      ,      112,        0,      112
EAR, 0.03378, 0.00114,      148,        5,      143
EAS, 0.06977, 0.00487,      172,       12,      160
EAT, 0.02256, 0.00051,      133,        3,      130
EAV, 0.01596, 0.00025,      188,        3,      185
EAW, 0      , 0      ,       40,        0,       40
EAY, 0      , 0      ,       74,        0,       74
EA_, 0      , 0      ,       18,        0,       18
ECE, 0.1    , 0.01   ,       10,        1,        9
ECF, 0      , 0      ,       29,        0,       29
ECG, 0.03226, 0.00104,       62,        2,       60
ECH, 0      , 0      ,        5,        0,        5
ECI, 0      , 0      ,       25,        0,       25
ECK, 0.01754, 0.00031,       57,        1,       56
ECL, 0      , 0      ,       20,        0,       20
ECM, 0      , 0      ,       13,        0,       13
ECN, 0      , 0      ,        4,        0,        4
ECP, 0      , 0      ,       10,        0,       10
ECQ, 0      , 0      ,       11,        0,       11
ECR, 0      , 0      ,       25,        0,       25
ECS, 0.06667, 0.00444,       30,        2,       28
ECT, 0      , 0      ,       20,        0,       20
ECV, 0      , 0      ,       24,        0,       24
ECW, 0      , 0      ,        2,        0,        2
ECY, 0      , 0      ,        9,        0,        9
EDE, 0      , 0      ,       82,        0,       82
EDF, 0.00781, 0.00006,      128,        1,      127
EDG, 0.03053, 0.00093,      131,        4,      127
EDH, 0.11628, 0.01352,       43,        5,       38
EDI, 0.01183, 0.00014,      169,        2,      167
EDK, 0      , 0      ,      126,        0,      126
EDL, 0.00667, 0.00004,      300,        2,      298
EDM, 0.02174, 0.00047,       46,        1,       45
EDN, 0.03704, 0.00137,       54,        2,       52
EDP, 0.01429, 0.0002 ,       70,        1,       69
EDQ, 0      , 0      ,       39,        0,       39
EDR, 0.06081, 0.0037 ,      148,        9,      139
EDS, 0.0531 , 0.00282,      113,        6,      107
EDT, 0.00833, 0.00007,      120,        1,      119
EDV, 0.01961, 0.00038,      204,        4,      200
EDW, 0      , 0      ,       30,        0,       30
EDY, 0.05063, 0.00256,       79,        4,       75
ED_, 0      , 0      ,        8,        0,        8
EEE, 0      , 0      ,      137,        0,      137
EEF, 0.01562, 0.00024,      128,        2,      126
EEG, 0.0202 , 0.00041,      198,        4,      194
EEH, 0.06897, 0.00476,       29,        2,       27
EEI, 0.02303, 0.00053,      304,        7,      297
EEK, 0.01224, 0.00015,      245,        3,      242
EEL, 0.01275, 0.00016,      549,        7,      542
EEM, 0      , 0      ,       98,        0,       98
EEN, 0.0084 , 0.00007,      119,        1,      118
EEP, 0      , 0      ,      153,        0,      153
EEQ, 0.01626, 0.00026,      123,        2,      121
EER, 0.00948, 0.00009,      211,        2,      209
EES, 0      , 0      ,      141,        0,      141
EET, 0.01242, 0.00015,      161,        2,      159
EEV, 0.01111, 0.00012,      270,        3,      267
EEW, 0      , 0      ,       51,        0,       51
EEY, 0      , 0      ,       84,        0,       84
EE_, 0      , 0      ,       14,        0,       14
EFE, 0      , 0      ,       48,        0,       48
EFF, 0.07018, 0.00492,       57,        4,       53
EFG, 0.05333, 0.00284,       75,        4,       71
EFH, 0      , 0      ,       21,        0,       21
EFI, 0      , 0      ,      119,        0,      119
EFK, 0.22581, 0.05099,       62,       14,       48
EFL, 0.08511, 0.00724,      141,       12,      129
EFM, 0      , 0      ,       44,        0,       44
EFN, 0.02326, 0.00054,       43,        1,       42
EFP, 0.02083, 0.00043,       48,        1,       47
EFQ, 0.03077, 0.00095,       65,        2,       63
EFR, 0.16667, 0.02778,       48,        8,       40
EFS, 0.11111, 0.01235,       81,        9,       72
EFT, 0.02247, 0.0005 ,       89,        2,       87
EFV, 0.02128, 0.00045,       94,        2,       92
EFW, 0.07143, 0.0051 ,       14,        1,       13
EFY, 0.01613, 0.00026,       62,        1,       61
EF_, 0      , 0      ,        3,        0,        3
EGE, 0      , 0      ,       97,        0,       97
EGF, 0.08333, 0.00694,       96,        8,       88
EGG, 0.0099 , 0.0001 ,      101,        1,      100
EGH, 0.05085, 0.00259,       59,        3,       56
EGI, 0.03252, 0.00106,      123,        4,      119
EGK, 0.01149, 0.00013,      174,        2,      172
EGL, 0.03433, 0.00118,      233,        8,      225
EGM, 0      , 0      ,       44,        0,       44
EGN, 0.03704, 0.00137,      108,        4,      104
EGP, 0      , 0      ,      103,        0,      103
EGQ, 0.0396 , 0.00157,      101,        4,       97
EGR, 0.04412, 0.00195,      136,        6,      130
EGS, 0.15044, 0.02263,      113,       17,       96
EGT, 0.01504, 0.00023,      133,        2,      131
EGV, 0      , 0      ,      123,        0,      123
EGW, 0.05556, 0.00309,       18,        1,       17
EGY, 0.02083, 0.00043,       96,        2,       94
EG_, 0      , 0      ,        4,        0,        4
EHE, 0      , 0      ,       28,        0,       28
EHF, 0.07895, 0.00623,       38,        3,       35
EHG, 0.01695, 0.00029,       59,        1,       58
EHH, 0.05714, 0.00327,       35,        2,       33
EHI, 0.04762, 0.00227,       63,        3,       60
EHK, 0.32353, 0.10467,       34,       11,       23
EHL, 0.14384, 0.02069,      146,       21,      125
EHM, 0      , 0      ,       10,        0,       10
EHN, 0.04167, 0.00174,       24,        1,       23
EHP, 0.06667, 0.00444,       30,        2,       28
EHQ, 0.20833, 0.0434 ,       24,        5,       19
EHR, 0.1    , 0.01   ,       40,        4,       36
EHS, 0.26471, 0.07007,       34,        9,       25
EHT, 0.07692, 0.00592,       26,        2,       24
EHV, 0.09615, 0.00925,       52,        5,       47
EHW, 0      , 0      ,       11,        0,       11
EHY, 0      , 0      ,       32,        0,       32
EH_, 0      , 0      ,        3,        0,        3
EIE, 0.03125, 0.00098,       64,        2,       62
EIF, 0.01538, 0.00024,       65,        1,       64
EIG, 0.0146 , 0.00021,      137,        2,      135
EIH, 0.06522, 0.00425,       46,        3,       43
EII, 0.01875, 0.00035,      160,        3,      157
EIK, 0.09091, 0.00826,       88,        8,       80
EIL, 0.01825, 0.00033,      274,        5,      269
EIM, 0.01562, 0.00024,       64,        1,       63
EIN, 0.04444, 0.00198,       90,        4,       86
EIP, 0.03571, 0.00128,       84,        3,       81
EIQ, 0.02041, 0.00042,       98,        2,       96
EIR, 0.01111, 0.00012,       90,        1,       89
EIS, 0.04717, 0.00222,      106,        5,      101
EIT, 0.02857, 0.00082,       70,        2,       68
EIV, 0.04217, 0.00178,      166,        7,      159
EIW, 0      , 0      ,       26,        0,       26
EIY, 0.06383, 0.00407,       94,        6,       88
EI_, 0      , 0      ,        3,        0,        3
EKE, 0.05607, 0.00314,      107,        6,      101
EKF, 0.08219, 0.00676,      146,       12,      134
EKG, 0.09901, 0.0098 ,      202,       20,      182
EKH, 0.13043, 0.01701,       46,        6,       40
EKI, 0.05063, 0.00256,      237,       12,      225
EKK, 0.13825, 0.01911,      217,       30,      187
EKL, 0.07944, 0.00631,      428,       34,      394
EKM, 0.08333, 0.00694,       60,        5,       55
EKN, 0.10811, 0.01169,      111,       12,       99
EKP, 0.15033, 0.0226 ,      153,       23,      130
EKQ, 0.1    , 0.01   ,      110,       11,       99
EKR, 0.18672, 0.03487,      241,       45,      196
EKS, 0.08642, 0.00747,      162,       14,      148
EKT, 0.13281, 0.01764,      128,       17,      111
EKV, 0.07636, 0.00583,      275,       21,      254
EKW, 0.02041, 0.00042,       49,        1,       48
EKY, 0.04237, 0.0018 ,      118,        5,      113
EK_, 0      , 0      ,        8,        0,        8
ELE, 0      , 0      ,      132,        0,      132
ELF, 0      , 0      ,      131,        0,      131
ELG, 0.04464, 0.00199,      224,       10,      214
ELH, 0.03226, 0.00104,       62,        2,       60
ELI, 0.01083, 0.00012,      277,        3,      274
ELK, 0.06084, 0.0037 ,      263,       16,      247
ELL, 0.01285, 0.00017,      467,        6,      461
ELM, 0.01449, 0.00021,       69,        1,       68
ELN, 0.01905, 0.00036,      105,        2,      103
ELP, 0.04651, 0.00216,      129,        6,      123
ELQ, 0      , 0      ,      144,        0,      144
ELR, 0.03913, 0.00153,      230,        9,      221
ELS, 0.01357, 0.00018,      221,        3,      218
ELT, 0.04908, 0.00241,      163,        8,      155
ELV, 0.00952, 0.00009,      210,        2,      208
ELW, 0      , 0      ,       65,        0,       65
ELY, 0      , 0      ,       70,        0,       70
EL_, 0      , 0      ,       10,        0,       10
EME, 0.07692, 0.00592,       39,        3,       36
EMF, 0      , 0      ,       32,        0,       32
EMG, 0.05556, 0.00309,       36,        2,       34
EMH, 0      , 0      ,       10,        0,       10
EMI, 0.00926, 0.00009,      108,        1,      107
EMK, 0      , 0      ,       54,        0,       54
EML, 0.02062, 0.00043,       97,        2,       95
EMM, 0.04167, 0.00174,       24,        1,       23
EMN, 0.02703, 0.00073,       37,        1,       36
EMP, 0.05556, 0.00309,       72,        4,       68
EMQ, 0      , 0      ,       11,        0,       11
EMR, 0.07143, 0.0051 ,       42,        3,       39
EMS, 0.03226, 0.00104,       31,        1,       30
EMT, 0.03846, 0.00148,       26,        1,       25
EMV, 0      , 0      ,       32,        0,       32
EMW, 0      , 0      ,       13,        0,       13
EMY, 0      , 0      ,       37,        0,       37
EM_, 0      , 0      ,       19,        0,       19
ENE, 0.02564, 0.00066,       78,        2,       76
ENF, 0.02564, 0.00066,       78,        2,       76
ENG, 0.09901, 0.0098 ,      101,       10,       91
ENH, 0.05556, 0.00309,       18,        1,       17
ENI, 0.04348, 0.00189,      161,        7,      154
ENK, 0.125  , 0.01562,      112,       14,       98
ENL, 0.04268, 0.00182,      164,        7,      157
ENM, 0.29268, 0.08566,       41,       12,       29
ENN, 0.08451, 0.00714,       71,        6,       65
ENP, 0.02817, 0.00079,       71,        2,       69
ENQ, 0.09375, 0.00879,       64,        6,       58
ENR, 0.09231, 0.00852,      130,       12,      118
ENS, 0.02778, 0.00077,       72,        2,       70
ENT, 0.18085, 0.03271,       94,       17,       77
ENV, 0.03226, 0.00104,      248,        8,      240
ENW, 0      , 0      ,       16,        0,       16
ENY, 0      , 0      ,       71,        0,       71
EN_, 0      , 0      ,        5,        0,        5
EPE, 0.03846, 0.00148,       52,        2,       50
EPF, 0.06667, 0.00444,       75,        5,       70
EPG, 0.01087, 0.00012,       92,        1,       91
EPH, 0      , 0      ,       39,        0,       39
EPI, 0.03488, 0.00122,       86,        3,       83
EPK, 0.01163, 0.00014,       86,        1,       85
EPL, 0.00483, 0.00002,      207,        1,      206
EPM, 0      , 0      ,       41,        0,       41
EPN, 0.0125 , 0.00016,       80,        1,       79
EPP, 0      , 0      ,       64,        0,       64
EPQ, 0.02778, 0.00077,       36,        1,       35
EPR, 0      , 0      ,      109,        0,      109
EPS, 0.02817, 0.00079,       71,        2,       69
EPT, 0.06024, 0.00363,      166,       10,      156
EPV, 0.00667, 0.00004,      150,        1,      149
EPW, 0.03846, 0.00148,       26,        1,       25
EPY, 0.01695, 0.00029,       59,        1,       58
EP_, 0.52632, 0.27701,       19,       10,        9
EQE, 0.01449, 0.00021,       69,        1,       68
EQF, 0.02985, 0.00089,       67,        2,       65
EQG, 0.08   , 0.0064 ,       75,        6,       69
EQH, 0      , 0      ,       40,        0,       40
EQI, 0.07921, 0.00627,      101,        8,       93
EQK, 0.04   , 0.0016 ,      100,        4,       96
EQL, 0.02899, 0.00084,      276,        8,      268
EQM, 0.07692, 0.00592,       52,        4,       48
EQN, 0      , 0      ,       56,        0,       56
EQP, 0.09804, 0.00961,       51,        5,       46
EQQ, 0      , 0      ,       88,        0,       88
EQR, 0.08182, 0.00669,      110,        9,      101
EQS, 0.04762, 0.00227,      126,        6,      120
EQT, 0.2    , 0.04   ,       75,       15,       60
EQV, 0.02308, 0.00053,      130,        3,      127
EQW, 0      , 0      ,       15,        0,       15
EQY, 0.01887, 0.00036,       53,        1,       52
EQ_, 0      , 0      ,        9,        0,        9
ERE, 0.11927, 0.01422,      109,       13,       96
ERF, 0.125  , 0.01562,      112,       14,       98
ERG, 0.11712, 0.01372,      111,       13,       98
ERH, 0.09091, 0.00826,       55,        5,       50
ERI, 0.10684, 0.01141,      234,       25,      209
ERK, 0.18868, 0.0356 ,      159,       30,      129
ERL, 0.10482, 0.01099,      353,       37,      316
ERM, 0.14754, 0.02177,       61,        9,       52
ERN, 0.23423, 0.05487,      111,       26,       85
ERP, 0.15152, 0.02296,       99,       15,       84
ERQ, 0.20423, 0.04171,      142,       29,      113
ERR, 0.20398, 0.04161,      201,       41,      160
ERS, 0.25664, 0.06586,      113,       29,       84
ERT, 0.2126 , 0.0452 ,      127,       27,      100
ERV, 0.11983, 0.01436,      242,       29,      213
ERW, 0.23438, 0.05493,       64,       15,       49
ERY, 0.1165 , 0.01357,      103,       12,       91
ER_, 0.21429, 0.04592,       14,        3,       11
ESE, 0.04545, 0.00207,       44,        2,       42
ESF, 0.04167, 0.00174,       96,        4,       92
ESG, 0.13235, 0.01752,      136,       18,      118
ESH, 0.1    , 0.01   ,       30,        3,       27
ESI, 0.03521, 0.00124,      142,        5,      137
ESK, 0.07692, 0.00592,       91,        7,       84
ESL, 0.09898, 0.0098 ,      293,       29,      264
ESM, 0.08108, 0.00657,       37,        3,       34
ESN, 0.16667, 0.02778,       66,       11,       55
ESP, 0.05155, 0.00266,       97,        5,       92
ESQ, 0.12766, 0.0163 ,       47,        6,       41
ESR, 0.1938 , 0.03756,      129,       25,      104
ESS, 0.072  , 0.00518,      125,        9,      116
EST, 0.06612, 0.00437,      121,        8,      113
ESV, 0.08427, 0.0071 ,      178,       15,      163
ESW, 0      , 0      ,       36,        0,       36
ESY, 0.13208, 0.01744,       53,        7,       46
ES_, 0      , 0      ,       11,        0,       11
ETE, 0.06122, 0.00375,       49,        3,       46
ETF, 0.02105, 0.00044,       95,        2,       93
ETG, 0.01205, 0.00015,       83,        1,       82
ETH, 0.02   , 0.0004 ,       50,        1,       49
ETI, 0.02532, 0.00064,      158,        4,      154
ETK, 0.06977, 0.00487,       86,        6,       80
ETL, 0.02756, 0.00076,      254,        7,      247
ETM, 0.16667, 0.02778,       30,        5,       25
ETN, 0.1746 , 0.03049,       63,       11,       52
ETP, 0.13333, 0.01778,       60,        8,       52
ETQ, 0.05556, 0.00309,       72,        4,       68
ETR, 0.03448, 0.00119,      116,        4,      112
ETS, 0.11   , 0.0121 ,      100,       11,       89
ETT, 0.07595, 0.00577,       79,        6,       73
ETV, 0.06875, 0.00473,      160,       11,      149
ETW, 0      , 0      ,       30,        0,       30
ETY, 0.02439, 0.00059,       41,        1,       40
ET_, 0      , 0      ,       11,        0,       11
EVE, 0      , 0      ,       65,        0,       65
EVF, 0      , 0      ,       64,        0,       64
EVG, 0.03478, 0.00121,      115,        4,      111
EVH, 0.16129, 0.02601,       31,        5,       26
EVI, 0      , 0      ,      142,        0,      142
EVK, 0.04167, 0.00174,       96,        4,       92
EVL, 0.02927, 0.00086,      205,        6,      199
EVM, 0.01587, 0.00025,       63,        1,       62
EVN, 0.01064, 0.00011,       94,        1,       93
EVP, 0.01835, 0.00034,      109,        2,      107
EVQ, 0.05882, 0.00346,       68,        4,       64
EVR, 0.0122 , 0.00015,      164,        2,      162
EVS, 0.01869, 0.00035,      107,        2,      105
EVT, 0      , 0      ,       92,        0,       92
EVV, 0.04516, 0.00204,      155,        7,      148
EVW, 0.18182, 0.03306,       22,        4,       18
EVY, 0      , 0      ,       66,        0,       66
EV_, 0      , 0      ,        9,        0,        9
EWE, 0      , 0      ,       16,        0,       16
EWF, 0.08333, 0.00694,       36,        3,       33
EWG, 0.04545, 0.00207,       22,        1,       21
EWH, 0.34783, 0.12098,       23,        8,       15
EWI, 0      , 0      ,       33,        0,       33
EWK, 0.09091, 0.00826,       22,        2,       20
EWL, 0      , 0      ,       56,        0,       56
EWM, 0      , 0      ,        9,        0,        9
EWN, 0.03125, 0.00098,       32,        1,       31
EWP, 0      , 0      ,       15,        0,       15
EWQ, 0.2    , 0.04   ,       30,        6,       24
EWR, 0.2    , 0.04   ,       20,        4,       16
EWS, 0      , 0      ,       19,        0,       19
EWT, 0.04545, 0.00207,       22,        1,       21
EWV, 0      , 0      ,       23,        0,       23
EWW, 0      , 0      ,       11,        0,       11
EWY, 0      , 0      ,       17,        0,       17
EYE, 0.08571, 0.00735,       35,        3,       32
EYF, 0.06667, 0.00444,       60,        4,       56
EYG, 0.10256, 0.01052,       78,        8,       70
EYH, 0.02857, 0.00082,       35,        1,       34
EYI, 0.04054, 0.00164,       74,        3,       71
EYK, 0.11392, 0.01298,       79,        9,       70
EYL, 0.05208, 0.00271,       96,        5,       91
EYM, 0      , 0      ,       16,        0,       16
EYN, 0.03175, 0.00101,       63,        2,       61
EYP, 0.01923, 0.00037,       52,        1,       51
EYQ, 0      , 0      ,       46,        0,       46
EYR, 0.17544, 0.03078,       57,       10,       47
EYS, 0.0339 , 0.00115,       59,        2,       57
EYT, 0.03333, 0.00111,       60,        2,       58
EYV, 0.04444, 0.00198,       90,        4,       86
EYW, 0.06897, 0.00476,       29,        2,       27
EYY, 0.35366, 0.12507,       82,       29,       53
EY_, 0      , 0      ,        2,        0,        2
FAF, 0      , 0      ,       12,        0,       12
FAG, 0      , 0      ,       54,        0,       54
FAH, 0.08333, 0.00694,       12,        1,       11
FAI, 0.02857, 0.00082,       35,        1,       34
FAK, 0.08911, 0.00794,      101,        9,       92
FAL, 0.01099, 0.00012,       91,        1,       90
FAM, 0      , 0      ,       52,        0,       52
FAN, 0.00885, 0.00008,      113,        1,      112
FAP, 0.20408, 0.04165,       49,       10,       39
FAQ, 0.10714, 0.01148,       56,        6,       50
FAR, 0.01316, 0.00017,       76,        1,       75
FAS, 0.0297 , 0.00088,      101,        3,       98
FAT, 0.01087, 0.00012,       92,        1,       91
FAV, 0.04255, 0.00181,       47,        2,       45
FAW, 0      , 0      ,        3,        0,        3
FAY, 0      , 0      ,       28,        0,       28
FA_, 0      , 0      ,        2,        0,        2
FCF, 0      , 0      ,        1,        0,        1
FCG, 0.30769, 0.09467,       26,        8,       18
FCH, 0      , 0      ,        8,        0,        8
FCI, 0      , 0      ,        8,        0,        8
FCK, 0.125  , 0.01562,       24,        3,       21
FCL, 0      , 0      ,       17,        0,       17
FCM, 0      , 0      ,        4,        0,        4
FCN, 0      , 0      ,       12,        0,       12
FCP, 0.25   , 0.0625 ,        4,        1,        3
FCQ, 0      , 0      ,        9,        0,        9
FCR, 0      , 0      ,       28,        0,       28
FCS, 0      , 0      ,       12,        0,       12
FCT, 0      , 0      ,        7,        0,        7
FCV, 0      , 0      ,        8,        0,        8
FCY, 0      , 0      ,        2,        0,        2
FC_, 0      , 0      ,        1,        0,        1
FDF, 0.04082, 0.00167,       49,        2,       47
FDG, 0.07042, 0.00496,       71,        5,       66
FDH, 0      , 0      ,       20,        0,       20
FDI, 0.11429, 0.01306,       70,        8,       62
FDK, 0.05208, 0.00271,       96,        5,       91
FDL, 0      , 0      ,      125,        0,      125
FDM, 0.14286, 0.02041,       42,        6,       36
FDN, 0      , 0      ,       72,        0,       72
FDP, 0.03191, 0.00102,       94,        3,       91
FDQ, 0      , 0      ,       59,        0,       59
FDR, 0.0283 , 0.0008 ,      106,        3,      103
FDS, 0.0463 , 0.00214,      108,        5,      103
FDT, 0      , 0      ,       48,        0,       48
FDV, 0.11111, 0.01235,       72,        8,       64
FDW, 0      , 0      ,       10,        0,       10
FDY, 0.2    , 0.04   ,       40,        8,       32
FD_, 0      , 0      ,        5,        0,        5
FEF, 0      , 0      ,       24,        0,       24
FEG, 0.01042, 0.00011,       96,        1,       95
FEH, 0      , 0      ,       22,        0,       22
FEI, 0.03636, 0.00132,      110,        4,      106
FEK, 0.01379, 0.00019,      145,        2,      143
FEL, 0.10924, 0.01193,      119,       13,      106
FEM, 0      , 0      ,       32,        0,       32
FEN, 0.05333, 0.00284,       75,        4,       71
FEP, 0      , 0      ,       75,        0,       75
FEQ, 0      , 0      ,       77,        0,       77
FER, 0.04878, 0.00238,      123,        6,      117
FES, 0.08772, 0.00769,      114,       10,      104
FET, 0      , 0      ,       61,        0,       61
FEV, 0.0274 , 0.00075,       73,        2,       71
FEW, 0      , 0      ,       28,        0,       28
FEY, 0.10811, 0.01169,       37,        4,       33
FE_, 0.07143, 0.0051 ,       14,        1,       13
FFF, 0      , 0      ,       19,        0,       19
FFG, 0.25   , 0.0625 ,       40,       10,       30
FFH, 0.11111, 0.01235,       36,        4,       32
FFI, 0.03226, 0.00104,       31,        1,       30
FFK, 0      , 0      ,       49,        0,       49
FFL, 0.02941, 0.00087,       34,        1,       33
FFM, 0      , 0      ,        5,        0,        5
FFN, 0.04651, 0.00216,       43,        2,       41
FFP, 0      , 0      ,       38,        0,       38
FFQ, 0.11111, 0.01235,       27,        3,       24
FFR, 0.0303 , 0.00092,       66,        2,       64
FFS, 0.01887, 0.00036,       53,        1,       52
FFT, 0      , 0      ,       30,        0,       30
FFV, 0.13333, 0.01778,       45,        6,       39
FFW, 0      , 0      ,        5,        0,        5
FFY, 0.19048, 0.03628,       21,        4,       17
FF_, 0      , 0      ,        3,        0,        3
FGF, 0      , 0      ,        6,        0,        6
FGG, 0.16471, 0.02713,       85,       14,       71
FGH, 0      , 0      ,       40,        0,       40
FGI, 0.07246, 0.00525,       69,        5,       64
FGK, 0.1938 , 0.03756,      129,       25,      104
FGL, 0.07042, 0.00496,       71,        5,       66
FGM, 0.16667, 0.02778,       42,        7,       35
FGN, 0.10127, 0.01025,       79,        8,       71
FGP, 0      , 0      ,       36,        0,       36
FGQ, 0.26923, 0.07249,      104,       28,       76
FGR, 0.09783, 0.00957,       92,        9,       83
FGS, 0.02817, 0.00079,       71,        2,       69
FGT, 0.01515, 0.00023,       66,        1,       65
FGV, 0.1    , 0.01   ,       50,        5,       45
FGW, 0      , 0      ,        4,        0,        4
FGY, 0.07692, 0.00592,       39,        3,       36
FG_, 0.25   , 0.0625 ,        4,        1,        3
FHF, 0.28   , 0.0784 ,       25,        7,       18
FHG, 0.2    , 0.04   ,       15,        3,       12
FHH, 0.04545, 0.00207,       22,        1,       21
FHI, 0.04348, 0.00189,       23,        1,       22
FHK, 0.15385, 0.02367,       39,        6,       33
FHL, 0.05556, 0.00309,       54,        3,       51
FHM, 0      , 0      ,       14,        0,       14
FHN, 0      , 0      ,       19,        0,       19
FHP, 0.125  , 0.01562,       16,        2,       14
FHQ, 0.05263, 0.00277,       19,        1,       18
FHR, 0.10448, 0.01092,       67,        7,       60
FHS, 0.15152, 0.02296,       33,        5,       28
FHT, 0      , 0      ,       30,        0,       30
FHV, 0.04545, 0.00207,       22,        1,       21
FHW, 0.28571, 0.08163,        7,        2,        5
FHY, 0.57143, 0.32653,       14,        8,        6
FIF, 0      , 0      ,        4,        0,        4
FIG, 0.09302, 0.00865,       43,        4,       39
FIH, 0.02778, 0.00077,       36,        1,       35
FII, 0      , 0      ,       26,        0,       26
FIK, 0.05263, 0.00277,       76,        4,       72
FIL, 0.06173, 0.00381,       81,        5,       76
FIM, 0      , 0      ,       19,        0,       19
FIN, 0.09091, 0.00826,       88,        8,       80
FIP, 0.04082, 0.00167,       49,        2,       47
FIQ, 0.02174, 0.00047,       46,        1,       45
FIR, 0.04839, 0.00234,       62,        3,       59
FIS, 0.01282, 0.00016,       78,        1,       77
FIT, 0.01538, 0.00024,       65,        1,       64
FIV, 0.02128, 0.00045,       47,        1,       46
FIW, 0      , 0      ,        3,        0,        3
FIY, 0.03571, 0.00128,       28,        1,       27
FI_, 1      , 1      ,        2,        2,        0
FKF, 0.2    , 0.04   ,       15,        3,       12
FKG, 0.17582, 0.03091,       91,       16,       75
FKH, 0.25   , 0.0625 ,       20,        5,       15
FKI, 0.14634, 0.02142,       82,       12,       70
FKK, 0.12698, 0.01612,      126,       16,      110
FKL, 0.08257, 0.00682,      109,        9,      100
FKM, 0.07317, 0.00535,       41,        3,       38
FKN, 0.05263, 0.00277,       95,        5,       90
FKP, 0.11111, 0.01235,      126,       14,      112
FKQ, 0.07692, 0.00592,       91,        7,       84
FKR, 0.42268, 0.17866,       97,       41,       56
FKS, 0.07547, 0.0057 ,       53,        4,       49
FKT, 0.125  , 0.01562,       56,        7,       49
FKV, 0.15217, 0.02316,       92,       14,       78
FKW, 0.4    , 0.16   ,        5,        2,        3
FKY, 0.11458, 0.01313,       96,       11,       85
FK_, 0      , 0      ,        5,        0,        5
FLF, 0      , 0      ,       20,        0,       20
FLG, 0.05882, 0.00346,       85,        5,       80
FLH, 0      , 0      ,       27,        0,       27
FLI, 0      , 0      ,       34,        0,       34
FLK, 0.05769, 0.00333,      104,        6,       98
FLL, 0.04819, 0.00232,       83,        4,       79
FLM, 0.03333, 0.00111,       30,        1,       29
FLN, 0      , 0      ,       58,        0,       58
FLP, 0.02703, 0.00073,       74,        2,       72
FLQ, 0.01887, 0.00036,       53,        1,       52
FLR, 0      , 0      ,      111,        0,      111
FLS, 0.0354 , 0.00125,      113,        4,      109
FLT, 0.0202 , 0.00041,       99,        2,       97
FLV, 0.10417, 0.01085,       96,       10,       86
FLW, 0      , 0      ,        4,        0,        4
FLY, 0.02273, 0.00052,       44,        1,       43
FL_, 0.14286, 0.02041,        7,        1,        6
FMF, 0      , 0      ,        2,        0,        2
FMG, 0.375  , 0.14062,       16,        6,       10
FMH, 0      , 0      ,        2,        0,        2
FMI, 0.28571, 0.08163,       21,        6,       15
FMK, 0      , 0      ,       24,        0,       24
FML, 0.04651, 0.00216,       43,        2,       41
FMM, 0      , 0      ,        9,        0,        9
FMN, 0.06667, 0.00444,       15,        1,       14
FMP, 0.06667, 0.00444,       15,        1,       14
FMQ, 0      , 0      ,       15,        0,       15
FMR, 0.06897, 0.00476,       29,        2,       27
FMS, 0      , 0      ,       23,        0,       23
FMT, 0      , 0      ,       20,        0,       20
FMV, 0.15   , 0.0225 ,       40,        6,       34
FMY, 0      , 0      ,        2,        0,        2
FM_, 0      , 0      ,        8,        0,        8
FNF, 0      , 0      ,       24,        0,       24
FNG, 0.13208, 0.01744,       53,        7,       46
FNH, 0      , 0      ,       18,        0,       18
FNI, 0.12857, 0.01653,       70,        9,       61
FNK, 0.14607, 0.02134,       89,       13,       76
FNL, 0.05128, 0.00263,       78,        4,       74
FNM, 0.04762, 0.00227,       21,        1,       20
FNN, 0.03175, 0.00101,       63,        2,       61
FNP, 0.06667, 0.00444,       60,        4,       56
FNQ, 0.472  , 0.22278,      125,       59,       66
FNR, 0.11864, 0.01408,       59,        7,       52
FNS, 0.11364, 0.01291,       44,        5,       39
FNT, 0.1    , 0.01   ,       40,        4,       36
FNV, 0.16667, 0.02778,       54,        9,       45
FNW, 0      , 0      ,       15,        0,       15
FNY, 0.06667, 0.00444,       45,        3,       42
FN_, 0      , 0      ,        7,        0,        7
FPF, 0      , 0      ,        9,        0,        9
FPG, 0.10638, 0.01132,       47,        5,       42
FPH, 0.05556, 0.00309,       36,        2,       34
FPI, 0.08451, 0.00714,       71,        6,       65
FPK, 0.02899, 0.00084,       69,        2,       67
FPL, 0.0597 , 0.00356,       67,        4,       63
FPM, 0.05263, 0.00277,       19,        1,       18
FPN, 0.18644, 0.03476,       59,       11,       48
FPP, 0.09091, 0.00826,       55,        5,       50
FPQ, 0      , 0      ,       33,        0,       33
FPR, 0.12308, 0.01515,       65,        8,       57
FPS, 0.01389, 0.00019,       72,        1,       71
FPT, 0      , 0      ,       31,        0,       31
FPV, 0.11111, 0.01235,       63,        7,       56
FPW, 0      , 0      ,        1,        0,        1
FPY, 0      , 0      ,       34,        0,       34
FP_, 0      , 0      ,        5,        0,        5
FQF, 0.22222, 0.04938,       18,        4,       14
FQG, 0.07229, 0.00523,       83,        6,       77
FQH, 0.23077, 0.05325,       26,        6,       20
FQI, 0.19298, 0.03724,       57,       11,       46
FQK, 0.04286, 0.00184,       70,        3,       67
FQL, 0.13115, 0.0172 ,       61,        8,       53
FQM, 0.04545, 0.00207,       22,        1,       21
FQN, 0.39062, 0.15259,       64,       25,       39
FQP, 0      , 0      ,       29,        0,       29
FQQ, 0.01887, 0.00036,       53,        1,       52
FQR, 0.01613, 0.00026,       62,        1,       61
FQS, 0.12088, 0.01461,       91,       11,       80
FQT, 0.03226, 0.00104,       93,        3,       90
FQV, 0.01887, 0.00036,       53,        1,       52
FQW, 0      , 0      ,       28,        0,       28
FQY, 0.03704, 0.00137,       27,        1,       26
FQ_, 0      , 0      ,       12,        0,       12
FRF, 0.19231, 0.03698,       26,        5,       21
FRG, 0.31731, 0.10068,      104,       33,       71
FRH, 0.23077, 0.05325,       26,        6,       20
FRI, 0.33333, 0.11111,       66,       22,       44
FRK, 0.22772, 0.05186,      101,       23,       78
FRL, 0.20354, 0.04143,      113,       23,       90
FRM, 0      , 0      ,       34,        0,       34
FRN, 0.13433, 0.01804,       67,        9,       58
FRP, 0.15584, 0.02429,       77,       12,       65
FRQ, 0.17857, 0.03189,       56,       10,       46
FRR, 0.18852, 0.03554,      122,       23,       99
FRS, 0.26126, 0.06826,      111,       29,       82
FRT, 0.23636, 0.05587,       55,       13,       42
FRV, 0.25455, 0.06479,      110,       28,       82
FRW, 0      , 0      ,       20,        0,       20
FRY, 0.15556, 0.0242 ,       45,        7,       38
FR_, 0      , 0      ,        7,        0,        7
FSF, 0.10526, 0.01108,       19,        2,       17
FSG, 0.14103, 0.01989,       78,       11,       67
FSH, 0.06061, 0.00367,       33,        2,       31
FSI, 0.15517, 0.02408,       58,        9,       49
FSK, 0.13725, 0.01884,      102,       14,       88
FSL, 0.17188, 0.02954,      128,       22,      106
FSM, 0      , 0      ,       25,        0,       25
FSN, 0.08667, 0.00751,      150,       13,      137
FSP, 0.06452, 0.00416,       62,        4,       58
FSQ, 0.19697, 0.0388 ,       66,       13,       53
FSR, 0.19469, 0.0379 ,      113,       22,       91
FSS, 0.07955, 0.00633,       88,        7,       81
FST, 0.09091, 0.00826,       66,        6,       60
FSV, 0.18812, 0.03539,      101,       19,       82
FSW, 0.16667, 0.02778,       18,        3,       15
FSY, 0.03333, 0.00111,       30,        1,       29
FS_, 0      , 0      ,       15,        0,       15
FTF, 0      , 0      ,       26,        0,       26
FTG, 0.11594, 0.01344,       69,        8,       61
FTH, 0.07143, 0.0051 ,       28,        2,       26
FTI, 0.05263, 0.00277,       38,        2,       36
FTK, 0.125  , 0.01562,      104,       13,       91
FTL, 0.01905, 0.00036,      105,        2,      103
FTM, 0.15625, 0.02441,       32,        5,       27
FTN, 0.22857, 0.05224,       35,        8,       27
FTP, 0.02439, 0.00059,       41,        1,       40
FTQ, 0.09375, 0.00879,       32,        3,       29
FTR, 0.13402, 0.01796,       97,       13,       84
FTS, 0.07647, 0.00585,      170,       13,      157
FTT, 0.0566 , 0.0032 ,       53,        3,       50
FTV, 0.03896, 0.00152,       77,        3,       74
FTW, 0      , 0      ,        7,        0,        7
FTY, 0.09756, 0.00952,       41,        4,       37
FT_, 0      , 0      ,       12,        0,       12
FVF, 0.2    , 0.04   ,       10,        2,        8
FVG, 0.11905, 0.01417,       42,        5,       37
FVH, 0      , 0      ,       13,        0,       13
FVI, 0.07576, 0.00574,       66,        5,       61
FVK, 0.12963, 0.0168 ,      108,       14,       94
FVL, 0.03125, 0.00098,       96,        3,       93
FVM, 0      , 0      ,        8,        0,        8
FVN, 0.0625 , 0.00391,       64,        4,       60
FVP, 0      , 0      ,       42,        0,       42
FVQ, 0.07407, 0.00549,       27,        2,       25
FVR, 0.01136, 0.00013,       88,        1,       87
FVS, 0.0125 , 0.00016,       80,        1,       79
FVT, 0.04878, 0.00238,       41,        2,       39
FVV, 0.08   , 0.0064 ,       50,        4,       46
FVW, 0      , 0      ,        2,        0,        2
FVY, 0      , 0      ,       49,        0,       49
FV_, 0      , 0      ,        1,        0,        1
FWF, 0      , 0      ,        7,        0,        7
FWG, 0.11111, 0.01235,       18,        2,       16
FWH, 0      , 0      ,        6,        0,        6
FWI, 0.51724, 0.26754,       29,       15,       14
FWK, 0.2    , 0.04   ,       20,        4,       16
FWL, 0.08696, 0.00756,       23,        2,       21
FWM, 0      , 0      ,        3,        0,        3
FWN, 0.31579, 0.09972,       19,        6,       13
FWP, 0.18182, 0.03306,       11,        2,        9
FWQ, 0      , 0      ,        9,        0,        9
FWR, 0.26316, 0.06925,       19,        5,       14
FWS, 0.33333, 0.11111,       24,        8,       16
FWT, 0.5    , 0.25   ,        8,        4,        4
FWV, 0.54545, 0.29752,       11,        6,        5
FWY, 0      , 0      ,        2,        0,        2
FW_, 0      , 0      ,        1,        0,        1
FYF, 0      , 0      ,       18,        0,       18
FYG, 0.09091, 0.00826,       55,        5,       50
FYH, 0.05882, 0.00346,       17,        1,       16
FYI, 0.45714, 0.20898,       35,       16,       19
FYK, 0.05357, 0.00287,       56,        3,       53
FYL, 0.22727, 0.05165,       66,       15,       51
FYM, 0      , 0      ,        3,        0,        3
FYN, 0      , 0      ,       27,        0,       27
FYP, 0.0339 , 0.00115,       59,        2,       57
FYQ, 0.12162, 0.01479,       74,        9,       65
FYR, 0.23404, 0.05478,       47,       11,       36
FYS, 0.03774, 0.00142,       53,        2,       51
FYT, 0      , 0      ,       48,        0,       48
FYV, 0.02439, 0.00059,       41,        1,       40
FYW, 0      , 0      ,        9,        0,        9
FYY, 0.19355, 0.03746,       31,        6,       25
FY_, 0      , 0      ,        1,        0,        1
GAG, 0.20792, 0.04323,      101,       21,       80
GAH, 0.07143, 0.0051 ,       70,        5,       65
GAI, 0.03509, 0.00123,       57,        2,       55
GAK, 0.0942 , 0.00887,      138,       13,      125
GAL, 0.12037, 0.01449,      216,       26,      190
GAM, 0.18182, 0.03306,       44,        8,       36
GAN, 0.03226, 0.00104,       62,        2,       60
GAP, 0.12621, 0.01593,      103,       13,       90
GAQ, 0.01667, 0.00028,       60,        1,       59
GAR, 0.09091, 0.00826,      132,       12,      120
GAS, 0.13333, 0.01778,      105,       14,       91
GAT, 0.09615, 0.00925,      104,       10,       94
GAV, 0.1369 , 0.01874,      168,       23,      145
GAW, 0.06452, 0.00416,       31,        2,       29
GAY, 0.05556, 0.00309,       36,        2,       34
GA_, 0      , 0      ,        9,        0,        9
GCG, 0.03846, 0.00148,       26,        1,       25
GCH, 0.5    , 0.25   ,       14,        7,        7
GCI, 0.11765, 0.01384,       17,        2,       15
GCK, 0.0303 , 0.00092,       33,        1,       32
GCL, 0.06061, 0.00367,       33,        2,       31
GCM, 0      , 0      ,       14,        0,       14
GCN, 0.07407, 0.00549,       27,        2,       25
GCP, 0      , 0      ,       10,        0,       10
GCQ, 0      , 0      ,       22,        0,       22
GCR, 0.10714, 0.01148,       28,        3,       25
GCS, 0.21429, 0.04592,       14,        3,       11
GCT, 0.05714, 0.00327,       35,        2,       33
GCV, 0.08333, 0.00694,       36,        3,       33
GCW, 0      , 0      ,        2,        0,        2
GCY, 0      , 0      ,        9,        0,        9
GC_, 0.33333, 0.11111,        3,        1,        2
GDG, 0.125  , 0.01562,       32,        4,       28
GDH, 0.45714, 0.20898,       35,       16,       19
GDI, 0.09231, 0.00852,      130,       12,      118
GDK, 0.0463 , 0.00214,      108,        5,      103
GDL, 0.04196, 0.00176,      143,        6,      137
GDM, 0.07692, 0.00592,       39,        3,       36
GDN, 0.02667, 0.00071,       75,        2,       73
GDP, 0.01064, 0.00011,       94,        1,       93
GDQ, 0.07317, 0.00535,       41,        3,       38
GDR, 0.04511, 0.00204,      133,        6,      127
GDS, 0.22727, 0.05165,       88,       20,       68
GDT, 0.12821, 0.01644,       78,       10,       68
GDV, 0.10101, 0.0102 ,      198,       20,      178
GDW, 0.07692, 0.00592,       13,        1,       12
GDY, 0.09804, 0.00961,       51,        5,       46
GD_, 0      , 0      ,        3,        0,        3
GEG, 0.14667, 0.02151,       75,       11,       64
GEH, 0.08108, 0.00657,       37,        3,       34
GEI, 0.04444, 0.00198,      180,        8,      172
GEK, 0.01143, 0.00013,      175,        2,      173
GEL, 0.00885, 0.00008,      226,        2,      224
GEM, 0      , 0      ,       69,        0,       69
GEN, 0.025  , 0.00063,       80,        2,       78
GEP, 0.03546, 0.00126,      141,        5,      136
GEQ, 0.02273, 0.00052,      132,        3,      129
GER, 0.05742, 0.0033 ,      209,       12,      197
GES, 0.05825, 0.00339,      103,        6,       97
GET, 0.06604, 0.00436,      106,        7,       99
GEV, 0.04192, 0.00176,      167,        7,      160
GEW, 0.03571, 0.00128,       28,        1,       27
GEY, 0.01408, 0.0002 ,       71,        1,       70
GE_, 0      , 0      ,        6,        0,        6
GFG, 0.16667, 0.02778,       54,        9,       45
GFH, 0      , 0      ,       22,        0,       22
GFI, 0.08654, 0.00749,      104,        9,       95
GFK, 0.08   , 0.0064 ,       75,        6,       69
GFL, 0.03306, 0.00109,      121,        4,      117
GFM, 0      , 0      ,       26,        0,       26
GFN, 0.24138, 0.05826,       29,        7,       22
GFP, 0.11236, 0.01262,       89,       10,       79
GFQ, 0.08621, 0.00743,       58,        5,       53
GFR, 0.30172, 0.09104,      116,       35,       81
GFS, 0.24561, 0.06033,       57,       14,       43
GFT, 0.13846, 0.01917,       65,        9,       56
GFV, 0.11429, 0.01306,       70,        8,       62
GFW, 0.25   , 0.0625 ,        8,        2,        6
GFY, 0      , 0      ,       46,        0,       46
GF_, 0.5    , 0.25   ,        2,        1,        1
GGG, 0.65306, 0.42649,       49,       32,       17
GGH, 0.35556, 0.12642,       45,       16,       29
GGI, 0.21311, 0.04542,       61,       13,       48
GGK, 0.08511, 0.00724,      141,       12,      129
GGL, 0.14384, 0.02069,      146,       21,      125
GGM, 0      , 0      ,       25,        0,       25
GGN, 0.50617, 0.25621,       81,       41,       40
GGP, 0.13235, 0.01752,       68,        9,       59
GGQ, 0.09231, 0.00852,       65,        6,       59
GGR, 0.20155, 0.04062,      129,       26,      103
GGS, 0.13415, 0.018  ,       82,       11,       71
GGT, 0.33333, 0.11111,       78,       26,       52
GGV, 0.08333, 0.00694,      144,       12,      132
GGW, 0.36842, 0.13573,       19,        7,       12
GGY, 0.31818, 0.10124,       44,       14,       30
GG_, 0.375  , 0.14062,        8,        3,        5
GHG, 0      , 0      ,       15,        0,       15
GHH, 0.27273, 0.07438,       22,        6,       16
GHI, 0.17742, 0.03148,       62,       11,       51
GHK, 0.14286, 0.02041,       49,        7,       42
GHL, 0.0641 , 0.00411,       78,        5,       73
GHM, 0      , 0      ,        8,        0,        8
GHN, 0.16667, 0.02778,       24,        4,       20
GHP, 0.23333, 0.05444,       30,        7,       23
GHQ, 0.28571, 0.08163,       28,        8,       20
GHR, 0.28169, 0.07935,       71,       20,       51
GHS, 0.14894, 0.02218,       47,        7,       40
GHT, 0.15385, 0.02367,       39,        6,       33
GHV, 0.04   , 0.0016 ,       50,        2,       48
GHW, 0      , 0      ,       15,        0,       15
GHY, 0.22449, 0.0504 ,       49,       11,       38
GH_, 0.5    , 0.25   ,        2,        1,        1
GIG, 0.24691, 0.06097,       81,       20,       61
GIH, 0      , 0      ,       37,        0,       37
GII, 0.03371, 0.00114,       89,        3,       86
GIK, 0.15232, 0.0232 ,      151,       23,      128
GIL, 0      , 0      ,      159,        0,      159
GIM, 0      , 0      ,       27,        0,       27
GIN, 0.13115, 0.0172 ,       61,        8,       53
GIP, 0.0604 , 0.00365,      149,        9,      140
GIQ, 0.14286, 0.02041,       63,        9,       54
GIR, 0.125  , 0.01562,      168,       21,      147
GIS, 0.2    , 0.04   ,      110,       22,       88
GIT, 0.05224, 0.00273,      134,        7,      127
GIV, 0.07   , 0.0049 ,      100,        7,       93
GIW, 0      , 0      ,        3,        0,        3
GIY, 0.06897, 0.00476,       58,        4,       54
GI_, 0      , 0      ,       13,        0,       13
GKG, 0.18987, 0.03605,       79,       15,       64
GKH, 0.3    , 0.09   ,       20,        6,       14
GKI, 0.16837, 0.02835,      196,       33,      163
GKK, 0.1875 , 0.03516,      176,       33,      143
GKL, 0.1433 , 0.02054,      321,       46,      275
GKM, 0.13333, 0.01778,       45,        6,       39
GKN, 0.18421, 0.03393,       76,       14,       62
GKP, 0.15672, 0.02456,      134,       21,      113
GKQ, 0.31013, 0.09618,      158,       49,      109
GKR, 0.22632, 0.05122,      190,       43,      147
GKS, 0.2439 , 0.05949,      164,       40,      124
GKT, 0.15135, 0.02291,      185,       28,      157
GKV, 0.19853, 0.03941,      136,       27,      109
GKW, 0.2    , 0.04   ,       55,       11,       44
GKY, 0.19737, 0.03895,       76,       15,       61
GK_, 0      , 0      ,       11,        0,       11
GLG, 0.04478, 0.002  ,       67,        3,       64
GLH, 0.0339 , 0.00115,       59,        2,       57
GLI, 0.11009, 0.01212,      109,       12,       97
GLK, 0.23492, 0.05519,      315,       74,      241
GLL, 0.03153, 0.00099,      222,        7,      215
GLM, 0      , 0      ,       38,        0,       38
GLN, 0.16038, 0.02572,      106,       17,       89
GLP, 0.07586, 0.00576,      145,       11,      134
GLQ, 0.024  , 0.00058,      125,        3,      122
GLR, 0.0101 , 0.0001 ,      198,        2,      196
GLS, 0.12667, 0.01604,      150,       19,      131
GLT, 0.0535 , 0.00286,      243,       13,      230
GLV, 0.0137 , 0.00019,      146,        2,      144
GLW, 0.05882, 0.00346,       34,        2,       32
GLY, 0.06977, 0.00487,       86,        6,       80
GL_, 0      , 0      ,       15,        0,       15
GMG, 0.125  , 0.01562,       16,        2,       14
GMH, 0.3    , 0.09   ,       20,        6,       14
GMI, 0.19048, 0.03628,       21,        4,       17
GMK, 0.19355, 0.03746,       31,        6,       25
GML, 0.01613, 0.00026,       62,        1,       61
GMM, 0      , 0      ,       15,        0,       15
GMN, 0.04545, 0.00207,       22,        1,       21
GMP, 0.02632, 0.00069,       38,        1,       37
GMQ, 0      , 0      ,       18,        0,       18
GMR, 0.09259, 0.00857,       54,        5,       49
GMS, 0.19149, 0.03667,       47,        9,       38
GMT, 0      , 0      ,       36,        0,       36
GMV, 0      , 0      ,       48,        0,       48
GMW, 0.28571, 0.08163,        7,        2,        5
GMY, 0      , 0      ,       13,        0,       13
GM_, 0.06667, 0.00444,       15,        1,       14
GNG, 0.02632, 0.00069,       38,        1,       37
GNH, 0.66667, 0.44444,       15,       10,        5
GNI, 0.03871, 0.0015 ,      155,        6,      149
GNK, 0.19492, 0.03799,      118,       23,       95
GNL, 0.20408, 0.04165,      147,       30,      117
GNM, 0.20588, 0.04239,       34,        7,       27
GNN, 0.23913, 0.05718,       46,       11,       35
GNP, 0.07692, 0.00592,      117,        9,      108
GNQ, 0.11364, 0.01291,       44,        5,       39
GNR, 0.14851, 0.02206,      101,       15,       86
GNS, 0.09804, 0.00961,      102,       10,       92
GNT, 0.10526, 0.01108,       57,        6,       51
GNV, 0.14286, 0.02041,       70,       10,       60
GNW, 0.32143, 0.10332,       28,        9,       19
GNY, 0.32653, 0.10662,       49,       16,       33
GN_, 0      , 0      ,        5,        0,        5
GPG, 0.12195, 0.01487,       41,        5,       36
GPH, 0.125  , 0.01562,       48,        6,       42
GPI, 0.07368, 0.00543,       95,        7,       88
GPK, 0.08421, 0.00709,       95,        8,       87
GPL, 0      , 0      ,      117,        0,      117
GPM, 0.07143, 0.0051 ,       42,        3,       39
GPN, 0.44361, 0.19679,      133,       59,       74
GPP, 0.03333, 0.00111,       90,        3,       87
GPQ, 0.01724, 0.0003 ,       58,        1,       57
GPR, 0.04545, 0.00207,       66,        3,       63
GPS, 0.08511, 0.00724,       47,        4,       43
GPT, 0.20896, 0.04366,       67,       14,       53
GPV, 0.05556, 0.00309,       72,        4,       68
GPW, 0.11111, 0.01235,       18,        2,       16
GPY, 0.03226, 0.00104,       31,        1,       30
GP_, 0      , 0      ,        6,        0,        6
GQG, 0.14894, 0.02218,       47,        7,       40
GQH, 0.0303 , 0.00092,       33,        1,       32
GQI, 0.14563, 0.02121,      103,       15,       88
GQK, 0.06306, 0.00398,      111,        7,      104
GQL, 0.02649, 0.0007 ,      151,        4,      147
GQM, 0.1    , 0.01   ,       20,        2,       18
GQN, 0.08696, 0.00756,       46,        4,       42
GQP, 0.06024, 0.00363,       83,        5,       78
GQQ, 0      , 0      ,       43,        0,       43
GQR, 0.08974, 0.00805,       78,        7,       71
GQS, 0.04   , 0.0016 ,       75,        3,       72
GQT, 0.02222, 0.00049,       45,        1,       44
GQV, 0.08036, 0.00646,      112,        9,      103
GQW, 0      , 0      ,       13,        0,       13
GQY, 0.60606, 0.36731,       99,       60,       39
GQ_, 0      , 0      ,        4,        0,        4
GRG, 0.39623, 0.157  ,      106,       42,       64
GRH, 0.12121, 0.01469,       66,        8,       58
GRI, 0.10484, 0.01099,      124,       13,      111
GRK, 0.28188, 0.07946,      149,       42,      107
GRL, 0.21212, 0.045  ,      297,       63,      234
GRM, 0.05556, 0.00309,       18,        1,       17
GRN, 0.37349, 0.1395 ,       83,       31,       52
GRP, 0.3625 , 0.13141,       80,       29,       51
GRQ, 0.19767, 0.03908,       86,       17,       69
GRR, 0.33714, 0.11367,      175,       59,      116
GRS, 0.30172, 0.09104,      116,       35,       81
GRT, 0.24648, 0.06075,      142,       35,      107
GRV, 0.1875 , 0.03516,      128,       24,      104
GRW, 0.37037, 0.13717,       27,       10,       17
GRY, 0.10714, 0.01148,       84,        9,       75
GR_, 0.375  , 0.14062,        8,        3,        5
GSG, 0.13514, 0.01826,      148,       20,      128
GSH, 0.05263, 0.00277,       57,        3,       54
GSI, 0.08   , 0.0064 ,      100,        8,       92
GSK, 0.2043 , 0.04174,       93,       19,       74
GSL, 0.10667, 0.01138,      150,       16,      134
GSM, 0      , 0      ,       25,        0,       25
GSN, 0.11321, 0.01282,       53,        6,       47
GSP, 0.04848, 0.00235,      165,        8,      157
GSQ, 0.0122 , 0.00015,       82,        1,       81
GSR, 0.17424, 0.03036,      132,       23,      109
GSS, 0.14474, 0.02095,       76,       11,       65
GST, 0.09924, 0.00985,      131,       13,      118
GSV, 0.0458 , 0.0021 ,      131,        6,      125
GSW, 0.15   , 0.0225 ,       20,        3,       17
GSY, 0.08772, 0.00769,       57,        5,       52
GS_, 0.14286, 0.02041,        7,        1,        6
GTG, 0.09375, 0.00879,       64,        6,       58
GTH, 0.02128, 0.00045,       47,        1,       46
GTI, 0.0566 , 0.0032 ,      212,       12,      200
GTK, 0.22936, 0.0526 ,      109,       25,       84
GTL, 0.125  , 0.01562,      152,       19,      133
GTM, 0.27778, 0.07716,       36,       10,       26
GTN, 0.19149, 0.03667,       47,        9,       38
GTP, 0.14655, 0.02148,      116,       17,       99
GTQ, 0.14035, 0.0197 ,       57,        8,       49
GTR, 0.12644, 0.01599,       87,       11,       76
GTS, 0.11957, 0.0143 ,       92,       11,       81
GTT, 0.24242, 0.05877,       66,       16,       50
GTV, 0.09677, 0.00937,      124,       12,      112
GTW, 0.05263, 0.00277,       19,        1,       18
GTY, 0.28571, 0.08163,       49,       14,       35
GT_, 0      , 0      ,        2,        0,        2
GVG, 0.21875, 0.04785,       64,       14,       50
GVH, 0.1087 , 0.01181,       46,        5,       41
GVI, 0.03922, 0.00154,      102,        4,       98
GVK, 0.05   , 0.0025 ,      140,        7,      133
GVL, 0.04478, 0.002  ,      134,        6,      128
GVM, 0      , 0      ,       31,        0,       31
GVN, 0.08   , 0.0064 ,       75,        6,       69
GVP, 0.03488, 0.00122,       86,        3,       83
GVQ, 0.04839, 0.00234,       62,        3,       59
GVR, 0.06627, 0.00439,      166,       11,      155
GVS, 0.12   , 0.0144 ,      125,       15,      110
GVT, 0.05505, 0.00303,      109,        6,      103
GVV, 0.0687 , 0.00472,      131,        9,      122
GVW, 0      , 0      ,        8,        0,        8
GVY, 0.075  , 0.00562,       40,        3,       37
GV_, 0.5    , 0.25   ,        2,        1,        1
GWG, 0      , 0      ,       12,        0,       12
GWH, 0      , 0      ,       11,        0,       11
GWI, 0      , 0      ,       30,        0,       30
GWK, 0.08571, 0.00735,       35,        3,       32
GWL, 0.30357, 0.09216,       56,       17,       39
GWM, 0      , 0      ,        1,        0,        1
GWN, 0.18182, 0.03306,       11,        2,        9
GWP, 0      , 0      ,       14,        0,       14
GWQ, 0      , 0      ,        8,        0,        8
GWR, 0.35821, 0.12831,       67,       24,       43
GWS, 0.08333, 0.00694,       12,        1,       11
GWT, 0.33333, 0.11111,       21,        7,       14
GWV, 0.11765, 0.01384,       34,        4,       30
GWW, 0.5    , 0.25   ,        2,        1,        1
GWY, 0      , 0      ,        6,        0,        6
GYG, 0.45455, 0.20661,       22,       10,       12
GYH, 0.41667, 0.17361,       60,       25,       35
GYI, 0.05   , 0.0025 ,       80,        4,       76
GYK, 0.38889, 0.15123,       54,       21,       33
GYL, 0.13462, 0.01812,      104,       14,       90
GYM, 0.30769, 0.09467,       26,        8,       18
GYN, 0.17188, 0.02954,       64,       11,       53
GYP, 0.08108, 0.00657,       37,        3,       34
GYQ, 0      , 0      ,       91,        0,       91
GYR, 0.32308, 0.10438,       65,       21,       44
GYS, 0.09434, 0.0089 ,       53,        5,       48
GYT, 0.12727, 0.0162 ,       55,        7,       48
GYV, 0.1223 , 0.01496,      139,       17,      122
GYW, 0      , 0      ,        7,        0,        7
GYY, 0.62766, 0.39396,       94,       59,       35
GY_, 0.8    , 0.64   ,        5,        4,        1
HAH, 0      , 0      ,       15,        0,       15
HAI, 0.16327, 0.02666,       49,        8,       41
HAK, 0      , 0      ,       45,        0,       45
HAL, 0.01163, 0.00014,       86,        1,       85
HAM, 0.05263, 0.00277,       19,        1,       18
HAN, 0.02941, 0.00087,       34,        1,       33
HAP, 0.0625 , 0.00391,       32,        2,       30
HAQ, 0.02778, 0.00077,       72,        2,       70
HAR, 0.125  , 0.01562,       48,        6,       42
HAS, 0.11111, 0.01235,       36,        4,       32
HAT, 0      , 0      ,       30,        0,       30
HAV, 0.04167, 0.00174,       48,        2,       46
HAW, 0      , 0      ,       12,        0,       12
HAY, 0.2    , 0.04   ,       20,        4,       16
HCH, 0      , 0      ,       17,        0,       17
HCI, 0.25   , 0.0625 ,        8,        2,        6
HCK, 0      , 0      ,       10,        0,       10
HCL, 0      , 0      ,       13,        0,       13
HCM, 0      , 0      ,       11,        0,       11
HCN, 0      , 0      ,        1,        0,        1
HCP, 0.2    , 0.04   ,        5,        1,        4
HCQ, 0      , 0      ,        4,        0,        4
HCR, 0.06667, 0.00444,       15,        1,       14
HCS, 0      , 0      ,        6,        0,        6
HCT, 0      , 0      ,        1,        0,        1
HCV, 0      , 0      ,       11,        0,       11
HCY, 0      , 0      ,        4,        0,        4
HDH, 0.26667, 0.07111,       15,        4,       11
HDI, 0.08   , 0.0064 ,       50,        4,       46
HDK, 0      , 0      ,       17,        0,       17
HDL, 0.04444, 0.00198,       45,        2,       43
HDM, 0      , 0      ,        3,        0,        3
HDN, 0      , 0      ,       24,        0,       24
HDP, 0.04762, 0.00227,       21,        1,       20
HDQ, 0      , 0      ,       12,        0,       12
HDR, 0.08   , 0.0064 ,       25,        2,       23
HDS, 0.05556, 0.00309,       54,        3,       51
HDT, 0.19048, 0.03628,       21,        4,       17
HDV, 0.08824, 0.00779,       34,        3,       31
HDW, 0      , 0      ,       12,        0,       12
HDY, 0.13333, 0.01778,       15,        2,       13
HD_, 0      , 0      ,        4,        0,        4
HEH, 0      , 0      ,        6,        0,        6
HEI, 0      , 0      ,       68,        0,       68
HEK, 0.01176, 0.00014,       85,        1,       84
HEL, 0.01099, 0.00012,       91,        1,       90
HEM, 0      , 0      ,       30,        0,       30
HEN, 0.05882, 0.00346,       34,        2,       32
HEP, 0      , 0      ,       17,        0,       17
HEQ, 0.12121, 0.01469,       33,        4,       29
HER, 0.0411 , 0.00169,       73,        3,       70
HES, 0      , 0      ,       31,        0,       31
HET, 0.08333, 0.00694,       36,        3,       33
HEV, 0      , 0      ,       62,        0,       62
HEW, 0      , 0      ,        8,        0,        8
HEY, 0      , 0      ,       29,        0,       29
HE_, 0      , 0      ,        7,        0,        7
HFH, 0      , 0      ,        3,        0,        3
HFI, 0.1    , 0.01   ,       20,        2,       18
HFK, 0.05263, 0.00277,       19,        1,       18
HFL, 0.04   , 0.0016 ,       50,        2,       48
HFM, 0      , 0      ,        6,        0,        6
HFN, 0      , 0      ,       38,        0,       38
HFP, 0      , 0      ,       48,        0,       48
HFQ, 0.16667, 0.02778,       12,        2,       10
HFR, 0      , 0      ,       14,        0,       14
HFS, 0.11765, 0.01384,       17,        2,       15
HFT, 0.025  , 0.00063,       40,        1,       39
HFV, 0      , 0      ,       26,        0,       26
HFY, 0.23684, 0.05609,       38,        9,       29
HF_, 0      , 0      ,        1,        0,        1
HGH, 0      , 0      ,        9,        0,        9
HGI, 0.04762, 0.00227,       42,        2,       40
HGK, 0.17143, 0.02939,       35,        6,       29
HGL, 0.11215, 0.01258,      107,       12,       95
HGM, 0      , 0      ,        9,        0,        9
HGN, 0.03333, 0.00111,       30,        1,       29
HGP, 0      , 0      ,       19,        0,       19
HGQ, 0.11765, 0.01384,       17,        2,       15
HGR, 0.19737, 0.03895,       76,       15,       61
HGS, 0.16   , 0.0256 ,       50,        8,       42
HGT, 0.11111, 0.01235,       54,        6,       48
HGV, 0      , 0      ,       27,        0,       27
HGW, 0      , 0      ,        4,        0,        4
HGY, 0      , 0      ,       29,        0,       29
HG_, 0      , 0      ,        7,        0,        7
HHH, 0.12121, 0.01469,       66,        8,       58
HHI, 0.13793, 0.01902,       29,        4,       25
HHK, 0      , 0      ,       22,        0,       22
HHL, 0.14634, 0.02142,       41,        6,       35
HHM, 0.33333, 0.11111,        6,        2,        4
HHN, 0.07143, 0.0051 ,       14,        1,       13
HHP, 0.05556, 0.00309,       18,        1,       17
HHQ, 0      , 0      ,       28,        0,       28
HHR, 0.125  , 0.01562,       24,        3,       21
HHS, 0.11538, 0.01331,       26,        3,       23
HHT, 0      , 0      ,       30,        0,       30
HHV, 0.42105, 0.17729,       19,        8,       11
HHW, 0.41667, 0.17361,       12,        5,        7
HHY, 0.26316, 0.06925,       19,        5,       14
HH_, 0.04545, 0.00207,       22,        1,       21
HIH, 0.1    , 0.01   ,       20,        2,       18
HII, 0      , 0      ,       19,        0,       19
HIK, 0.05769, 0.00333,       52,        3,       49
HIL, 0      , 0      ,       55,        0,       55
HIM, 0      , 0      ,       10,        0,       10
HIN, 0.01852, 0.00034,       54,        1,       53
HIP, 0      , 0      ,       11,        0,       11
HIQ, 0      , 0      ,       20,        0,       20
HIR, 0.18182, 0.03306,       22,        4,       18
HIS, 0      , 0      ,       29,        0,       29
HIT, 0      , 0      ,       25,        0,       25
HIV, 0.03077, 0.00095,       65,        2,       63
HIW, 0      , 0      ,        7,        0,        7
HIY, 0      , 0      ,       16,        0,       16
HKH, 0.36364, 0.13223,       11,        4,        7
HKI, 0.02703, 0.00073,       37,        1,       36
HKK, 0.23611, 0.05575,       72,       17,       55
HKL, 0.09677, 0.00937,       93,        9,       84
HKM, 0.22727, 0.05165,       22,        5,       17
HKN, 0.23529, 0.05536,       34,        8,       26
HKP, 0.04167, 0.00174,       24,        1,       23
HKQ, 0.34483, 0.11891,       29,       10,       19
HKR, 0.1875 , 0.03516,       48,        9,       39
HKS, 0.40909, 0.16736,       22,        9,       13
HKT, 0.19231, 0.03698,       52,       10,       42
HKV, 0.01887, 0.00036,       53,        1,       52
HKW, 0.125  , 0.01562,        8,        1,        7
HKY, 0.07317, 0.00535,       41,        3,       38
HK_, 0      , 0      ,        5,        0,        5
HLH, 0      , 0      ,       14,        0,       14
HLI, 0      , 0      ,       69,        0,       69
HLK, 0.15686, 0.02461,       51,        8,       43
HLL, 0      , 0      ,      106,        0,      106
HLM, 0      , 0      ,       10,        0,       10
HLN, 0.16   , 0.0256 ,       25,        4,       21
HLP, 0      , 0      ,       48,        0,       48
HLQ, 0.09615, 0.00925,       52,        5,       47
HLR, 0.0137 , 0.00019,       73,        1,       72
HLS, 0.15476, 0.02395,       84,       13,       71
HLT, 0.15476, 0.02395,       84,       13,       71
HLV, 0      , 0      ,       50,        0,       50
HLW, 0      , 0      ,        5,        0,        5
HLY, 0.08333, 0.00694,       36,        3,       33
HL_, 0      , 0      ,        7,        0,        7
HMH, 0      , 0      ,        1,        0,        1
HMI, 0.57143, 0.32653,        7,        4,        3
HMK, 0      , 0      ,       24,        0,       24
HML, 0.27273, 0.07438,       11,        3,        8
HMM, 0      , 0      ,        1,        0,        1
HMN, 0.03333, 0.00111,       30,        1,       29
HMP, 0      , 0      ,        7,        0,        7
HMQ, 0.1    , 0.01   ,       10,        1,        9
HMR, 0      , 0      ,        9,        0,        9
HMS, 0.33333, 0.11111,       15,        5,       10
HMT, 0      , 0      ,        8,        0,        8
HMV, 0      , 0      ,       11,        0,       11
HMW, 0      , 0      ,       19,        0,       19
HMY, 0      , 0      ,        2,        0,        2
HNH, 0      , 0      ,        5,        0,        5
HNI, 0.02273, 0.00052,       44,        1,       43
HNK, 0.01754, 0.00031,       57,        1,       56
HNL, 0.01587, 0.00025,       63,        1,       62
HNM, 0.17391, 0.03025,       23,        4,       19
HNN, 0.03846, 0.00148,       52,        2,       50
HNP, 0.09091, 0.00826,       22,        2,       20
HNQ, 0.08333, 0.00694,       12,        1,       11
HNR, 0.04167, 0.00174,       24,        1,       23
HNS, 0.08108, 0.00657,       37,        3,       34
HNT, 0      , 0      ,        6,        0,        6
HNV, 0.10256, 0.01052,       39,        4,       35
HNW, 0      , 0      ,        3,        0,        3
HNY, 0      , 0      ,       27,        0,       27
HN_, 0      , 0      ,        3,        0,        3
HPH, 0      , 0      ,       14,        0,       14
HPI, 0      , 0      ,       41,        0,       41
HPK, 0      , 0      ,       22,        0,       22
HPL, 0.02564, 0.00066,       39,        1,       38
HPM, 0.16667, 0.02778,       12,        2,       10
HPN, 0      , 0      ,       23,        0,       23
HPP, 0      , 0      ,       15,        0,       15
HPQ, 0.09091, 0.00826,       33,        3,       30
HPR, 0.07692, 0.00592,       26,        2,       24
HPS, 0.11111, 0.01235,       36,        4,       32
HPT, 0      , 0      ,       20,        0,       20
HPV, 0.06667, 0.00444,       30,        2,       28
HPW, 0      , 0      ,        6,        0,        6
HPY, 0.02778, 0.00077,       36,        1,       35
HP_, 0      , 0      ,       10,        0,       10
HQH, 0.375  , 0.14062,       16,        6,       10
HQI, 0.3913 , 0.15312,       23,        9,       14
HQK, 0.03333, 0.00111,       30,        1,       29
HQL, 0.01667, 0.00028,       60,        1,       59
HQM, 0      , 0      ,        9,        0,        9
HQN, 0.09091, 0.00826,       22,        2,       20
HQP, 0.08696, 0.00756,       23,        2,       21
HQQ, 0      , 0      ,       36,        0,       36
HQR, 0.04255, 0.00181,       47,        2,       45
HQS, 0.25926, 0.06722,       27,        7,       20
HQT, 0.21739, 0.04726,       23,        5,       18
HQV, 0.02564, 0.00066,       39,        1,       38
HQW, 0      , 0      ,        4,        0,        4
HQY, 0.3    , 0.09   ,       10,        3,        7
HQ_, 0      , 0      ,        3,        0,        3
HRH, 0.33333, 0.11111,       15,        5,       10
HRI, 0.29091, 0.08463,       55,       16,       39
HRK, 0.39216, 0.15379,       51,       20,       31
HRL, 0.33036, 0.10914,      112,       37,       75
HRM, 0.22222, 0.04938,       18,        4,       14
HRN, 0.14634, 0.02142,       41,        6,       35
HRP, 0.1875 , 0.03516,       32,        6,       26
HRQ, 0.15556, 0.0242 ,       45,        7,       38
HRR, 0.30303, 0.09183,       66,       20,       46
HRS, 0.4    , 0.16   ,       40,       16,       24
HRT, 0.16667, 0.02778,       42,        7,       35
HRV, 0.28125, 0.0791 ,       64,       18,       46
HRW, 0.22222, 0.04938,        9,        2,        7
HRY, 0.4    , 0.16   ,       40,       16,       24
HR_, 0      , 0      ,        1,        0,        1
HSH, 0      , 0      ,        9,        0,        9
HSI, 0.08333, 0.00694,       60,        5,       55
HSK, 0.33846, 0.11456,       65,       22,       43
HSL, 0.16216, 0.0263 ,       74,       12,       62
HSM, 0      , 0      ,       19,        0,       19
HSN, 0      , 0      ,       43,        0,       43
HSP, 0.02703, 0.00073,       37,        1,       36
HSQ, 0.26316, 0.06925,       38,       10,       28
HSR, 0.37143, 0.13796,       35,       13,       22
HSS, 0.10811, 0.01169,       37,        4,       33
HST, 0.04545, 0.00207,       22,        1,       21
HSV, 0.16667, 0.02778,       54,        9,       45
HSW, 0      , 0      ,        5,        0,        5
HSY, 0      , 0      ,        7,        0,        7
HS_, 0      , 0      ,        7,        0,        7
HTH, 0      , 0      ,        4,        0,        4
HTI, 0.12903, 0.01665,       31,        4,       27
HTK, 0.1875 , 0.03516,       32,        6,       26
HTL, 0.08696, 0.00756,       92,        8,       84
HTM, 0      , 0      ,        1,        0,        1
HTN, 0      , 0      ,       29,        0,       29
HTP, 0.48387, 0.23413,       31,       15,       16
HTQ, 0.26316, 0.06925,       19,        5,       14
HTR, 0.33846, 0.11456,       65,       22,       43
HTS, 0.20513, 0.04208,       39,        8,       31
HTT, 0      , 0      ,       27,        0,       27
HTV, 0.04   , 0.0016 ,       25,        1,       24
HTW, 0.2    , 0.04   ,        5,        1,        4
HTY, 0.42857, 0.18367,        7,        3,        4
HT_, 0      , 0      ,        6,        0,        6
HVH, 0      , 0      ,       12,        0,       12
HVI, 0      , 0      ,       41,        0,       41
HVK, 0.18367, 0.03374,       49,        9,       40
HVL, 0.05882, 0.00346,       34,        2,       32
HVM, 0      , 0      ,        4,        0,        4
HVN, 0      , 0      ,       18,        0,       18
HVP, 0      , 0      ,       43,        0,       43
HVQ, 0.26087, 0.06805,       23,        6,       17
HVR, 0.05   , 0.0025 ,       40,        2,       38
HVS, 0.11429, 0.01306,       35,        4,       31
HVT, 0.17143, 0.02939,       35,        6,       29
HVV, 0.09091, 0.00826,       22,        2,       20
HVW, 0.2    , 0.04   ,       10,        2,        8
HVY, 0      , 0      ,       31,        0,       31
HV_, 0      , 0      ,        5,        0,        5
HWH, 0      , 0      ,        3,        0,        3
HWI, 0      , 0      ,       11,        0,       11
HWK, 0.57143, 0.32653,        7,        4,        3
HWL, 0      , 0      ,       13,        0,       13
HWM, 0      , 0      ,        6,        0,        6
HWN, 0.4    , 0.16   ,        5,        2,        3
HWP, 0      , 0      ,        9,        0,        9
HWQ, 0      , 0      ,        1,        0,        1
HWR, 0      , 0      ,        8,        0,        8
HWS, 0.46667, 0.21778,       15,        7,        8
HWT, 0      , 0      ,       11,        0,       11
HWV, 0      , 0      ,       11,        0,       11
HWY, 0.5    , 0.25   ,        4,        2,        2
HW_, 0      , 0      ,        2,        0,        2
HYH, 0      , 0      ,        4,        0,        4
HYI, 0.18182, 0.03306,       33,        6,       27
HYK, 0      , 0      ,       24,        0,       24
HYL, 0.14286, 0.02041,       56,        8,       48
HYM, 0.53333, 0.28444,       15,        8,        7
HYN, 0.17647, 0.03114,       17,        3,       14
HYP, 0.28947, 0.0838 ,       38,       11,       27
HYQ, 0.1    , 0.01   ,       10,        1,        9
HYR, 0.27027, 0.07305,       37,       10,       27
HYS, 0.32432, 0.10519,       37,       12,       25
HYT, 0.07407, 0.00549,       27,        2,       25
HYV, 0      , 0      ,       23,        0,       23
HYW, 0      , 0      ,        3,        0,        3
HYY, 0.3    , 0.09   ,       20,        6,       14
IAI, 0      , 0      ,       11,        0,       11
IAK, 0.08556, 0.00732,      187,       16,      171
IAL, 0.03488, 0.00122,       86,        3,       83
IAM, 0      , 0      ,       14,        0,       14
IAN, 0.09589, 0.00919,       73,        7,       66
IAP, 0.06818, 0.00465,       88,        6,       82
IAQ, 0.09091, 0.00826,      121,       11,      110
IAR, 0.36747, 0.13503,      166,       61,      105
IAS, 0.03371, 0.00114,       89,        3,       86
IAT, 0.04762, 0.00227,      105,        5,      100
IAV, 0.0678 , 0.0046 ,      118,        8,      110
IAW, 0.07407, 0.00549,       27,        2,       25
IAY, 0      , 0      ,       45,        0,       45
ICI, 0      , 0      ,        4,        0,        4
ICK, 0.04762, 0.00227,       21,        1,       20
ICL, 0.09524, 0.00907,       21,        2,       19
ICM, 0      , 0      ,        2,        0,        2
ICN, 0      , 0      ,        6,        0,        6
ICP, 0      , 0      ,       15,        0,       15
ICQ, 0      , 0      ,        6,        0,        6
ICR, 0.26667, 0.07111,       15,        4,       11
ICS, 0      , 0      ,        4,        0,        4
ICT, 0      , 0      ,        8,        0,        8
ICV, 0      , 0      ,        3,        0,        3
ICW, 0      , 0      ,        3,        0,        3
ICY, 0      , 0      ,        7,        0,        7
IDI, 0.04878, 0.00238,       41,        2,       39
IDK, 0.00578, 0.00003,      173,        1,      172
IDL, 0.10294, 0.0106 ,      204,       21,      183
IDM, 0      , 0      ,       36,        0,       36
IDN, 0.01111, 0.00012,       90,        1,       89
IDP, 0.0625 , 0.00391,       80,        5,       75
IDQ, 0.02632, 0.00069,       76,        2,       74
IDR, 0.0625 , 0.00391,      128,        8,      120
IDS, 0.07634, 0.00583,      131,       10,      121
IDT, 0.05932, 0.00352,      118,        7,      111
IDV, 0.07627, 0.00582,      118,        9,      109
IDW, 0.02174, 0.00047,       46,        1,       45
IDY, 0.05607, 0.00314,      107,        6,      101
ID_, 0      , 0      ,       11,        0,       11
IEI, 0.06897, 0.00476,       58,        4,       54
IEK, 0.00806, 0.00007,      248,        2,      246
IEL, 0.00467, 0.00002,      214,        1,      213
IEM, 0.01786, 0.00032,       56,        1,       55
IEN, 0.01156, 0.00013,      173,        2,      171
IEP, 0.00901, 0.00008,      111,        1,      110
IEQ, 0.0411 , 0.00169,      146,        6,      140
IER, 0.04651, 0.00216,      172,        8,      164
IES, 0.01622, 0.00026,      185,        3,      182
IET, 0.04412, 0.00195,      136,        6,      130
IEV, 0      , 0      ,      136,        0,      136
IEW, 0.0625 , 0.00391,       32,        2,       30
IEY, 0.025  , 0.00063,       80,        2,       78
IE_, 0.07143, 0.0051 ,       14,        1,       13
IFI, 0      , 0      ,       12,        0,       12
IFK, 0.08974, 0.00805,       78,        7,       71
IFL, 0.11429, 0.01306,       35,        4,       31
IFM, 0      , 0      ,       15,        0,       15
IFN, 0      , 0      ,       56,        0,       56
IFP, 0.18605, 0.03461,       43,        8,       35
IFQ, 0      , 0      ,       73,        0,       73
IFR, 0.14286, 0.02041,       84,       12,       72
IFS, 0.13253, 0.01756,       83,       11,       72
IFT, 0.02128, 0.00045,       47,        1,       46
IFV, 0.06061, 0.00367,       33,        2,       31
IFW, 0      , 0      ,        7,        0,        7
IFY, 0      , 0      ,       40,        0,       40
IGI, 0.13158, 0.01731,       38,        5,       33
IGK, 0.08075, 0.00652,      161,       13,      148
IGL, 0.13836, 0.01914,      159,       22,      137
IGM, 0.0303 , 0.00092,       33,        1,       32
IGN, 0.12941, 0.01675,       85,       11,       74
IGP, 0.10769, 0.0116 ,       65,        7,       58
IGQ, 0.10227, 0.01046,       88,        9,       79
IGR, 0.16038, 0.02572,      106,       17,       89
IGS, 0.04545, 0.00207,      110,        5,      105
IGT, 0.23529, 0.05536,       85,       20,       65
IGV, 0.03371, 0.00114,       89,        3,       86
IGW, 0      , 0      ,       19,        0,       19
IGY, 0.09649, 0.00931,      114,       11,      103
IG_, 0.33333, 0.11111,        9,        3,        6
IHI, 0.26667, 0.07111,       15,        4,       11
IHK, 0.2381 , 0.05669,       42,       10,       32
IHL, 0.10476, 0.01098,      105,       11,       94
IHM, 0.14286, 0.02041,        7,        1,        6
IHN, 0.1875 , 0.03516,       32,        6,       26
IHP, 0      , 0      ,       50,        0,       50
IHQ, 0.02128, 0.00045,       47,        1,       46
IHR, 0.09091, 0.00826,       44,        4,       40
IHS, 0.2    , 0.04   ,       75,       15,       60
IHT, 0.02439, 0.00059,       41,        1,       40
IHV, 0.10204, 0.01041,       49,        5,       44
IHW, 0      , 0      ,        2,        0,        2
IHY, 0      , 0      ,       13,        0,       13
IH_, 0.16667, 0.02778,        6,        1,        5
III, 0      , 0      ,       22,        0,       22
IIK, 0.03788, 0.00143,      132,        5,      127
IIL, 0.03361, 0.00113,      119,        4,      115
IIM, 0      , 0      ,       31,        0,       31
IIN, 0      , 0      ,      150,        0,      150
IIP, 0      , 0      ,       59,        0,       59
IIQ, 0.02632, 0.00069,       38,        1,       37
IIR, 0.03529, 0.00125,       85,        3,       82
IIS, 0.00943, 0.00009,      106,        1,      105
IIT, 0.00893, 0.00008,      112,        1,      111
IIV, 0      , 0      ,       53,        0,       53
IIW, 0.05882, 0.00346,       17,        1,       16
IIY, 0.10526, 0.01108,       19,        2,       17
II_, 0      , 0      ,        3,        0,        3
IKI, 0.21311, 0.04542,       61,       13,       48
IKK, 0.07426, 0.00551,      202,       15,      187
IKL, 0.14226, 0.02024,      239,       34,      205
IKM, 0.19403, 0.03765,       67,       13,       54
IKN, 0.08974, 0.00805,      156,       14,      142
IKP, 0.28571, 0.08163,       98,       28,       70
IKQ, 0.09402, 0.00884,      117,       11,      106
IKR, 0.08   , 0.0064 ,      150,       12,      138
IKS, 0.17033, 0.02901,      182,       31,      151
IKT, 0.15625, 0.02441,      128,       20,      108
IKV, 0.168  , 0.02822,      125,       21,      104
IKW, 0      , 0      ,       21,        0,       21
IKY, 0.10169, 0.01034,       59,        6,       53
IK_, 0      , 0      ,        7,        0,        7
ILI, 0.03774, 0.00142,       53,        2,       51
ILK, 0.02304, 0.00053,      217,        5,      212
ILL, 0      , 0      ,      155,        0,      155
ILM, 0      , 0      ,       30,        0,       30
ILN, 0.09677, 0.00937,      124,       12,      112
ILP, 0.08929, 0.00797,      112,       10,      102
ILQ, 0.06803, 0.00463,      147,       10,      137
ILR, 0.06164, 0.0038 ,      146,        9,      137
ILS, 0.00402, 0.00002,      249,        1,      248
ILT, 0      , 0      ,       94,        0,       94
ILV, 0      , 0      ,       82,        0,       82
ILW, 0.0625 , 0.00391,       16,        1,       15
ILY, 0      , 0      ,       48,        0,       48
IL_, 0      , 0      ,        7,        0,        7
IMI, 0      , 0      ,        6,        0,        6
IMK, 0.11765, 0.01384,       34,        4,       30
IML, 0.02857, 0.00082,       35,        1,       34
IMM, 0.09091, 0.00826,       11,        1,       10
IMN, 0      , 0      ,       80,        0,       80
IMP, 0.11111, 0.01235,       18,        2,       16
IMQ, 0.02857, 0.00082,       35,        1,       34
IMR, 0      , 0      ,       65,        0,       65
IMS, 0.03704, 0.00137,       27,        1,       26
IMT, 0.15385, 0.02367,       13,        2,       11
IMV, 0      , 0      ,       20,        0,       20
IMY, 0      , 0      ,       20,        0,       20
IM_, 0      , 0      ,        9,        0,        9
INI, 0.18182, 0.03306,       33,        6,       27
INK, 0.05814, 0.00338,      172,       10,      162
INL, 0.07563, 0.00572,      119,        9,      110
INM, 0.27273, 0.07438,       22,        6,       16
INN, 0.05882, 0.00346,      102,        6,       96
INP, 0.18966, 0.03597,       58,       11,       47
INQ, 0.23457, 0.05502,       81,       19,       62
INR, 0.10112, 0.01023,       89,        9,       80
INS, 0.0625 , 0.00391,       80,        5,       75
INT, 0.05333, 0.00284,       75,        4,       71
INV, 0.07692, 0.00592,      130,       10,      120
INW, 0.11111, 0.01235,       36,        4,       32
INY, 0.04348, 0.00189,       23,        1,       22
IN_, 0      , 0      ,        4,        0,        4
IPI, 0.21875, 0.04785,       32,        7,       25
IPK, 0.02151, 0.00046,       93,        2,       91
IPL, 0.08547, 0.00731,      117,       10,      107
IPM, 0.16667, 0.02778,       12,        2,       10
IPN, 0.02632, 0.00069,       38,        1,       37
IPP, 0.17241, 0.02973,       29,        5,       24
IPQ, 0.14583, 0.02127,       48,        7,       41
IPR, 0.03125, 0.00098,       64,        2,       62
IPS, 0.0315 , 0.00099,      127,        4,      123
IPT, 0.03509, 0.00123,       57,        2,       55
IPV, 0      , 0      ,       57,        0,       57
IPW, 0      , 0      ,        5,        0,        5
IPY, 0.28205, 0.07955,       39,       11,       28
IP_, 0      , 0      ,       14,        0,       14
IQI, 0.09259, 0.00857,       54,        5,       49
IQK, 0.18182, 0.03306,      121,       22,       99
IQL, 0.11538, 0.01331,      130,       15,      115
IQM, 0      , 0      ,       12,        0,       12
IQN, 0.12903, 0.01665,       93,       12,       81
IQP, 0.0303 , 0.00092,       33,        1,       32
IQQ, 0.01786, 0.00032,       56,        1,       55
IQR, 0.15929, 0.02537,      113,       18,       95
IQS, 0.26549, 0.07048,      113,       30,       83
IQT, 0.20968, 0.04396,       62,       13,       49
IQV, 0.13333, 0.01778,       60,        8,       52
IQW, 0.2    , 0.04   ,       10,        2,        8
IQY, 0.04651, 0.00216,       43,        2,       41
IQ_, 0      , 0      ,        8,        0,        8
IRI, 0.32075, 0.10288,       53,       17,       36
IRK, 0.25714, 0.06612,      140,       36,      104
IRL, 0.18605, 0.03461,      129,       24,      105
IRM, 0.25455, 0.06479,       55,       14,       41
IRN, 0.52941, 0.28028,      153,       81,       72
IRP, 0.14493, 0.021  ,       69,       10,       59
IRQ, 0.30172, 0.09104,      116,       35,       81
IRR, 0.2067 , 0.04273,      179,       37,      142
IRS, 0.20219, 0.04088,      183,       37,      146
IRT, 0.15   , 0.0225 ,      120,       18,      102
IRV, 0.104  , 0.01082,      125,       13,      112
IRW, 0.41176, 0.16955,       17,        7,       10
IRY, 0.29487, 0.08695,       78,       23,       55
IR_, 0      , 0      ,        4,        0,        4
ISI, 0.13725, 0.01884,       51,        7,       44
ISK, 0.21488, 0.04617,      121,       26,       95
ISL, 0.13068, 0.01708,      176,       23,      153
ISM, 0.07143, 0.0051 ,       28,        2,       26
ISN, 0.17857, 0.03189,       84,       15,       69
ISP, 0.1358 , 0.01844,       81,       11,       70
ISQ, 0.09375, 0.00879,       96,        9,       87
ISR, 0.15842, 0.0251 ,      101,       16,       85
ISS, 0.11111, 0.01235,      171,       19,      152
IST, 0.10448, 0.01092,      134,       14,      120
ISV, 0.14607, 0.02134,       89,       13,       76
ISW, 0.23529, 0.05536,       17,        4,       13
ISY, 0.04762, 0.00227,       42,        2,       40
IS_, 0      , 0      ,        7,        0,        7
ITI, 0.12903, 0.01665,       31,        4,       27
ITK, 0.20833, 0.0434 ,       96,       20,       76
ITL, 0.11823, 0.01398,      203,       24,      179
ITM, 0.125  , 0.01562,       24,        3,       21
ITN, 0.19231, 0.03698,       52,       10,       42
ITP, 0.09459, 0.00895,       74,        7,       67
ITQ, 0.51351, 0.2637 ,       74,       38,       36
ITR, 0.30702, 0.09426,      114,       35,       79
ITS, 0.05325, 0.00284,      169,        9,      160
ITT, 0.32323, 0.10448,       99,       32,       67
ITV, 0.18519, 0.03429,      108,       20,       88
ITW, 0.22222, 0.04938,        9,        2,        7
ITY, 0.20455, 0.04184,       44,        9,       35
IT_, 0      , 0      ,        7,        0,        7
IVI, 0.17857, 0.03189,       28,        5,       23
IVK, 0.02439, 0.00059,      123,        3,      120
IVL, 0.02041, 0.00042,       98,        2,       96
IVM, 0      , 0      ,       11,        0,       11
IVN, 0.04839, 0.00234,       62,        3,       59
IVP, 0.01538, 0.00024,       65,        1,       64
IVQ, 0.06667, 0.00444,       60,        4,       56
IVR, 0.04878, 0.00238,       82,        4,       78
IVS, 0      , 0      ,       99,        0,       99
IVT, 0      , 0      ,       57,        0,       57
IVV, 0.03279, 0.00107,       61,        2,       59
IVW, 0      , 0      ,       16,        0,       16
IVY, 0.08   , 0.0064 ,       25,        2,       23
IV_, 0      , 0      ,        2,        0,        2
IWI, 0      , 0      ,        5,        0,        5
IWK, 0.14815, 0.02195,       27,        4,       23
IWL, 0      , 0      ,       14,        0,       14
IWM, 0      , 0      ,       16,        0,       16
IWN, 0.10526, 0.01108,       19,        2,       17
IWP, 0.14286, 0.02041,       21,        3,       18
IWQ, 0      , 0      ,        6,        0,        6
IWR, 0.28125, 0.0791 ,       32,        9,       23
IWS, 0.0625 , 0.00391,       16,        1,       15
IWT, 0.11765, 0.01384,       17,        2,       15
IWV, 0.125  , 0.01562,       16,        2,       14
IWW, 0.5    , 0.25   ,        4,        2,        2
IWY, 0      , 0      ,       12,        0,       12
IYI, 0      , 0      ,       12,        0,       12
IYK, 0.152  , 0.0231 ,      125,       19,      106
IYL, 0.20548, 0.04222,       73,       15,       58
IYM, 0.1    , 0.01   ,       20,        2,       18
IYN, 0.11429, 0.01306,       35,        4,       31
IYP, 0.32075, 0.10288,       53,       17,       36
IYQ, 0.02273, 0.00052,       88,        2,       86
IYR, 0.13043, 0.01701,       92,       12,       80
IYS, 0.20968, 0.04396,       62,       13,       49
IYT, 0.22034, 0.04855,       59,       13,       46
IYV, 0.30159, 0.09095,       63,       19,       44
IYW, 0      , 0      ,       19,        0,       19
IYY, 0.57009, 0.32501,      107,       61,       46
IY_, 0      , 0      ,        5,        0,        5
KAK, 0.10938, 0.01196,       64,        7,       57
KAL, 0.03459, 0.0012 ,      318,       11,      307
KAM, 0      , 0      ,       24,        0,       24
KAN, 0.25556, 0.06531,       90,       23,       67
KAP, 0.07353, 0.00541,       68,        5,       63
KAQ, 0.09167, 0.0084 ,      120,       11,      109
KAR, 0.16867, 0.02845,       83,       14,       69
KAS, 0.09804, 0.00961,      102,       10,       92
KAT, 0.15179, 0.02304,      112,       17,       95
KAV, 0.12613, 0.01591,      111,       14,       97
KAW, 0      , 0      ,       25,        0,       25
KAY, 0      , 0      ,      125,        0,      125
KA_, 0.23256, 0.05408,       43,       10,       33
KCK, 0      , 0      ,       14,        0,       14
KCL, 0      , 0      ,       17,        0,       17
KCM, 0      , 0      ,        3,        0,        3
KCN, 0.03704, 0.00137,       27,        1,       26
KCP, 0.5    , 0.25   ,       30,       15,       15
KCQ, 0      , 0      ,       15,        0,       15
KCR, 0.19048, 0.03628,       21,        4,       17
KCS, 0.03571, 0.00128,       28,        1,       27
KCT, 0      , 0      ,       17,        0,       17
KCV, 0      , 0      ,       32,        0,       32
KCW, 0.5    , 0.25   ,        6,        3,        3
KCY, 0      , 0      ,        6,        0,        6
KC_, 0      , 0      ,        1,        0,        1
KDK, 0.06349, 0.00403,       63,        4,       59
KDL, 0.03887, 0.00151,      283,       11,      272
KDM, 0.23077, 0.05325,       13,        3,       10
KDN, 0.02469, 0.00061,       81,        2,       79
KDP, 0.03846, 0.00148,      104,        4,      100
KDQ, 0      , 0      ,       49,        0,       49
KDR, 0.11905, 0.01417,       84,       10,       74
KDS, 0.2    , 0.04   ,      100,       20,       80
KDT, 0.04301, 0.00185,       93,        4,       89
KDV, 0.03333, 0.00111,      120,        4,      116
KDW, 0.02273, 0.00052,       44,        1,       43
KDY, 0.15686, 0.02461,      102,       16,       86
KD_, 0      , 0      ,        5,        0,        5
KEK, 0.04908, 0.00241,      163,        8,      155
KEL, 0.0334 , 0.00112,      479,       16,      463
KEM, 0.05882, 0.00346,       51,        3,       48
KEN, 0.0431 , 0.00186,      116,        5,      111
KEP, 0      , 0      ,      100,        0,      100
KEQ, 0.05085, 0.00259,      118,        6,      112
KER, 0.02094, 0.00044,      191,        4,      187
KES, 0.0885 , 0.00783,      113,       10,      103
KET, 0.04545, 0.00207,      132,        6,      126
KEV, 0      , 0      ,      204,        0,      204
KEW, 0      , 0      ,       47,        0,       47
KEY, 0.03731, 0.00139,      134,        5,      129
KE_, 0      , 0      ,       16,        0,       16
KFK, 0.03448, 0.00119,       29,        1,       28
KFL, 0.02913, 0.00085,      103,        3,      100
KFM, 0.41379, 0.17122,       29,       12,       17
KFN, 0.01724, 0.0003 ,      116,        2,      114
KFP, 0.03125, 0.00098,       64,        2,       62
KFQ, 0.32   , 0.1024 ,       25,        8,       17
KFR, 0.10526, 0.01108,       76,        8,       68
KFS, 0.16667, 0.02778,       60,       10,       50
KFT, 0.46377, 0.21508,      138,       64,       74
KFV, 0.14474, 0.02095,       76,       11,       65
KFW, 0      , 0      ,       14,        0,       14
KFY, 0.06667, 0.00444,       45,        3,       42
KF_, 0      , 0      ,        5,        0,        5
KGK, 0.2    , 0.04   ,       60,       12,       48
KGL, 0.09914, 0.00983,      232,       23,      209
KGM, 0.12069, 0.01457,       58,        7,       51
KGN, 0.06863, 0.00471,      102,        7,       95
KGP, 0.21687, 0.04703,       83,       18,       65
KGQ, 0.09677, 0.00937,      124,       12,      112
KGR, 0.24194, 0.05853,      124,       30,       94
KGS, 0.14835, 0.02201,      182,       27,      155
KGT, 0.07627, 0.00582,      118,        9,      109
KGV, 0.11585, 0.01342,      164,       19,      145
KGW, 0.06897, 0.00476,       29,        2,       27
KGY, 0.06338, 0.00402,      142,        9,      133
KG_, 0.33333, 0.11111,       15,        5,       10
KHK, 0.33333, 0.11111,       18,        6,       12
KHL, 0.08654, 0.00749,      104,        9,       95
KHM, 0      , 0      ,       20,        0,       20
KHN, 0.15625, 0.02441,       32,        5,       27
KHP, 0.08333, 0.00694,       48,        4,       44
KHQ, 0.125  , 0.01562,        8,        1,        7
KHR, 0.2439 , 0.05949,       41,       10,       31
KHS, 0.32609, 0.10633,       46,       15,       31
KHT, 0.08824, 0.00779,       34,        3,       31
KHV, 0.04167, 0.00174,       48,        2,       46
KHW, 0.22222, 0.04938,        9,        2,        7
KHY, 0.21212, 0.045  ,       33,        7,       26
KH_, 0.28571, 0.08163,        7,        2,        5
KIK, 0.04286, 0.00184,       70,        3,       67
KIL, 0.06489, 0.00421,      262,       17,      245
KIM, 0.13953, 0.01947,       43,        6,       37
KIN, 0.04255, 0.00181,       94,        4,       90
KIP, 0.06818, 0.00465,       44,        3,       41
KIQ, 0.03571, 0.00128,       56,        2,       54
KIR, 0.08054, 0.00649,      149,       12,      137
KIS, 0.17925, 0.03213,      106,       19,       87
KIT, 0.06306, 0.00398,      111,        7,      104
KIV, 0.025  , 0.00063,       80,        2,       78
KIW, 0.39286, 0.15434,       28,       11,       17
KIY, 0.02564, 0.00066,       78,        2,       76
KI_, 0      , 0      ,        4,        0,        4
KKK, 0.11628, 0.01352,       86,       10,       76
KKL, 0.11307, 0.01278,      398,       45,      353
KKM, 0.13265, 0.0176 ,       98,       13,       85
KKN, 0.21348, 0.04558,       89,       19,       70
KKP, 0.21795, 0.0475 ,       78,       17,       61
KKQ, 0.20175, 0.0407 ,      114,       23,       91
KKR, 0.27326, 0.07467,      172,       47,      125
KKS, 0.19858, 0.03943,      141,       28,      113
KKT, 0.1125 , 0.01266,       80,        9,       71
KKV, 0.107  , 0.01145,      243,       26,      217
KKW, 0.08696, 0.00756,       46,        4,       42
KKY, 0.09353, 0.00875,      139,       13,      126
KK_, 0.17143, 0.02939,       35,        6,       29
KLK, 0.07246, 0.00525,      138,       10,      128
KLL, 0.01198, 0.00014,      334,        4,      330
KLM, 0.01449, 0.00021,       69,        1,       68
KLN, 0.03937, 0.00155,      127,        5,      122
KLP, 0.07843, 0.00615,      102,        8,       94
KLQ, 0      , 0      ,      117,        0,      117
KLR, 0.04795, 0.0023 ,      146,        7,      139
KLS, 0.09551, 0.00912,      178,       17,      161
KLT, 0.02618, 0.00069,      191,        5,      186
KLV, 0.0226 , 0.00051,      177,        4,      173
KLW, 0.08889, 0.0079 ,       45,        4,       41
KLY, 0.10256, 0.01052,       78,        8,       70
KL_, 0      , 0      ,       23,        0,       23
KMK, 0      , 0      ,       25,        0,       25
KML, 0.08642, 0.00747,       81,        7,       74
KMM, 0.02381, 0.00057,       42,        1,       41
KMN, 0.13793, 0.01902,       29,        4,       25
KMP, 0.08   , 0.0064 ,       25,        2,       23
KMQ, 0      , 0      ,       30,        0,       30
KMR, 0.19048, 0.03628,       63,       12,       51
KMS, 0.07895, 0.00623,       38,        3,       35
KMT, 0.02128, 0.00045,       47,        1,       46
KMV, 0      , 0      ,       26,        0,       26
KMW, 0      , 0      ,        4,        0,        4
KMY, 0.04167, 0.00174,       24,        1,       23
KM_, 0.16364, 0.02678,       55,        9,       46
KNK, 0.11111, 0.01235,       72,        8,       64
KNL, 0.08427, 0.0071 ,      178,       15,      163
KNM, 0.2    , 0.04   ,       35,        7,       28
KNN, 0.20455, 0.04184,       88,       18,       70
KNP, 0.28571, 0.08163,       63,       18,       45
KNQ, 0.14493, 0.021  ,       69,       10,       59
KNR, 0.27711, 0.07679,       83,       23,       60
KNS, 0.19626, 0.03852,      107,       21,       86
KNT, 0.2    , 0.04   ,       55,       11,       44
KNV, 0.08333, 0.00694,      132,       11,      121
KNW, 0.1    , 0.01   ,       20,        2,       18
KNY, 0.12162, 0.01479,       74,        9,       65
KN_, 0      , 0      ,        9,        0,        9
KPK, 0.18605, 0.03461,       43,        8,       35
KPL, 0.07643, 0.00584,      157,       12,      145
KPM, 0      , 0      ,       21,        0,       21
KPN, 0.08   , 0.0064 ,       75,        6,       69
KPP, 0.05882, 0.00346,       34,        2,       32
KPQ, 0.26923, 0.07249,       52,       14,       38
KPR, 0.10606, 0.01125,       66,        7,       59
KPS, 0.18667, 0.03484,       75,       14,       61
KPT, 0.33333, 0.11111,      111,       37,       74
KPV, 0.02469, 0.00061,      162,        4,      158
KPW, 0.3    , 0.09   ,       30,        9,       21
KPY, 0.06122, 0.00375,       98,        6,       92
KP_, 0      , 0      ,       18,        0,       18
KQK, 0.11905, 0.01417,       84,       10,       74
KQL, 0.06987, 0.00488,      229,       16,      213
KQM, 0.02439, 0.00059,       41,        1,       40
KQN, 0.26471, 0.07007,       34,        9,       25
KQP, 0      , 0      ,       53,        0,       53
KQQ, 0.0625 , 0.00391,       64,        4,       60
KQR, 0.12658, 0.01602,       79,       10,       69
KQS, 0.10256, 0.01052,       78,        8,       70
KQT, 0.44186, 0.19524,       43,       19,       24
KQV, 0.1    , 0.01   ,       70,        7,       63
KQW, 0      , 0      ,       21,        0,       21
KQY, 0.0339 , 0.00115,       59,        2,       57
KQ_, 0      , 0      ,        6,        0,        6
KRK, 0.32353, 0.10467,      102,       33,       69
KRL, 0.15969, 0.0255 ,      382,       61,      321
KRM, 0.20482, 0.04195,       83,       17,       66
KRN, 0.16667, 0.02778,       96,       16,       80
KRP, 0.2381 , 0.05669,       63,       15,       48
KRQ, 0.27907, 0.07788,       86,       24,       62
KRR, 0.42697, 0.1823 ,      178,       76,      102
KRS, 0.24638, 0.0607 ,      138,       34,      104
KRT, 0.40541, 0.16435,      111,       45,       66
KRV, 0.25641, 0.06575,      156,       40,      116
KRW, 0.2381 , 0.05669,       42,       10,       32
KRY, 0.21429, 0.04592,      112,       24,       88
KR_, 0.33333, 0.11111,       21,        7,       14
KSK, 0.16393, 0.02687,       61,       10,       51
KSL, 0.11486, 0.01319,      296,       34,      262
KSM, 0.25   , 0.0625 ,       48,       12,       36
KSN, 0.16092, 0.0259 ,       87,       14,       73
KSP, 0.29358, 0.08619,      109,       32,       77
KSQ, 0.08861, 0.00785,       79,        7,       72
KSR, 0.27083, 0.07335,       96,       26,       70
KSS, 0.19136, 0.03662,      162,       31,      131
KST, 0.16667, 0.02778,       96,       16,       80
KSV, 0.2027 , 0.04109,      148,       30,      118
KSW, 0.06667, 0.00444,       30,        2,       28
KSY, 0.13953, 0.01947,       43,        6,       37
KS_, 0      , 0      ,       30,        0,       30
KTK, 0.16901, 0.02857,       71,       12,       59
KTL, 0.08333, 0.00694,      180,       15,      165
KTM, 0.09091, 0.00826,       55,        5,       50
KTN, 0.14583, 0.02127,       48,        7,       41
KTP, 0.19231, 0.03698,       78,       15,       63
KTQ, 0.08   , 0.0064 ,       75,        6,       69
KTR, 0.14773, 0.02182,       88,       13,       75
KTS, 0.22807, 0.05202,      114,       26,       88
KTT, 0.13636, 0.0186 ,       88,       12,       76
KTV, 0.41606, 0.1731 ,      137,       57,       80
KTW, 0.19048, 0.03628,       21,        4,       17
KTY, 0.03571, 0.00128,       28,        1,       27
KT_, 0      , 0      ,        4,        0,        4
KVK, 0.07143, 0.0051 ,       70,        5,       65
KVL, 0.02008, 0.0004 ,      249,        5,      244
KVM, 0      , 0      ,       46,        0,       46
KVN, 0.07042, 0.00496,       71,        5,       66
KVP, 0.04545, 0.00207,       88,        4,       84
KVQ, 0.10667, 0.01138,       75,        8,       67
KVR, 0.05208, 0.00271,       96,        5,       91
KVS, 0.1087 , 0.01181,       92,       10,       82
KVT, 0.03846, 0.00148,      104,        4,      100
KVV, 0.02667, 0.00071,      150,        4,      146
KVW, 0      , 0      ,       30,        0,       30
KVY, 0.04167, 0.00174,       72,        3,       69
KV_, 0.1875 , 0.03516,       16,        3,       13
KWK, 0.07692, 0.00592,       26,        2,       24
KWL, 0.10345, 0.0107 ,       29,        3,       26
KWM, 0      , 0      ,       11,        0,       11
KWN, 0.26087, 0.06805,       23,        6,       17
KWP, 0.45455, 0.20661,       22,       10,       12
KWQ, 0.86567, 0.74939,       67,       58,        9
KWR, 0.13158, 0.01731,       38,        5,       33
KWS, 0.18   , 0.0324 ,       50,        9,       41
KWT, 0      , 0      ,       20,        0,       20
KWV, 0.13793, 0.01902,       29,        4,       25
KWW, 0      , 0      ,        2,        0,        2
KWY, 0      , 0      ,       17,        0,       17
KW_, 0      , 0      ,        1,        0,        1
KYK, 0.12121, 0.01469,       33,        4,       29
KYL, 0.22656, 0.05133,      128,       29,       99
KYM, 0      , 0      ,       15,        0,       15
KYN, 0.19608, 0.03845,       51,       10,       41
KYP, 0.10145, 0.01029,       69,        7,       62
KYQ, 0.3    , 0.09   ,       40,       12,       28
KYR, 0.28767, 0.08275,       73,       21,       52
KYS, 0.21277, 0.04527,       94,       20,       74
KYT, 0.15217, 0.02316,       46,        7,       39
KYV, 0.10989, 0.01208,       91,       10,       81
KYW, 0      , 0      ,       14,        0,       14
KYY, 0.14894, 0.02218,       47,        7,       40
KY_, 0      , 0      ,        2,        0,        2
LAL, 0.0303 , 0.00092,       99,        3,       96
LAM, 0.02857, 0.00082,       70,        2,       68
LAN, 0      , 0      ,      129,        0,      129
LAP, 0.0198 , 0.00039,      202,        4,      198
LAQ, 0.01031, 0.00011,      194,        2,      192
LAR, 0.02833, 0.0008 ,      353,       10,      343
LAS, 0.0375 , 0.00141,      160,        6,      154
LAT, 0.13014, 0.01694,      146,       19,      127
LAV, 0.03061, 0.00094,      196,        6,      190
LAW, 0.02   , 0.0004 ,       50,        1,       49
LAY, 0.01408, 0.0002 ,       71,        1,       70
LA_, 0      , 0      ,       25,        0,       25
LCL, 0      , 0      ,       24,        0,       24
LCM, 0      , 0      ,        1,        0,        1
LCN, 0.16667, 0.02778,       12,        2,       10
LCP, 0      , 0      ,       20,        0,       20
LCQ, 0      , 0      ,       59,        0,       59
LCR, 0.2    , 0.04   ,       25,        5,       20
LCS, 0      , 0      ,       47,        0,       47
LCT, 0      , 0      ,       24,        0,       24
LCV, 0.02632, 0.00069,       38,        1,       37
LCW, 0      , 0      ,        1,        0,        1
LCY, 0      , 0      ,       10,        0,       10
LC_, 0      , 0      ,        1,        0,        1
LDL, 0.07101, 0.00504,      169,       12,      157
LDM, 0.05769, 0.00333,       52,        3,       49
LDN, 0.01613, 0.00026,      124,        2,      122
LDP, 0.02747, 0.00075,      182,        5,      177
LDQ, 0      , 0      ,      103,        0,      103
LDR, 0.03571, 0.00128,      168,        6,      162
LDS, 0.03265, 0.00107,      245,        8,      237
LDT, 0.0137 , 0.00019,      146,        2,      144
LDV, 0.06075, 0.00369,      214,       13,      201
LDW, 0      , 0      ,       29,        0,       29
LDY, 0.02128, 0.00045,       94,        2,       92
LD_, 0      , 0      ,       21,        0,       21
LEL, 0.02778, 0.00077,      216,        6,      210
LEM, 0.02532, 0.00064,       79,        2,       77
LEN, 0.02532, 0.00064,      237,        6,      231
LEP, 0.08333, 0.00694,      192,       16,      176
LEQ, 0.04633, 0.00215,      259,       12,      247
LER, 0.02096, 0.00044,      334,        7,      327
LES, 0.03947, 0.00156,      304,       12,      292
LET, 0.03015, 0.00091,      199,        6,      193
LEV, 0.03286, 0.00108,      213,        7,      206
LEW, 0      , 0      ,       63,        0,       63
LEY, 0.02362, 0.00056,      127,        3,      124
LE_, 0.0303 , 0.00092,       33,        1,       32
LFL, 0.07937, 0.0063 ,       63,        5,       58
LFM, 0.08824, 0.00779,       34,        3,       31
LFN, 0.02985, 0.00089,       67,        2,       65
LFP, 0.03125, 0.00098,       64,        2,       62
LFQ, 0.04124, 0.0017 ,       97,        4,       93
LFR, 0.13793, 0.01902,       87,       12,       75
LFS, 0.0922 , 0.0085 ,      141,       13,      128
LFT, 0.02597, 0.00067,       77,        2,       75
LFV, 0.16393, 0.02687,       61,       10,       51
LFW, 0      , 0      ,       17,        0,       17
LFY, 0      , 0      ,       31,        0,       31
LGL, 0.0438 , 0.00192,      137,        6,      131
LGM, 0.03077, 0.00095,       65,        2,       63
LGN, 0.04651, 0.00216,      172,        8,      164
LGP, 0.01613, 0.00026,      124,        2,      122
LGQ, 0      , 0      ,      106,        0,      106
LGR, 0.08772, 0.00769,      171,       15,      156
LGS, 0.08721, 0.00761,      172,       15,      157
LGT, 0.09028, 0.00815,      144,       13,      131
LGV, 0.07971, 0.00635,      138,       11,      127
LGW, 0.03774, 0.00142,       53,        2,       51
LGY, 0.07609, 0.00579,       92,        7,       85
LG_, 0      , 0      ,       10,        0,       10
LHL, 0      , 0      ,       44,        0,       44
LHM, 0.03125, 0.00098,       32,        1,       31
LHN, 0.19266, 0.03712,      109,       21,       88
LHP, 0.10638, 0.01132,       47,        5,       42
LHQ, 0.04348, 0.00189,       69,        3,       66
LHR, 0.08974, 0.00805,       78,        7,       71
LHS, 0.43023, 0.1851 ,       86,       37,       49
LHT, 0.13793, 0.01902,       58,        8,       50
LHV, 0.06897, 0.00476,       58,        4,       54
LHW, 0      , 0      ,        8,        0,        8
LHY, 0.07018, 0.00492,       57,        4,       53
LH_, 0      , 0      ,        4,        0,        4
LIL, 0      , 0      ,       71,        0,       71
LIM, 0.09091, 0.00826,       22,        2,       20
LIN, 0.04762, 0.00227,      105,        5,      100
LIP, 0      , 0      ,      101,        0,      101
LIQ, 0      , 0      ,      113,        0,      113
LIR, 0.04895, 0.0024 ,      143,        7,      136
LIS, 0.02797, 0.00078,      143,        4,      139
LIT, 0.28774, 0.08279,      212,       61,      151
LIV, 0.03896, 0.00152,       77,        3,       74
LIW, 0.07692, 0.00592,       26,        2,       24
LIY, 0.02439, 0.00059,       82,        2,       80
LI_, 0      , 0      ,        7,        0,        7
LKL, 0.2    , 0.04   ,      130,       26,      104
LKM, 0.09375, 0.00879,       64,        6,       58
LKN, 0.10288, 0.01058,      243,       25,      218
LKP, 0.09402, 0.00884,      117,       11,      106
LKQ, 0.0892 , 0.00796,      213,       19,      194
LKR, 0.11014, 0.01213,      345,       38,      307
LKS, 0.19588, 0.03837,      291,       57,      234
LKT, 0.12105, 0.01465,      190,       23,      167
LKV, 0.28777, 0.08281,      278,       80,      198
LKW, 0.09677, 0.00937,       31,        3,       28
LKY, 0.18644, 0.03476,      118,       22,       96
LK_, 0.04167, 0.00174,       24,        1,       23
LLL, 0      , 0      ,      170,        0,      170
LLM, 0      , 0      ,       64,        0,       64
LLN, 0.03509, 0.00123,      171,        6,      165
LLP, 0.04464, 0.00199,      224,       10,      214
LLQ, 0.01493, 0.00022,      201,        3,      198
LLR, 0.02579, 0.00067,      349,        9,      340
LLS, 0.02787, 0.00078,      287,        8,      279
LLT, 0.03846, 0.00148,      234,        9,      225
LLV, 0.01471, 0.00022,      136,        2,      134
LLW, 0      , 0      ,       23,        0,       23
LLY, 0.075  , 0.00562,      120,        9,      111
LL_, 0.07692, 0.00592,       13,        1,       12
LML, 0      , 0      ,       51,        0,       51
LMM, 0      , 0      ,       16,        0,       16
LMN, 0.025  , 0.00063,       40,        1,       39
LMP, 0.23077, 0.05325,       39,        9,       30
LMQ, 0.01562, 0.00024,       64,        1,       63
LMR, 0.05263, 0.00277,       57,        3,       54
LMS, 0.04167, 0.00174,       72,        3,       69
LMT, 0.14545, 0.02116,       55,        8,       47
LMV, 0.0566 , 0.0032 ,       53,        3,       50
LMW, 0      , 0      ,        7,        0,        7
LMY, 0      , 0      ,       29,        0,       29
LM_, 0      , 0      ,       17,        0,       17
LNL, 0.09211, 0.00848,      152,       14,      138
LNM, 0.03509, 0.00123,       57,        2,       55
LNN, 0.10811, 0.01169,      111,       12,       99
LNP, 0.1087 , 0.01181,       92,       10,       82
LNQ, 0.10526, 0.01108,      114,       12,      102
LNR, 0.08738, 0.00764,      206,       18,      188
LNS, 0.16327, 0.02666,      196,       32,      164
LNT, 0.20732, 0.04298,       82,       17,       65
LNV, 0.16522, 0.0273 ,      115,       19,       96
LNW, 0.15385, 0.02367,       26,        4,       22
LNY, 0.05634, 0.00317,       71,        4,       67
LN_, 0      , 0      ,       17,        0,       17
LPL, 0.05195, 0.0027 ,       77,        4,       73
LPM, 0      , 0      ,       50,        0,       50
LPN, 0.02857, 0.00082,      105,        3,      102
LPP, 0.04348, 0.00189,      161,        7,      154
LPQ, 0.05618, 0.00316,       89,        5,       84
LPR, 0.11875, 0.0141 ,      160,       19,      141
LPS, 0.08392, 0.00704,      143,       12,      131
LPT, 0.03704, 0.00137,      108,        4,      104
LPV, 0.05202, 0.00271,      173,        9,      164
LPW, 0.08333, 0.00694,       36,        3,       33
LPY, 0.01205, 0.00015,       83,        1,       82
LP_, 0      , 0      ,       20,        0,       20
LQL, 0.12844, 0.0165 ,      109,       14,       95
LQM, 0.02   , 0.0004 ,       50,        1,       49
LQN, 0.09231, 0.00852,      130,       12,      118
LQP, 0.05882, 0.00346,      102,        6,       96
LQQ, 0.14516, 0.02107,      124,       18,      106
LQR, 0.11927, 0.01422,      218,       26,      192
LQS, 0.01439, 0.00021,      139,        2,      137
LQT, 0.07143, 0.0051 ,      112,        8,      104
LQV, 0.17687, 0.03128,      147,       26,      121
LQW, 0.03571, 0.00128,       28,        1,       27
LQY, 0.06977, 0.00487,       43,        3,       40
LQ_, 0.08   , 0.0064 ,       25,        2,       23
LRL, 0.14394, 0.02072,      132,       19,      113
LRM, 0.14706, 0.02163,      102,       15,       87
LRN, 0.17045, 0.02905,       88,       15,       73
LRP, 0.13934, 0.01942,      122,       17,      105
LRQ, 0.12626, 0.01594,      198,       25,      173
LRR, 0.14247, 0.0203 ,      365,       52,      313
LRS, 0.18443, 0.03401,      244,       45,      199
LRT, 0.12977, 0.01684,      131,       17,      114
LRV, 0.07241, 0.00524,      290,       21,      269
LRW, 0.02326, 0.00054,       43,        1,       42
LRY, 0.2782 , 0.07739,      133,       37,       96
LR_, 0.05556, 0.00309,       18,        1,       17
LSL, 0.14365, 0.02063,      181,       26,      155
LSM, 0.26154, 0.0684 ,       65,       17,       48
LSN, 0.05652, 0.00319,      230,       13,      217
LSP, 0.1938 , 0.03756,      129,       25,      104
LSQ, 0.08383, 0.00703,      167,       14,      153
LSR, 0.21111, 0.04457,      270,       57,      213
LSS, 0.10131, 0.01026,      306,       31,      275
LST, 0.09929, 0.00986,      141,       14,      127
LSV, 0.06667, 0.00444,      150,       10,      140
LSW, 0.02128, 0.00045,       47,        1,       46
LSY, 0.13281, 0.01764,      128,       17,      111
LS_, 0      , 0      ,       14,        0,       14
LTL, 0.08451, 0.00714,      142,       12,      130
LTM, 0.20833, 0.0434 ,       72,       15,       57
LTN, 0.1125 , 0.01266,      160,       18,      142
LTP, 0.0878 , 0.00771,      205,       18,      187
LTQ, 0.1399 , 0.01957,      193,       27,      166
LTR, 0.25926, 0.06722,      189,       49,      140
LTS, 0.20588, 0.04239,      170,       35,      135
LTT, 0.19841, 0.03937,      126,       25,      101
LTV, 0.08824, 0.00779,      170,       15,      155
LTW, 0.0625 , 0.00391,       16,        1,       15
LTY, 0.08621, 0.00743,      116,       10,      106
LT_, 0      , 0      ,        6,        0,        6
LVL, 0.18421, 0.03393,       76,       14,       62
LVM, 0.11864, 0.01408,       59,        7,       52
LVN, 0.00559, 0.00003,      179,        1,      178
LVP, 0      , 0      ,      183,        0,      183
LVQ, 0.05882, 0.00346,      204,       12,      192
LVR, 0.1457 , 0.02123,      151,       22,      129
LVS, 0.02632, 0.00069,      152,        4,      148
LVT, 0.04505, 0.00203,      111,        5,      106
LVV, 0.0073 , 0.00005,      137,        1,      136
LVW, 0.06061, 0.00367,       33,        2,       31
LVY, 0.05556, 0.00309,       36,        2,       34
LV_, 0.25   , 0.0625 ,        8,        2,        6
LWL, 0.12821, 0.01644,       39,        5,       34
LWM, 0.15385, 0.02367,       13,        2,       11
LWN, 0.37037, 0.13717,       27,       10,       17
LWP, 0.14286, 0.02041,       14,        2,       12
LWQ, 0.08511, 0.00724,       47,        4,       43
LWR, 0.11268, 0.0127 ,       71,        8,       63
LWS, 0.04255, 0.00181,       47,        2,       45
LWT, 0.33333, 0.11111,       21,        7,       14
LWV, 0.0303 , 0.00092,       33,        1,       32
LWW, 0      , 0      ,        1,        0,        1
LWY, 0      , 0      ,        9,        0,        9
LW_, 0      , 0      ,        1,        0,        1
LYL, 0.03409, 0.00116,       88,        3,       85
LYM, 0      , 0      ,       23,        0,       23
LYN, 0.16667, 0.02778,       96,       16,       80
LYP, 0.20312, 0.04126,       64,       13,       51
LYQ, 0.08642, 0.00747,       81,        7,       74
LYR, 0.22222, 0.04938,      135,       30,      105
LYS, 0.16667, 0.02778,       96,       16,       80
LYT, 0.0597 , 0.00356,       67,        4,       63
LYV, 0.10309, 0.01063,       97,       10,       87
LYW, 0.29412, 0.08651,       17,        5,       12
LYY, 0.20561, 0.04227,      107,       22,       85
LY_, 0      , 0      ,        3,        0,        3
MAM, 0      , 0      ,        4,        0,        4
MAN, 0.0625 , 0.00391,       32,        2,       30
MAP, 0.07143, 0.0051 ,       28,        2,       26
MAQ, 0      , 0      ,       32,        0,       32
MAR, 0.05479, 0.003  ,       73,        4,       69
MAS, 0.05405, 0.00292,       37,        2,       35
MAT, 0.12   , 0.0144 ,       50,        6,       44
MAV, 0.02703, 0.00073,       37,        1,       36
MAW, 0      , 0      ,        9,        0,        9
MAY, 0.08696, 0.00756,       23,        2,       21
MA_, 0.09091, 0.00826,       11,        1,       10
MCN, 0      , 0      ,        3,        0,        3
MCP, 0      , 0      ,        2,        0,        2
MCQ, 0      , 0      ,        2,        0,        2
MCR, 0      , 0      ,        8,        0,        8
MCS, 0      , 0      ,        1,        0,        1
MCT, 0      , 0      ,        6,        0,        6
MCV, 0      , 0      ,        2,        0,        2
MCY, 0      , 0      ,        1,        0,        1
MDM, 0      , 0      ,        9,        0,        9
MDN, 0      , 0      ,       22,        0,       22
MDP, 0.075  , 0.00562,       40,        3,       37
MDQ, 0.05263, 0.00277,       19,        1,       18
MDR, 0.02   , 0.0004 ,       50,        1,       49
MDS, 0.07547, 0.0057 ,       53,        4,       49
MDT, 0      , 0      ,       24,        0,       24
MDV, 0.04651, 0.00216,       43,        2,       41
MDW, 0      , 0      ,        3,        0,        3
MDY, 0.07143, 0.0051 ,       14,        1,       13
MD_, 0.2    , 0.04   ,        5,        1,        4
MEM, 0      , 0      ,       13,        0,       13
MEN, 0      , 0      ,       30,        0,       30
MEP, 0      , 0      ,       34,        0,       34
MEQ, 0      , 0      ,       64,        0,       64
MER, 0.02   , 0.0004 ,       50,        1,       49
MES, 0.02703, 0.00073,       37,        1,       36
MET, 0      , 0      ,       45,        0,       45
MEV, 0.03659, 0.00134,       82,        3,       79
MEW, 0      , 0      ,       17,        0,       17
MEY, 0      , 0      ,       33,        0,       33
ME_, 0      , 0      ,        6,        0,        6
MFN, 0      , 0      ,       36,        0,       36
MFP, 0.0625 , 0.00391,       16,        1,       15
MFQ, 0.1875 , 0.03516,       16,        3,       13
MFR, 0.23333, 0.05444,       30,        7,       23
MFS, 0      , 0      ,       17,        0,       17
MFT, 0      , 0      ,        5,        0,        5
MFV, 0.42857, 0.18367,       14,        6,        8
MFW, 0      , 0      ,        4,        0,        4
MFY, 0      , 0      ,       15,        0,       15
MGM, 0      , 0      ,        5,        0,        5
MGN, 0      , 0      ,       18,        0,       18
MGP, 0.03448, 0.00119,       29,        1,       28
MGQ, 0      , 0      ,       10,        0,       10
MGR, 0.03636, 0.00132,       55,        2,       53
MGS, 0.15789, 0.02493,       38,        6,       32
MGT, 0.08696, 0.00756,       23,        2,       21
MGV, 0.10811, 0.01169,       37,        4,       33
MGW, 0.1    , 0.01   ,       20,        2,       18
MGY, 0.10526, 0.01108,       19,        2,       17
MG_, 0.125  , 0.01562,        8,        1,        7
MHM, 1      , 1      ,        2,        2,        0
MHN, 0.5    , 0.25   ,        2,        1,        1
MHP, 0.1    , 0.01   ,       20,        2,       18
MHQ, 0      , 0      ,        7,        0,        7
MHR, 0.38462, 0.14793,       13,        5,        8
MHS, 0.03571, 0.00128,       28,        1,       27
MHT, 0      , 0      ,        8,        0,        8
MHV, 0      , 0      ,       16,        0,       16
MHW, 0.2    , 0.04   ,        5,        1,        4
MHY, 0      , 0      ,        5,        0,        5
MH_, 0.08696, 0.00756,       23,        2,       21
MIN, 0      , 0      ,       70,        0,       70
MIP, 0      , 0      ,       24,        0,       24
MIQ, 0      , 0      ,       36,        0,       36
MIR, 0      , 0      ,       24,        0,       24
MIS, 0.04167, 0.00174,       48,        2,       46
MIT, 0.03333, 0.00111,       30,        1,       29
MIV, 0.06061, 0.00367,       33,        2,       31
MIW, 0.33333, 0.11111,        6,        2,        4
MIY, 0      , 0      ,       12,        0,       12
MI_, 0      , 0      ,        2,        0,        2
MKM, 0.05   , 0.0025 ,       20,        1,       19
MKN, 0.23077, 0.05325,       52,       12,       40
MKP, 0.11111, 0.01235,       45,        5,       40
MKQ, 0.20968, 0.04396,       62,       13,       49
MKR, 0.10345, 0.0107 ,       58,        6,       52
MKS, 0.11905, 0.01417,       42,        5,       37
MKT, 0.07143, 0.0051 ,       28,        2,       26
MKV, 0.07143, 0.0051 ,       42,        3,       39
MKW, 0.5    , 0.25   ,        4,        2,        2
MKY, 0.48148, 0.23182,       27,       13,       14
MK_, 0      , 0      ,        2,        0,        2
MLM, 0      , 0      ,        4,        0,        4
MLN, 0      , 0      ,       63,        0,       63
MLP, 0      , 0      ,       32,        0,       32
MLQ, 0      , 0      ,       57,        0,       57
MLR, 0.04651, 0.00216,       43,        2,       41
MLS, 0.01538, 0.00024,       65,        1,       64
MLT, 0.01786, 0.00032,       56,        1,       55
MLV, 0.11538, 0.01331,       26,        3,       23
MLW, 0      , 0      ,        8,        0,        8
MLY, 0      , 0      ,       25,        0,       25
ML_, 0      , 0      ,        3,        0,        3
MMM, 0      , 0      ,        4,        0,        4
MMN, 0.18182, 0.03306,       11,        2,        9
MMP, 0      , 0      ,       21,        0,       21
MMQ, 0      , 0      ,        6,        0,        6
MMR, 0      , 0      ,       35,        0,       35
MMS, 0.0625 , 0.00391,       16,        1,       15
MMT, 0      , 0      ,        5,        0,        5
MMV, 0.2    , 0.04   ,       10,        2,        8
MMW, 0.5    , 0.25   ,        2,        1,        1
MM_, 0      , 0      ,       10,        0,       10
MNM, 0.5    , 0.25   ,        2,        1,        1
MNN, 0.125  , 0.01562,       24,        3,       21
MNP, 0.11765, 0.01384,       34,        4,       30
MNQ, 0      , 0      ,       14,        0,       14
MNR, 0.06897, 0.00476,       29,        2,       27
MNS, 0.30556, 0.09336,       36,       11,       25
MNT, 0.37681, 0.14199,       69,       26,       43
MNV, 0      , 0      ,       83,        0,       83
MNW, 0      , 0      ,        2,        0,        2
MNY, 0      , 0      ,       41,        0,       41
MN_, 0      , 0      ,        7,        0,        7
MPM, 0.14286, 0.02041,        7,        1,        6
MPN, 0      , 0      ,       21,        0,       21
MPP, 0      , 0      ,       14,        0,       14
MPQ, 0.18182, 0.03306,       11,        2,        9
MPR, 0      , 0      ,       35,        0,       35
MPS, 0      , 0      ,       29,        0,       29
MPT, 0.225  , 0.05063,       40,        9,       31
MPV, 0      , 0      ,       38,        0,       38
MPW, 0.5    , 0.25   ,        2,        1,        1
MPY, 0.06897, 0.00476,       29,        2,       27
MP_, 0      , 0      ,       14,        0,       14
MQN, 0      , 0      ,       26,        0,       26
MQP, 0.36364, 0.13223,       11,        4,        7
MQQ, 0.0303 , 0.00092,       33,        1,       32
MQR, 0.08889, 0.0079 ,       45,        4,       41
MQS, 0.06383, 0.00407,       47,        3,       44
MQT, 0      , 0      ,       30,        0,       30
MQV, 0.26087, 0.06805,       23,        6,       17
MQW, 0      , 0      ,        5,        0,        5
MQY, 0.15385, 0.02367,       13,        2,       11
MQ_, 0      , 0      ,        1,        0,        1
MRM, 0.25   , 0.0625 ,       12,        3,        9
MRN, 0.38095, 0.14512,       42,       16,       26
MRP, 0.15385, 0.02367,       26,        4,       22
MRQ, 0.11628, 0.01352,       43,        5,       38
MRR, 0.38947, 0.15169,       95,       37,       58
MRS, 0.14583, 0.02127,       48,        7,       41
MRT, 0.15385, 0.02367,       52,        8,       44
MRV, 0.2    , 0.04   ,       50,       10,       40
MRW, 0.28571, 0.08163,       14,        4,       10
MRY, 0.32   , 0.1024 ,       25,        8,       17
MR_, 0      , 0      ,        1,        0,        1
MSM, 0.33333, 0.11111,        6,        2,        4
MSN, 0.45833, 0.21007,       24,       11,       13
MSP, 0.19048, 0.03628,       21,        4,       17
MSQ, 0.21622, 0.04675,       37,        8,       29
MSR, 0.22222, 0.04938,       54,       12,       42
MSS, 0.075  , 0.00562,       40,        3,       37
MST, 0.29167, 0.08507,       24,        7,       17
MSV, 0.04167, 0.00174,       48,        2,       46
MSW, 0      , 0      ,        7,        0,        7
MSY, 0.11429, 0.01306,       35,        4,       31
MS_, 0      , 0      ,       16,        0,       16
MTM, 0      , 0      ,        1,        0,        1
MTN, 0.125  , 0.01562,       16,        2,       14
MTP, 0      , 0      ,       29,        0,       29
MTQ, 0.075  , 0.00562,       40,        3,       37
MTR, 0.26667, 0.07111,       15,        4,       11
MTS, 0.06   , 0.0036 ,       50,        3,       47
MTT, 0.10345, 0.0107 ,       29,        3,       26
MTV, 0.35   , 0.1225 ,       20,        7,       13
MTW, 0      , 0      ,        1,        0,        1
MTY, 0      , 0      ,       14,        0,       14
MT_, 0      , 0      ,        1,        0,        1
MVM, 0      , 0      ,       13,        0,       13
MVN, 0      , 0      ,       32,        0,       32
MVP, 0      , 0      ,       25,        0,       25
MVQ, 0.03846, 0.00148,       26,        1,       25
MVR, 0.04762, 0.00227,       42,        2,       40
MVS, 0.11538, 0.01331,       26,        3,       23
MVT, 0.11765, 0.01384,       17,        2,       15
MVV, 0      , 0      ,       16,        0,       16
MVW, 0      , 0      ,        9,        0,        9
MVY, 0.04167, 0.00174,       24,        1,       23
MWN, 0      , 0      ,        3,        0,        3
MWQ, 0.33333, 0.11111,        3,        1,        2
MWR, 0.07692, 0.00592,       13,        1,       12
MWS, 0.5    , 0.25   ,        4,        2,        2
MWT, 0      , 0      ,        1,        0,        1
MWV, 0      , 0      ,        9,        0,        9
MWW, 0.33333, 0.11111,        6,        2,        4
MWY, 0      , 0      ,       10,        0,       10
MYM, 0      , 0      ,        8,        0,        8
MYN, 0      , 0      ,        3,        0,        3
MYP, 0      , 0      ,       25,        0,       25
MYQ, 0.4    , 0.16   ,        5,        2,        3
MYR, 0.16   , 0.0256 ,       50,        8,       42
MYS, 0.125  , 0.01562,       24,        3,       21
MYT, 0.05263, 0.00277,       19,        1,       18
MYV, 0      , 0      ,       23,        0,       23
MYY, 0.33333, 0.11111,        3,        1,        2
MY_, 0      , 0      ,        2,        0,        2
NAN, 0.01351, 0.00018,       74,        1,       73
NAP, 0      , 0      ,       47,        0,       47
NAQ, 0.25581, 0.06544,       43,       11,       32
NAR, 0.06667, 0.00444,       60,        4,       56
NAS, 0.0566 , 0.0032 ,       53,        3,       50
NAT, 0.12245, 0.01499,       49,        6,       43
NAV, 0.1358 , 0.01844,       81,       11,       70
NAW, 0      , 0      ,       10,        0,       10
NAY, 0      , 0      ,       35,        0,       35
NA_, 0      , 0      ,        8,        0,        8
NCN, 0      , 0      ,        2,        0,        2
NCP, 0      , 0      ,       18,        0,       18
NCQ, 0      , 0      ,        4,        0,        4
NCR, 0.09091, 0.00826,       11,        1,       10
NCS, 0      , 0      ,       17,        0,       17
NCT, 0.14286, 0.02041,        7,        1,        6
NCV, 0      , 0      ,       16,        0,       16
NCW, 0.16667, 0.02778,        6,        1,        5
NCY, 0      , 0      ,        5,        0,        5
NC_, 0      , 0      ,        1,        0,        1
NDN, 0      , 0      ,       16,        0,       16
NDP, 0.1    , 0.01   ,       30,        3,       27
NDQ, 0.15   , 0.0225 ,       40,        6,       34
NDR, 0.13559, 0.01839,       59,        8,       51
NDS, 0.03226, 0.00104,       62,        2,       60
NDT, 0.08   , 0.0064 ,       50,        4,       46
NDV, 0.02   , 0.0004 ,       50,        1,       49
NDW, 0      , 0      ,        9,        0,        9
NDY, 0      , 0      ,       47,        0,       47
ND_, 0.25   , 0.0625 ,        4,        1,        3
NEN, 0.02703, 0.00073,      111,        3,      108
NEP, 0.01449, 0.00021,       69,        1,       68
NEQ, 0.08696, 0.00756,       69,        6,       63
NER, 0.02778, 0.00077,       72,        2,       70
NES, 0.05983, 0.00358,      117,        7,      110
NET, 0.07576, 0.00574,       66,        5,       61
NEV, 0.04167, 0.00174,       96,        4,       92
NEW, 0      , 0      ,       34,        0,       34
NEY, 0.0339 , 0.00115,       59,        2,       57
NE_, 0      , 0      ,        6,        0,        6
NFN, 0.2    , 0.04   ,       15,        3,       12
NFP, 0      , 0      ,       24,        0,       24
NFQ, 0.55556, 0.30864,      108,       60,       48
NFR, 0.23077, 0.05325,       39,        9,       30
NFS, 0.08929, 0.00797,       56,        5,       51
NFT, 0.06557, 0.0043 ,       61,        4,       57
NFV, 0      , 0      ,       47,        0,       47
NFW, 0.54545, 0.29752,       11,        6,        5
NFY, 0.01493, 0.00022,       67,        1,       66
NGN, 0.09375, 0.00879,       32,        3,       29
NGP, 0      , 0      ,       40,        0,       40
NGQ, 0      , 0      ,       47,        0,       47
NGR, 0.20513, 0.04208,       78,       16,       62
NGS, 0.16418, 0.02695,       67,       11,       56
NGT, 0.06122, 0.00375,       49,        3,       46
NGV, 0.05085, 0.00259,       59,        3,       56
NGW, 0.06897, 0.00476,       29,        2,       27
NGY, 0.17647, 0.03114,       34,        6,       28
NG_, 0      , 0      ,        9,        0,        9
NHN, 0      , 0      ,        8,        0,        8
NHP, 0.125  , 0.01562,       16,        2,       14
NHQ, 0.09375, 0.00879,       32,        3,       29
NHR, 0.2037 , 0.0415 ,       54,       11,       43
NHS, 0.17647, 0.03114,       17,        3,       14
NHT, 0.25641, 0.06575,       39,       10,       29
NHV, 0.04167, 0.00174,       24,        1,       23
NHY, 0.11111, 0.01235,       18,        2,       16
NH_, 0      , 0      ,        5,        0,        5
NIN, 0      , 0      ,       26,        0,       26
NIP, 0.11364, 0.01291,       44,        5,       39
NIQ, 0      , 0      ,       32,        0,       32
NIR, 0.05   , 0.0025 ,       80,        4,       76
NIS, 0.0339 , 0.00115,       59,        2,       57
NIT, 0.12308, 0.01515,       65,        8,       57
NIV, 0.09459, 0.00895,       74,        7,       67
NIW, 0      , 0      ,       17,        0,       17
NIY, 0.05263, 0.00277,       38,        2,       36
NI_, 0      , 0      ,        5,        0,        5
NKN, 0.12903, 0.01665,       31,        4,       27
NKP, 0.18667, 0.03484,       75,       14,       61
NKQ, 0.25758, 0.06635,       66,       17,       49
NKR, 0.25547, 0.06527,      137,       35,      102
NKS, 0.18269, 0.03338,      104,       19,       85
NKT, 0.26923, 0.07249,      104,       28,       76
NKV, 0.1068 , 0.01141,      103,       11,       92
NKW, 0.05882, 0.00346,       34,        2,       32
NKY, 0.19318, 0.03732,       88,       17,       71
NK_, 0.4    , 0.16   ,       10,        4,        6
NLN, 0.02222, 0.00049,       45,        1,       44
NLP, 0.02985, 0.00089,      134,        4,      130
NLQ, 0.06329, 0.00401,       79,        5,       74
NLR, 0.04808, 0.00231,      104,        5,       99
NLS, 0.03571, 0.00128,      112,        4,      108
NLT, 0.08917, 0.00795,      157,       14,      143
NLV, 0.02222, 0.00049,       90,        2,       88
NLW, 0.32143, 0.10332,       28,        9,       19
NLY, 0.12048, 0.01452,       83,       10,       73
NL_, 0      , 0      ,        6,        0,        6
NMN, 0.34783, 0.12098,       23,        8,       15
NMP, 0.37143, 0.13796,       35,       13,       22
NMQ, 0      , 0      ,       26,        0,       26
NMR, 0.1    , 0.01   ,       20,        2,       18
NMS, 0.19231, 0.03698,       26,        5,       21
NMT, 0.0625 , 0.00391,       16,        1,       15
NMV, 0.04167, 0.00174,       24,        1,       23
NMW, 0      , 0      ,        5,        0,        5
NMY, 0.04167, 0.00174,       24,        1,       23
NM_, 0.22222, 0.04938,       18,        4,       14
NNN, 0.08889, 0.0079 ,       45,        4,       41
NNP, 0.25806, 0.0666 ,       62,       16,       46
NNQ, 0      , 0      ,       43,        0,       43
NNR, 0.26923, 0.07249,       52,       14,       38
NNS, 0.0625 , 0.00391,       80,        5,       75
NNT, 0.18644, 0.03476,       59,       11,       48
NNV, 0.01613, 0.00026,       62,        1,       61
NNW, 0.15385, 0.02367,       13,        2,       11
NNY, 0.04444, 0.00198,       45,        2,       43
NN_, 0      , 0      ,       12,        0,       12
NPN, 0.02564, 0.00066,       39,        1,       38
NPP, 0.15   , 0.0225 ,       20,        3,       17
NPQ, 0.04082, 0.00167,       98,        4,       94
NPR, 0.2    , 0.04   ,       50,       10,       40
NPS, 0.21739, 0.04726,       69,       15,       54
NPT, 0      , 0      ,       92,        0,       92
NPV, 0.03297, 0.00109,       91,        3,       88
NPW, 0.36842, 0.13573,       19,        7,       12
NPY, 0.1    , 0.01   ,       40,        4,       36
NP_, 0      , 0      ,        8,        0,        8
NQN, 0      , 0      ,       16,        0,       16
NQP, 0.16   , 0.0256 ,       25,        4,       21
NQQ, 0.03704, 0.00137,       81,        3,       78
NQR, 0.14286, 0.02041,       35,        5,       30
NQS, 0.14894, 0.02218,       47,        7,       40
NQT, 0.27451, 0.07536,       51,       14,       37
NQV, 0.05634, 0.00317,       71,        4,       67
NQW, 0.07143, 0.0051 ,       14,        1,       13
NQY, 0      , 0      ,       47,        0,       47
NQ_, 0      , 0      ,        5,        0,        5
NRN, 0.13514, 0.01826,       37,        5,       32
NRP, 0.20833, 0.0434 ,       48,       10,       38
NRQ, 0.16364, 0.02678,       55,        9,       46
NRR, 0.41935, 0.17586,      124,       52,       72
NRS, 0.47727, 0.22779,       88,       42,       46
NRT, 0.57692, 0.33284,       78,       45,       33
NRV, 0.15385, 0.02367,       78,       12,       66
NRW, 0.09091, 0.00826,       22,        2,       20
NRY, 0.04615, 0.00213,       65,        3,       62
NR_, 0.35714, 0.12755,       14,        5,        9
NSN, 0.07692, 0.00592,       39,        3,       36
NSP, 0.20312, 0.04126,       64,       13,       51
NSQ, 0.0566 , 0.0032 ,       53,        3,       50
NSR, 0.25641, 0.06575,       78,       20,       58
NSS, 0.28571, 0.08163,       63,       18,       45
NST, 0.06849, 0.00469,       73,        5,       68
NSV, 0.16279, 0.0265 ,       86,       14,       72
NSW, 0.15789, 0.02493,       19,        3,       16
NSY, 0.125  , 0.01562,       72,        9,       63
NS_, 0      , 0      ,        9,        0,        9
NTN, 0.34211, 0.11704,       38,       13,       25
NTP, 0      , 0      ,       46,        0,       46
NTQ, 0.02299, 0.00053,       87,        2,       85
NTR, 0.26154, 0.0684 ,       65,       17,       48
NTS, 0.13793, 0.01902,       58,        8,       50
NTT, 0.10811, 0.01169,       37,        4,       33
NTV, 0.10714, 0.01148,       84,        9,       75
NTW, 0      , 0      ,       16,        0,       16
NTY, 0      , 0      ,       26,        0,       26
NT_, 0      , 0      ,        3,        0,        3
NVN, 0      , 0      ,       28,        0,       28
NVP, 0.67045, 0.44951,       88,       59,       29
NVQ, 0      , 0      ,       33,        0,       33
NVR, 0.04255, 0.00181,       47,        2,       45
NVS, 0.35152, 0.12356,      165,       58,      107
NVT, 0.1087 , 0.01181,       46,        5,       41
NVV, 0.03774, 0.00142,      106,        4,      102
NVW, 0      , 0      ,       10,        0,       10
NVY, 0.02273, 0.00052,       44,        1,       43
NV_, 0      , 0      ,        2,        0,        2
NWN, 0      , 0      ,        5,        0,        5
NWP, 0.21053, 0.04432,       19,        4,       15
NWQ, 0.4    , 0.16   ,        5,        2,        3
NWR, 0.21739, 0.04726,       23,        5,       18
NWS, 0.25   , 0.0625 ,       16,        4,       12
NWT, 0      , 0      ,       16,        0,       16
NWV, 0      , 0      ,       19,        0,       19
NWW, 0      , 0      ,        2,        0,        2
NWY, 0      , 0      ,        1,        0,        1
NYN, 0.11111, 0.01235,       18,        2,       16
NYP, 0.02941, 0.00087,       34,        1,       33
NYQ, 0.25   , 0.0625 ,       20,        5,       15
NYR, 0.05   , 0.0025 ,       40,        2,       38
NYS, 0.28571, 0.08163,       28,        8,       20
NYT, 0.15789, 0.02493,       19,        3,       16
NYV, 0.08824, 0.00779,       68,        6,       62
NYW, 0.16667, 0.02778,        6,        1,        5
NYY, 0.13043, 0.01701,       23,        3,       20
NY_, 0      , 0      ,        4,        0,        4
PAP, 0      , 0      ,       44,        0,       44
PAQ, 0      , 0      ,       49,        0,       49
PAR, 0.04762, 0.00227,       63,        3,       60
PAS, 0.0241 , 0.00058,       83,        2,       81
PAT, 0.06494, 0.00422,       77,        5,       72
PAV, 0      , 0      ,      106,        0,      106
PAW, 0.2    , 0.04   ,        5,        1,        4
PAY, 0      , 0      ,       36,        0,       36
PA_, 0.25   , 0.0625 ,        4,        1,        3
PCP, 0      , 0      ,       15,        0,       15
PCQ, 0      , 0      ,        5,        0,        5
PCR, 0      , 0      ,       17,        0,       17
PCS, 0      , 0      ,       15,        0,       15
PCT, 0.125  , 0.01562,       24,        3,       21
PCV, 0      , 0      ,       19,        0,       19
PCW, 0      , 0      ,        2,        0,        2
PCY, 0      , 0      ,        4,        0,        4
PDP, 0      , 0      ,       24,        0,       24
PDQ, 0.11538, 0.01331,       52,        6,       46
PDR, 0.04545, 0.00207,       66,        3,       63
PDS, 0.02247, 0.0005 ,       89,        2,       87
PDT, 0.03077, 0.00095,       65,        2,       63
PDV, 0.15   , 0.0225 ,      140,       21,      119
PDW, 0      , 0      ,       25,        0,       25
PDY, 0      , 0      ,       63,        0,       63
PD_, 0.25   , 0.0625 ,       20,        5,       15
PEP, 0      , 0      ,       27,        0,       27
PEQ, 0.02326, 0.00054,       86,        2,       84
PER, 0.04808, 0.00231,      104,        5,       99
PES, 0.02151, 0.00046,       93,        2,       91
PET, 0.06338, 0.00402,      142,        9,      133
PEV, 0.00714, 0.00005,      140,        1,      139
PEW, 0      , 0      ,       28,        0,       28
PEY, 0      , 0      ,       45,        0,       45
PE_, 0      , 0      ,       10,        0,       10
PFP, 0.05556, 0.00309,       18,        1,       17
PFQ, 0.06061, 0.00367,       33,        2,       31
PFR, 0.13953, 0.01947,       43,        6,       37
PFS, 0.20833, 0.0434 ,       48,       10,       38
PFT, 0.11429, 0.01306,       70,        8,       62
PFV, 0.05   , 0.0025 ,       60,        3,       57
PFW, 0      , 0      ,       20,        0,       20
PFY, 0      , 0      ,       33,        0,       33
PF_, 0      , 0      ,        5,        0,        5
PGP, 0      , 0      ,       47,        0,       47
PGQ, 0.02174, 0.00047,       46,        1,       45
PGR, 0.13542, 0.01834,       96,       13,       83
PGS, 0.01613, 0.00026,      124,        2,      122
PGT, 0.50781, 0.25787,      128,       65,       63
PGV, 0.06557, 0.0043 ,       61,        4,       57
PGW, 0.03125, 0.00098,       32,        1,       31
PGY, 0.04348, 0.00189,       23,        1,       22
PG_, 0      , 0      ,       14,        0,       14
PHP, 0.05882, 0.00346,       34,        2,       32
PHQ, 0.18182, 0.03306,       22,        4,       18
PHR, 0.10526, 0.01108,       38,        4,       34
PHS, 0.05128, 0.00263,       39,        2,       37
PHT, 0.05128, 0.00263,       39,        2,       37
PHV, 0.27586, 0.0761 ,       58,       16,       42
PHW, 0      , 0      ,        9,        0,        9
PHY, 0.46154, 0.21302,       26,       12,       14
PH_, 0      , 0      ,        5,        0,        5
PIP, 0      , 0      ,       31,        0,       31
PIQ, 0      , 0      ,       47,        0,       47
PIR, 0.23913, 0.05718,       46,       11,       35
PIS, 0.06024, 0.00363,       83,        5,       78
PIT, 0.13725, 0.01884,       51,        7,       44
PIV, 0.0119 , 0.00014,       84,        1,       83
PIW, 0      , 0      ,       14,        0,       14
PIY, 0.06061, 0.00367,       33,        2,       31
PI_, 0      , 0      ,        6,        0,        6
PKP, 0.40909, 0.16736,       44,       18,       26
PKQ, 0.24324, 0.05917,       74,       18,       56
PKR, 0.24419, 0.05963,       86,       21,       65
PKS, 0.45205, 0.20435,       73,       33,       40
PKT, 0.22727, 0.05165,       88,       20,       68
PKV, 0.08889, 0.0079 ,       90,        8,       82
PKW, 0      , 0      ,       25,        0,       25
PKY, 0.19149, 0.03667,       47,        9,       38
PK_, 0      , 0      ,       22,        0,       22
PLP, 0.05556, 0.00309,       72,        4,       68
PLQ, 0.09877, 0.00975,       81,        8,       73
PLR, 0.07874, 0.0062 ,      127,       10,      117
PLS, 0.05426, 0.00294,      129,        7,      122
PLT, 0.02586, 0.00067,      116,        3,      113
PLV, 0.00943, 0.00009,      106,        1,      105
PLW, 0.02941, 0.00087,       34,        1,       33
PLY, 0.0303 , 0.00092,       66,        2,       64
PL_, 0      , 0      ,       14,        0,       14
PMP, 0      , 0      ,        2,        0,        2
PMQ, 0.08696, 0.00756,       23,        2,       21
PMR, 0.21739, 0.04726,       23,        5,       18
PMS, 0.05556, 0.00309,       36,        2,       34
PMT, 0      , 0      ,        8,        0,        8
PMV, 0      , 0      ,       43,        0,       43
PMW, 1      , 1      ,        1,        1,        0
PMY, 0      , 0      ,        9,        0,        9
PM_, 0      , 0      ,        8,        0,        8
PNP, 0.1875 , 0.03516,       32,        6,       26
PNQ, 0.03333, 0.00111,       30,        1,       29
PNR, 0.06034, 0.00364,      116,        7,      109
PNS, 0.07333, 0.00538,      150,       11,      139
PNT, 0.07812, 0.0061 ,       64,        5,       59
PNV, 0.05882, 0.00346,       34,        2,       32
PNW, 0.26087, 0.06805,       23,        6,       17
PNY, 0.05263, 0.00277,       38,        2,       36
PN_, 0.15385, 0.02367,       13,        2,       11
PPP, 0.02703, 0.00073,       37,        1,       36
PPQ, 0.10417, 0.01085,       48,        5,       43
PPR, 0.09677, 0.00937,       31,        3,       28
PPS, 0.1    , 0.01   ,       60,        6,       54
PPT, 0      , 0      ,       49,        0,       49
PPV, 0.1194 , 0.01426,       67,        8,       59
PPW, 0      , 0      ,       14,        0,       14
PPY, 0.09677, 0.00937,       31,        3,       28
PP_, 0      , 0      ,        2,        0,        2
PQP, 0      , 0      ,       12,        0,       12
PQQ, 0.11321, 0.01282,       53,        6,       47
PQR, 0.07547, 0.0057 ,       53,        4,       49
PQS, 0.14286, 0.02041,       42,        6,       36
PQT, 0.10526, 0.01108,       76,        8,       68
PQV, 0.03252, 0.00106,      123,        4,      119
PQW, 0.25   , 0.0625 ,       16,        4,       12
PQY, 0      , 0      ,       31,        0,       31
PQ_, 0      , 0      ,        5,        0,        5
PRP, 0.16129, 0.02601,       31,        5,       26
PRQ, 0.16667, 0.02778,       54,        9,       45
PRR, 0.21505, 0.04625,       93,       20,       73
PRS, 0.21622, 0.04675,       74,       16,       58
PRT, 0.30556, 0.09336,       72,       22,       50
PRV, 0.12871, 0.01657,      101,       13,       88
PRW, 0.30769, 0.09467,       13,        4,        9
PRY, 0.29167, 0.08507,       48,       14,       34
PR_, 0.17647, 0.03114,       17,        3,       14
PSP, 0.41026, 0.16831,       39,       16,       23
PSQ, 0.18182, 0.03306,       33,        6,       27
PSR, 0.1375 , 0.01891,       80,       11,       69
PSS, 0.11111, 0.01235,       90,       10,       80
PST, 0.07273, 0.00529,       55,        4,       51
PSV, 0.04839, 0.00234,      124,        6,      118
PSW, 0.16667, 0.02778,       36,        6,       30
PSY, 0.18519, 0.03429,       54,       10,       44
PS_, 0      , 0      ,       17,        0,       17
PTP, 0      , 0      ,       45,        0,       45
PTQ, 0.08333, 0.00694,       12,        1,       11
PTR, 0.29167, 0.08507,       48,       14,       34
PTS, 0.16393, 0.02687,       61,       10,       51
PTT, 0.16667, 0.02778,       30,        5,       25
PTV, 0.11732, 0.01376,      179,       21,      158
PTW, 0      , 0      ,       22,        0,       22
PTY, 0.08333, 0.00694,       60,        5,       55
PT_, 0      , 0      ,        4,        0,        4
PVP, 0.03125, 0.00098,       32,        1,       31
PVQ, 0      , 0      ,       41,        0,       41
PVR, 0.03488, 0.00122,       86,        3,       83
PVS, 0.09167, 0.0084 ,      120,       11,      109
PVT, 0.025  , 0.00063,       80,        2,       78
PVV, 0.01205, 0.00015,       83,        1,       82
PVW, 0      , 0      ,       22,        0,       22
PVY, 0      , 0      ,       58,        0,       58
PV_, 0      , 0      ,       25,        0,       25
PWP, 0      , 0      ,        9,        0,        9
PWQ, 0.16667, 0.02778,       12,        2,       10
PWR, 0.125  , 0.01562,       32,        4,       28
PWS, 0.16667, 0.02778,       18,        3,       15
PWT, 0      , 0      ,       17,        0,       17
PWV, 0.16667, 0.02778,       12,        2,       10
PWW, 0      , 0      ,        9,        0,        9
PWY, 0.2    , 0.04   ,       15,        3,       12
PYP, 0.14286, 0.02041,       14,        2,       12
PYQ, 0.32258, 0.10406,       31,       10,       21
PYR, 0.15152, 0.02296,       33,        5,       28
PYS, 0.275  , 0.07563,       40,       11,       29
PYT, 0.08696, 0.00756,       23,        2,       21
PYV, 0.175  , 0.03062,       80,       14,       66
PYW, 0      , 0      ,        7,        0,        7
PYY, 0.07692, 0.00592,       26,        2,       24
PY_, 0      , 0      ,        6,        0,        6
QAQ, 0      , 0      ,       45,        0,       45
QAR, 0.05195, 0.0027 ,       77,        4,       73
QAS, 0.16667, 0.02778,       36,        6,       30
QAT, 0.02564, 0.00066,       39,        1,       38
QAV, 0.39073, 0.15267,      151,       59,       92
QAW, 0.05556, 0.00309,       18,        1,       17
QAY, 0.09091, 0.00826,       44,        4,       40
QA_, 0      , 0      ,        4,        0,        4
QCQ, 0      , 0      ,       11,        0,       11
QCR, 0      , 0      ,       15,        0,       15
QCS, 0      , 0      ,        5,        0,        5
QCT, 0      , 0      ,        5,        0,        5
QCV, 0      , 0      ,       12,        0,       12
QCW, 0      , 0      ,        8,        0,        8
QCY, 0      , 0      ,        8,        0,        8
QDQ, 0      , 0      ,       14,        0,       14
QDR, 0.08451, 0.00714,       71,        6,       65
QDS, 0.06897, 0.00476,       29,        2,       27
QDT, 0.10145, 0.01029,       69,        7,       62
QDV, 0      , 0      ,       80,        0,       80
QDW, 0      , 0      ,        9,        0,        9
QDY, 0      , 0      ,       30,        0,       30
QD_, 0      , 0      ,        1,        0,        1
QEQ, 0      , 0      ,       36,        0,       36
QER, 0      , 0      ,       97,        0,       97
QES, 0.01389, 0.00019,       72,        1,       71
QET, 0.02222, 0.00049,       45,        1,       44
QEV, 0.02128, 0.00045,      141,        3,      138
QEW, 0      , 0      ,        4,        0,        4
QEY, 0.05556, 0.00309,       54,        3,       51
QE_, 0      , 0      ,        8,        0,        8
QFQ, 0.16667, 0.02778,        6,        1,        5
QFR, 0.075  , 0.00562,       40,        3,       37
QFS, 0.10959, 0.01201,       73,        8,       65
QFT, 0      , 0      ,       19,        0,       19
QFV, 0.04348, 0.00189,       46,        2,       44
QFW, 0      , 0      ,       34,        0,       34
QFY, 0      , 0      ,       16,        0,       16
QF_, 0      , 0      ,        1,        0,        1
QGQ, 0.03704, 0.00137,       54,        2,       52
QGR, 0.15493, 0.024  ,       71,       11,       60
QGS, 0.04348, 0.00189,       46,        2,       44
QGT, 0.2449 , 0.05998,       49,       12,       37
QGV, 0.04688, 0.0022 ,       64,        3,       61
QGW, 0      , 0      ,       17,        0,       17
QGY, 0.09375, 0.00879,       32,        3,       29
QG_, 0.07692, 0.00592,       13,        1,       12
QHQ, 0.2    , 0.04   ,        5,        1,        4
QHR, 0.48148, 0.23182,       54,       26,       28
QHS, 0.46667, 0.21778,       15,        7,        8
QHT, 0.10811, 0.01169,       37,        4,       33
QHV, 0.16279, 0.0265 ,       43,        7,       36
QHW, 0      , 0      ,        1,        0,        1
QHY, 0.24   , 0.0576 ,       25,        6,       19
QH_, 0      , 0      ,        2,        0,        2
QIQ, 0.2    , 0.04   ,       30,        6,       24
QIR, 0.01786, 0.00032,       56,        1,       55
QIS, 0.04054, 0.00164,       74,        3,       71
QIT, 0.12903, 0.01665,       62,        8,       54
QIV, 0.0678 , 0.0046 ,       59,        4,       55
QIW, 0.15385, 0.02367,       13,        2,       11
QIY, 0      , 0      ,       19,        0,       19
QI_, 1      , 1      ,        2,        2,        0
QKQ, 0.08696, 0.00756,       23,        2,       21
QKR, 0.09877, 0.00975,       81,        8,       73
QKS, 0.23333, 0.05444,       60,       14,       46
QKT, 0.21277, 0.04527,       47,       10,       37
QKV, 0.25773, 0.06643,       97,       25,       72
QKW, 0.10526, 0.01108,       19,        2,       17
QKY, 0.36842, 0.13573,       38,       14,       24
QK_, 0      , 0      ,       10,        0,       10
QLQ, 0      , 0      ,       40,        0,       40
QLR, 0.08759, 0.00767,      137,       12,      125
QLS, 0.08075, 0.00652,      161,       13,      148
QLT, 0.0241 , 0.00058,       83,        2,       81
QLV, 0.0098 , 0.0001 ,      102,        1,      101
QLW, 0.32653, 0.10662,       49,       16,       33
QLY, 0.025  , 0.00063,       40,        1,       39
QL_, 0      , 0      ,        3,        0,        3
QMQ, 0.66667, 0.44444,        3,        2,        1
QMR, 0.2    , 0.04   ,       30,        6,       24
QMS, 0.14286, 0.02041,       21,        3,       18
QMT, 0.12   , 0.0144 ,       25,        3,       22
QMV, 0.05128, 0.00263,       39,        2,       37
QMW, 0      , 0      ,        4,        0,        4
QMY, 0      , 0      ,        3,        0,        3
QM_, 0.33333, 0.11111,       18,        6,       12
QNQ, 0.2    , 0.04   ,       10,        2,        8
QNR, 0.41538, 0.17254,       65,       27,       38
QNS, 0.16667, 0.02778,       36,        6,       30
QNT, 0.11111, 0.01235,       45,        5,       40
QNV, 0      , 0      ,       54,        0,       54
QNW, 0.16667, 0.02778,       24,        4,       20
QNY, 0      , 0      ,       25,        0,       25
QN_, 0.25   , 0.0625 ,       12,        3,        9
QPQ, 0      , 0      ,       23,        0,       23
QPR, 0.125  , 0.01562,       32,        4,       28
QPS, 0.17778, 0.0316 ,       45,        8,       37
QPT, 0      , 0      ,       52,        0,       52
QPV, 0      , 0      ,       72,        0,       72
QPW, 0      , 0      ,        6,        0,        6
QPY, 0      , 0      ,       12,        0,       12
QP_, 0      , 0      ,       17,        0,       17
QQQ, 0.10345, 0.0107 ,       29,        3,       26
QQR, 0.05747, 0.0033 ,       87,        5,       82
QQS, 0.03226, 0.00104,       62,        2,       60
QQT, 0.04918, 0.00242,       61,        3,       58
QQV, 0.07018, 0.00492,       57,        4,       53
QQW, 0      , 0      ,       11,        0,       11
QQY, 0      , 0      ,       39,        0,       39
QQ_, 0      , 0      ,        1,        0,        1
QRQ, 0.06897, 0.00476,       29,        2,       27
QRR, 0.27619, 0.07628,      105,       29,       76
QRS, 0.36957, 0.13658,       46,       17,       29
QRT, 0.19792, 0.03917,       96,       19,       77
QRV, 0.19847, 0.03939,      131,       26,      105
QRW, 0.48718, 0.23734,       39,       19,       20
QRY, 0.6    , 0.36   ,      115,       69,       46
QR_, 0.33333, 0.11111,        3,        1,        2
QSQ, 0.33333, 0.11111,       12,        4,        8
QSR, 0.10448, 0.01092,       67,        7,       60
QSS, 0.16364, 0.02678,       55,        9,       46
QST, 0.28571, 0.08163,       49,       14,       35
QSV, 0.10345, 0.0107 ,       87,        9,       78
QSW, 0.06452, 0.00416,       31,        2,       29
QSY, 0.1    , 0.01   ,      120,       12,      108
QS_, 0      , 0      ,        6,        0,        6
QTQ, 0      , 0      ,        9,        0,        9
QTR, 0.18966, 0.03597,       58,       11,       47
QTS, 0.29787, 0.08873,       47,       14,       33
QTT, 0.23256, 0.05408,       43,       10,       33
QTV, 0.31944, 0.10204,       72,       23,       49
QTW, 0.25   , 0.0625 ,        8,        2,        6
QTY, 0.28571, 0.08163,       42,       12,       30
QT_, 0.42857, 0.18367,        7,        3,        4
QVQ, 0      , 0      ,       13,        0,       13
QVR, 0.01333, 0.00018,       75,        1,       74
QVS, 0.22535, 0.05078,       71,       16,       55
QVT, 0      , 0      ,       35,        0,       35
QVV, 0      , 0      ,       58,        0,       58
QVW, 0.11111, 0.01235,       18,        2,       16
QVY, 0      , 0      ,       27,        0,       27
QV_, 0      , 0      ,        2,        0,        2
QWQ, 0      , 0      ,       10,        0,       10
QWR, 0      , 0      ,       14,        0,       14
QWS, 0.21053, 0.04432,       19,        4,       15
QWT, 0      , 0      ,       12,        0,       12
QWV, 0.4    , 0.16   ,       25,       10,       15
QWW, 0      , 0      ,        1,        0,        1
QWY, 0.41667, 0.17361,       12,        5,        7
QYQ, 0.2    , 0.04   ,       10,        2,        8
QYR, 0.07143, 0.0051 ,       42,        3,       39
QYS, 0.375  , 0.14062,       24,        9,       15
QYT, 0.02941, 0.00087,       34,        1,       33
QYV, 0.07692, 0.00592,       52,        4,       48
QYW, 0      , 0      ,       15,        0,       15
QYY, 0.07692, 0.00592,       26,        2,       24
QY_, 0      , 0      ,        7,        0,        7
RAR, 0.16393, 0.02687,       61,       10,       51
RAS, 0.14062, 0.01978,      128,       18,      110
RAT, 0.05512, 0.00304,      127,        7,      120
RAV, 0.03865, 0.00149,      207,        8,      199
RAW, 0.11111, 0.01235,       36,        4,       32
RAY, 0.06667, 0.00444,       60,        4,       56
RA_, 0      , 0      ,       11,        0,       11
RCR, 0.125  , 0.01562,        8,        1,        7
RCS, 0.15789, 0.02493,       19,        3,       16
RCT, 0      , 0      ,       11,        0,       11
RCV, 0.02381, 0.00057,       42,        1,       41
RCY, 0      , 0      ,        6,        0,        6
RDR, 0.17204, 0.0296 ,       93,       16,       77
RDS, 0.125  , 0.01562,       80,       10,       70
RDT, 0.01613, 0.00026,       62,        1,       61
RDV, 0.02273, 0.00052,      132,        3,      129
RDW, 0.13889, 0.01929,       36,        5,       31
RDY, 0.05263, 0.00277,       57,        3,       54
RD_, 0      , 0      ,        5,        0,        5
RER, 0.11905, 0.01417,      126,       15,      111
RES, 0.11258, 0.01267,      151,       17,      134
RET, 0.048  , 0.0023 ,      125,        6,      119
REV, 0.05028, 0.00253,      179,        9,      170
REW, 0      , 0      ,       44,        0,       44
REY, 0.01942, 0.00038,      103,        2,      101
RE_, 0      , 0      ,        8,        0,        8
RFR, 0.32143, 0.10332,       28,        9,       19
RFS, 0.13235, 0.01752,       68,        9,       59
RFT, 0.27692, 0.07669,       65,       18,       47
RFV, 0.0297 , 0.00088,      101,        3,       98
RFW, 0      , 0      ,       14,        0,       14
RFY, 0.17778, 0.0316 ,       45,        8,       37
RF_, 0      , 0      ,        4,        0,        4
RGR, 0.13953, 0.01947,       43,        6,       37
RGS, 0.17925, 0.03213,      106,       19,       87
RGT, 0.22892, 0.0524 ,       83,       19,       64
RGV, 0.14379, 0.02068,      153,       22,      131
RGW, 0.125  , 0.01562,       32,        4,       28
RGY, 0.09615, 0.00925,      104,       10,       94
RG_, 0      , 0      ,       19,        0,       19
RHR, 0.24138, 0.05826,       29,        7,       22
RHS, 0.13158, 0.01731,       38,        5,       33
RHT, 0.10714, 0.01148,       28,        3,       25
RHV, 0.26471, 0.07007,       34,        9,       25
RHW, 0.26923, 0.07249,       26,        7,       19
RHY, 0.12   , 0.0144 ,       25,        3,       22
RH_, 0      , 0      ,        8,        0,        8
RIR, 0      , 0      ,       43,        0,       43
RIS, 0.07273, 0.00529,      110,        8,      102
RIT, 0.03125, 0.00098,       64,        2,       62
RIV, 0      , 0      ,      125,        0,      125
RIW, 0      , 0      ,       15,        0,       15
RIY, 0.03846, 0.00148,       52,        2,       50
RI_, 0      , 0      ,        9,        0,        9
RKR, 0.27907, 0.07788,       86,       24,       62
RKS, 0.29851, 0.08911,      134,       40,       94
RKT, 0.26866, 0.07218,       67,       18,       49
RKV, 0.12143, 0.01474,      140,       17,      123
RKW, 0.06452, 0.00416,       31,        2,       29
RKY, 0.1    , 0.01   ,       60,        6,       54
RK_, 0.375  , 0.14062,       16,        6,       10
RLR, 0      , 0      ,       84,        0,       84
RLS, 0.0979 , 0.00958,      143,       14,      129
RLT, 0.03571, 0.00128,      140,        5,      135
RLV, 0.10448, 0.01092,      201,       21,      180
RLW, 0      , 0      ,       42,        0,       42
RLY, 0.06667, 0.00444,      105,        7,       98
RL_, 0.25   , 0.0625 ,       16,        4,       12
RMR, 0.15385, 0.02367,       26,        4,       22
RMS, 0.22581, 0.05099,       31,        7,       24
RMT, 0.44444, 0.19753,       36,       16,       20
RMV, 0.04762, 0.00227,       42,        2,       40
RMW, 0.05882, 0.00346,       17,        1,       16
RMY, 0.31818, 0.10124,       22,        7,       15
RM_, 0.05   , 0.0025 ,       20,        1,       19
RNR, 0.35185, 0.1238 ,       54,       19,       35
RNS, 0.20652, 0.04265,       92,       19,       73
RNT, 0.11364, 0.01291,       44,        5,       39
RNV, 0.16092, 0.0259 ,       87,       14,       73
RNW, 0      , 0      ,       15,        0,       15
RNY, 0.16216, 0.0263 ,       37,        6,       31
RN_, 0.11111, 0.01235,        9,        1,        8
RPR, 0.30303, 0.09183,       33,       10,       23
RPS, 0.0411 , 0.00169,       73,        3,       70
RPT, 0.16667, 0.02778,       54,        9,       45
RPV, 0.04   , 0.0016 ,      100,        4,       96
RPW, 0.18182, 0.03306,       22,        4,       18
RPY, 0.06452, 0.00416,       31,        2,       29
RP_, 0      , 0      ,       16,        0,       16
RQR, 0.17857, 0.03189,       56,       10,       46
RQS, 0.05952, 0.00354,      168,       10,      158
RQT, 0.27273, 0.07438,       33,        9,       24
RQV, 0.1875 , 0.03516,      128,       24,      104
RQW, 0.21875, 0.04785,       32,        7,       25
RQY, 0.10526, 0.01108,       57,        6,       51
RQ_, 0      , 0      ,        1,        0,        1
RRR, 0.30435, 0.09263,       92,       28,       64
RRS, 0.30579, 0.0935 ,      121,       37,       84
RRT, 0.39062, 0.15259,      128,       50,       78
RRV, 0.14851, 0.02206,      202,       30,      172
RRW, 0.1    , 0.01   ,       50,        5,       45
RRY, 0.34783, 0.12098,       92,       32,       60
RR_, 0.30769, 0.09467,       13,        4,        9
RSR, 0.12121, 0.01469,       66,        8,       58
RSS, 0.13333, 0.01778,      105,       14,       91
RST, 0.10909, 0.0119 ,      110,       12,       98
RSV, 0.10791, 0.01165,      139,       15,      124
RSW, 0.03333, 0.00111,       30,        1,       29
RSY, 0.0082 , 0.00007,      122,        1,      121
RS_, 0.86364, 0.74587,       66,       57,        9
RTR, 0.09302, 0.00865,       43,        4,       39
RTS, 0.15625, 0.02441,       64,       10,       54
RTT, 0.32836, 0.10782,       67,       22,       45
RTV, 0.26289, 0.06911,      194,       51,      143
RTW, 0.18182, 0.03306,       22,        4,       18
RTY, 0.01961, 0.00038,       51,        1,       50
RVR, 0.06557, 0.0043 ,       61,        4,       57
RVS, 0.24419, 0.05963,       86,       21,       65
RVT, 0.18681, 0.0349 ,       91,       17,       74
RVV, 0.05063, 0.00256,      158,        8,      150
RVW, 0.25714, 0.06612,       35,        9,       26
RVY, 0.11111, 0.01235,       27,        3,       24
RV_, 0      , 0      ,       10,        0,       10
RWR, 0.11111, 0.01235,       18,        2,       16
RWS, 0      , 0      ,        8,        0,        8
RWT, 0.32353, 0.10467,       34,       11,       23
RWV, 0.07547, 0.0057 ,       53,        4,       49
RWW, 0.5    , 0.25   ,        6,        3,        3
RWY, 0      , 0      ,       11,        0,       11
RW_, 0      , 0      ,        1,        0,        1
RYR, 0.125  , 0.01562,       32,        4,       28
RYS, 0.03226, 0.00104,       62,        2,       60
RYT, 0.11864, 0.01408,       59,        7,       52
RYV, 0.23077, 0.05325,       91,       21,       70
RYW, 0      , 0      ,        4,        0,        4
RYY, 0.50877, 0.25885,       57,       29,       28
RY_, 0      , 0      ,        3,        0,        3
SAS, 0.12281, 0.01508,       57,        7,       50
SAT, 0.12621, 0.01593,      103,       13,       90
SAV, 0.05462, 0.00298,      238,       13,      225
SAW, 0.1    , 0.01   ,       10,        1,        9
SAY, 0.04839, 0.00234,       62,        3,       59
SA_, 0      , 0      ,       10,        0,       10
SCS, 0.4    , 0.16   ,        5,        2,        3
SCT, 0.2    , 0.04   ,       35,        7,       28
SCV, 0      , 0      ,       38,        0,       38
SCW, 0      , 0      ,        3,        0,        3
SCY, 0      , 0      ,        1,        0,        1
SDS, 0.09677, 0.00937,       62,        6,       56
SDT, 0.03704, 0.00137,       81,        3,       78
SDV, 0.06832, 0.00467,      161,       11,      150
SDW, 0      , 0      ,       33,        0,       33
SDY, 0      , 0      ,       74,        0,       74
SD_, 0      , 0      ,        8,        0,        8
SES, 0      , 0      ,       37,        0,       37
SET, 0      , 0      ,      112,        0,      112
SEV, 0.09565, 0.00915,      115,       11,      104
SEW, 0      , 0      ,       38,        0,       38
SEY, 0.04225, 0.00179,       71,        3,       68
SE_, 0      , 0      ,        3,        0,        3
SFS, 0.26829, 0.07198,       41,       11,       30
SFT, 0.16949, 0.02873,       59,       10,       49
SFV, 0.07143, 0.0051 ,       84,        6,       78
SFW, 0      , 0      ,        3,        0,        3
SFY, 0.06742, 0.00454,       89,        6,       83
SF_, 0      , 0      ,        1,        0,        1
SGS, 0.17742, 0.03148,       62,       11,       51
SGT, 0.03825, 0.00146,      183,        7,      176
SGV, 0.03061, 0.00094,       98,        3,       95
SGW, 0.02941, 0.00087,       34,        1,       33
SGY, 0.22642, 0.05126,       53,       12,       41
SG_, 0.12121, 0.01469,       33,        4,       29
SHS, 0      , 0      ,       17,        0,       17
SHT, 0.08889, 0.0079 ,       45,        4,       41
SHV, 0.05063, 0.00256,       79,        4,       75
SHW, 0      , 0      ,        6,        0,        6
SHY, 0.22727, 0.05165,       22,        5,       17
SIS, 0.17143, 0.02939,       35,        6,       29
SIT, 0.10145, 0.01029,       69,        7,       62
SIV, 0      , 0      ,       77,        0,       77
SIW, 0.03125, 0.00098,       32,        1,       31
SIY, 0.04587, 0.0021 ,      109,        5,      104
SI_, 0      , 0      ,       12,        0,       12
SKS, 0.23256, 0.05408,       43,       10,       33
SKT, 0.4381 , 0.19193,      105,       46,       59
SKV, 0.29032, 0.08429,      124,       36,       88
SKW, 0.11765, 0.01384,       34,        4,       30
SKY, 0.16667, 0.02778,       84,       14,       70
SK_, 0.05405, 0.00292,       37,        2,       35
SLS, 0.0404 , 0.00163,       99,        4,       95
SLT, 0.17778, 0.0316 ,      180,       32,      148
SLV, 0.0068 , 0.00005,      147,        1,      146
SLW, 0.07692, 0.00592,       26,        2,       24
SLY, 0.06034, 0.00364,      116,        7,      109
SL_, 0      , 0      ,        3,        0,        3
SMS, 0.17241, 0.02973,       29,        5,       24
SMT, 0.16216, 0.0263 ,       37,        6,       31
SMV, 0.3    , 0.09   ,       30,        9,       21
SMW, 0      , 0      ,        8,        0,        8
SMY, 0.13636, 0.0186 ,       22,        3,       19
SM_, 0      , 0      ,       21,        0,       21
SNS, 0.16667, 0.02778,       30,        5,       25
SNT, 0.17442, 0.03042,       86,       15,       71
SNV, 0.01714, 0.00029,      175,        3,      172
SNW, 0.08   , 0.0064 ,       25,        2,       23
SNY, 0.11111, 0.01235,       45,        5,       40
SN_, 0      , 0      ,        2,        0,        2
SPS, 0.04444, 0.00198,       45,        2,       43
SPT, 0.1    , 0.01   ,      120,       12,      108
SPV, 0.00552, 0.00003,      181,        1,      180
SPW, 0.05   , 0.0025 ,       20,        1,       19
SPY, 0.05405, 0.00292,       37,        2,       35
SP_, 0      , 0      ,        4,        0,        4
SQS, 0.15789, 0.02493,       38,        6,       32
SQT, 0.21277, 0.04527,       47,       10,       37
SQV, 0.10526, 0.01108,       76,        8,       68
SQW, 0.11765, 0.01384,       17,        2,       15
SQY, 0.46875, 0.21973,       32,       15,       17
SQ_, 0      , 0      ,        1,        0,        1
SRS, 0.66087, 0.43675,      115,       76,       39
SRT, 0.27632, 0.07635,       76,       21,       55
SRV, 0.09286, 0.00862,      140,       13,      127
SRW, 0.125  , 0.01562,       32,        4,       28
SRY, 0.22917, 0.05252,       48,       11,       37
SR_, 0.05882, 0.00346,       17,        1,       16
SSS, 0.01235, 0.00015,       81,        1,       80
SST, 0.23009, 0.05294,      113,       26,       87
SSV, 0.05844, 0.00342,      154,        9,      145
SSW, 0.08   , 0.0064 ,       25,        2,       23
SSY, 0.04918, 0.00242,       61,        3,       58
SS_, 0      , 0      ,       10,        0,       10
STS, 0.2    , 0.04   ,       30,        6,       24
STT, 0.18182, 0.03306,       88,       16,       72
STV, 0.15254, 0.02327,      118,       18,      100
STW, 0.05   , 0.0025 ,       40,        2,       38
STY, 0.20833, 0.0434 ,       72,       15,       57
ST_, 0      , 0      ,       10,        0,       10
SVS, 0.07937, 0.0063 ,       63,        5,       58
SVT, 0.0463 , 0.00214,      108,        5,      103
SVV, 0.03226, 0.00104,       93,        3,       90
SVW, 0.10526, 0.01108,       19,        2,       17
SVY, 0.024  , 0.00058,      125,        3,      122
SV_, 0      , 0      ,        7,        0,        7
SWS, 0.25   , 0.0625 ,       32,        8,       24
SWT, 0.37931, 0.14388,       29,       11,       18
SWV, 0.13793, 0.01902,       29,        4,       25
SWW, 0      , 0      ,        5,        0,        5
SWY, 0      , 0      ,        7,        0,        7
SYS, 0.03922, 0.00154,      102,        4,       98
SYT, 0.04348, 0.00189,       69,        3,       66
SYV, 0.27273, 0.07438,       55,       15,       40
SYW, 0      , 0      ,       14,        0,       14
SYY, 0.20513, 0.04208,       39,        8,       31
SY_, 0      , 0      ,        5,        0,        5
TAT, 0.06061, 0.00367,       33,        2,       31
TAV, 0      , 0      ,       88,        0,       88
TAW, 0      , 0      ,       29,        0,       29
TAY, 0.14286, 0.02041,       49,        7,       42
TA_, 0      , 0      ,        3,        0,        3
TCT, 0.14286, 0.02041,        7,        1,        6
TCV, 0      , 0      ,       19,        0,       19
TCW, 0      , 0      ,        2,        0,        2
TCY, 0      , 0      ,        9,        0,        9
TDT, 0.11429, 0.01306,       35,        4,       31
TDV, 0.03774, 0.00142,       53,        2,       51
TDW, 0.07692, 0.00592,       26,        2,       24
TDY, 0.04348, 0.00189,       69,        3,       66
TD_, 0      , 0      ,        3,        0,        3
TET, 0      , 0      ,       24,        0,       24
TEV, 0.03974, 0.00158,      151,        6,      145
TEW, 0      , 0      ,       36,        0,       36
TEY, 0      , 0      ,       55,        0,       55
TE_, 0      , 0      ,        6,        0,        6
TFT, 0.2069 , 0.04281,       29,        6,       23
TFV, 0.06557, 0.0043 ,       61,        4,       57
TFW, 0      , 0      ,        5,        0,        5
TFY, 0      , 0      ,       35,        0,       35
TF_, 0      , 0      ,        6,        0,        6
TGT, 0.19355, 0.03746,       31,        6,       25
TGV, 0.11607, 0.01347,      112,       13,       99
TGW, 0.13636, 0.0186 ,       22,        3,       19
TGY, 0.01923, 0.00037,      104,        2,      102
TG_, 0      , 0      ,        6,        0,        6
THT, 0.03448, 0.00119,       29,        1,       28
THV, 0.02222, 0.00049,       45,        1,       44
THW, 0      , 0      ,       13,        0,       13
THY, 0.11111, 0.01235,        9,        1,        8
TH_, 0      , 0      ,        1,        0,        1
TIT, 0.13793, 0.01902,       58,        8,       50
TIV, 0.05357, 0.00287,       56,        3,       53
TIW, 0.41667, 0.17361,       12,        5,        7
TIY, 0.08571, 0.00735,       35,        3,       32
TI_, 0      , 0      ,        1,        0,        1
TKT, 0.4186 , 0.17523,       43,       18,       25
TKV, 0.19048, 0.03628,      105,       20,       85
TKW, 0.20833, 0.0434 ,       24,        5,       19
TKY, 0.01961, 0.00038,       51,        1,       50
TK_, 0      , 0      ,        8,        0,        8
TLT, 0.04819, 0.00232,       83,        4,       79
TLV, 0      , 0      ,      141,        0,      141
TLW, 0.2381 , 0.05669,       21,        5,       16
TLY, 0.03226, 0.00104,       62,        2,       60
TL_, 0      , 0      ,        4,        0,        4
TMT, 0      , 0      ,       11,        0,       11
TMV, 0      , 0      ,       17,        0,       17
TMW, 0      , 0      ,        4,        0,        4
TMY, 0.1    , 0.01   ,       10,        1,        9
TM_, 0      , 0      ,        7,        0,        7
TNT, 0.2069 , 0.04281,       29,        6,       23
TNV, 0.48462, 0.23485,      130,       63,       67
TNW, 0.26087, 0.06805,       23,        6,       17
TNY, 0.12821, 0.01644,       39,        5,       34
TN_, 0      , 0      ,        4,        0,        4
TPT, 0      , 0      ,       14,        0,       14
TPV, 0.08989, 0.00808,       89,        8,       81
TPW, 0      , 0      ,        6,        0,        6
TPY, 0.10811, 0.01169,       37,        4,       33
TP_, 0      , 0      ,        4,        0,        4
TQT, 0.39394, 0.15519,       33,       13,       20
TQV, 0.1    , 0.01   ,       60,        6,       54
TQW, 0.2    , 0.04   ,        5,        1,        4
TQY, 0.07407, 0.00549,       81,        6,       75
TQ_, 0      , 0      ,        3,        0,        3
TRT, 0.35135, 0.12345,       37,       13,       24
TRV, 0.18667, 0.03484,      150,       28,      122
TRW, 0.47222, 0.22299,       36,       17,       19
TRY, 0.21311, 0.04542,       61,       13,       48
TR_, 0.71429, 0.5102 ,        7,        5,        2
TST, 0.10714, 0.01148,       56,        6,       50
TSV, 0.04762, 0.00227,      147,        7,      140
TSW, 0      , 0      ,       11,        0,       11
TSY, 0.15278, 0.02334,       72,       11,       61
TS_, 0      , 0      ,       13,        0,       13
TTT, 0.03922, 0.00154,       51,        2,       49
TTV, 0.05882, 0.00346,       68,        4,       64
TTW, 0      , 0      ,        8,        0,        8
TTY, 0.07407, 0.00549,       27,        2,       25
TVT, 0.04545, 0.00207,       44,        2,       42
TVV, 0.01031, 0.00011,       97,        1,       96
TVW, 0.125  , 0.01562,       16,        2,       14
TVY, 0.02632, 0.00069,       38,        1,       37
TV_, 0      , 0      ,        5,        0,        5
TWT, 0.21429, 0.04592,       14,        3,       11
TWV, 0.08824, 0.00779,       34,        3,       31
TWW, 0.5    , 0.25   ,        8,        4,        4
TWY, 0.10526, 0.01108,       19,        2,       17
TYT, 0.39474, 0.15582,       38,       15,       23
TYV, 0.27907, 0.07788,       43,       12,       31
TYW, 0.08696, 0.00756,       23,        2,       21
TYY, 0.13333, 0.01778,       30,        4,       26
TY_, 0      , 0      ,        2,        0,        2
VAV, 0.06818, 0.00465,       44,        3,       41
VAW, 0      , 0      ,       14,        0,       14
VAY, 0      , 0      ,       51,        0,       51
VA_, 0.125  , 0.01562,        8,        1,        7
VCV, 0      , 0      ,        8,        0,        8
VCW, 1      , 1      ,        6,        6,        0
VCY, 0.25   , 0.0625 ,        8,        2,        6
VDV, 0.06061, 0.00367,       99,        6,       93
VDW, 0      , 0      ,       26,        0,       26
VDY, 0      , 0      ,       52,        0,       52
VD_, 0      , 0      ,        4,        0,        4
VEV, 0.04167, 0.00174,       96,        4,       92
VEW, 0.18182, 0.03306,       22,        4,       18
VEY, 0.0274 , 0.00075,       73,        2,       71
VE_, 0      , 0      ,        8,        0,        8
VFV, 0.19512, 0.03807,       41,        8,       33
VFW, 0      , 0      ,        5,        0,        5
VFY, 0      , 0      ,       27,        0,       27
VF_, 0      , 0      ,        4,        0,        4
VGV, 0.15556, 0.0242 ,       45,        7,       38
VGW, 0      , 0      ,       24,        0,       24
VGY, 0      , 0      ,       52,        0,       52
VG_, 0      , 0      ,        8,        0,        8
VHV, 0      , 0      ,       25,        0,       25
VHW, 0.33333, 0.11111,        6,        2,        4
VHY, 0.19512, 0.03807,       41,        8,       33
VH_, 0      , 0      ,        2,        0,        2
VIV, 0      , 0      ,       49,        0,       49
VIW, 0      , 0      ,        7,        0,        7
VIY, 0      , 0      ,       45,        0,       45
VI_, 0      , 0      ,        3,        0,        3
VKV, 0.03571, 0.00128,      112,        4,      108
VKW, 0.125  , 0.01562,       24,        3,       21
VKY, 0.09434, 0.0089 ,      106,       10,       96
VK_, 0.11765, 0.01384,       17,        2,       15
VLV, 0      , 0      ,       90,        0,       90
VLW, 0.12121, 0.01469,       33,        4,       29
VLY, 0      , 0      ,       89,        0,       89
VL_, 0      , 0      ,        6,        0,        6
VMV, 0      , 0      ,       19,        0,       19
VMW, 0      , 0      ,        8,        0,        8
VMY, 0      , 0      ,        8,        0,        8
VM_, 0.07692, 0.00592,       13,        1,       12
VNV, 0.125  , 0.01562,       40,        5,       35
VNW, 0.23529, 0.05536,       17,        4,       13
VNY, 0.02326, 0.00054,       43,        1,       42
VN_, 0      , 0      ,        6,        0,        6
VPV, 0      , 0      ,       87,        0,       87
VPW, 0      , 0      ,        7,        0,        7
VPY, 0.02439, 0.00059,       41,        1,       40
VP_, 0      , 0      ,       11,        0,       11
VQV, 0.15556, 0.0242 ,       45,        7,       38
VQW, 0      , 0      ,       14,        0,       14
VQY, 0.25333, 0.06418,       75,       19,       56
VQ_, 0.18182, 0.03306,       11,        2,        9
VRV, 0.19753, 0.03902,       81,       16,       65
VRW, 0.3    , 0.09   ,       20,        6,       14
VRY, 0.05   , 0.0025 ,       40,        2,       38
VR_, 0      , 0      ,        9,        0,        9
VSV, 0.02899, 0.00084,       69,        2,       67
VSW, 0.23913, 0.05718,       46,       11,       35
VSY, 0.18182, 0.03306,       44,        8,       36
VS_, 0      , 0      ,       85,        0,       85
VTV, 0.05   , 0.0025 ,       60,        3,       57
VTW, 0.05   , 0.0025 ,       40,        2,       38
VTY, 0.02703, 0.00073,       37,        1,       36
VT_, 0.5    , 0.25   ,        6,        3,        3
VVV, 0.02817, 0.00079,       71,        2,       69
VVW, 0      , 0      ,       18,        0,       18
VVY, 0      , 0      ,       47,        0,       47
VV_, 0      , 0      ,        4,        0,        4
VWV, 0.28571, 0.08163,        7,        2,        5
VWY, 0.30769, 0.09467,       13,        4,        9
VYV, 0.31111, 0.09679,       45,       14,       31
VYW, 0.2    , 0.04   ,       15,        3,       12
VYY, 0.26829, 0.07198,       41,       11,       30
WAW, 0      , 0      ,        9,        0,        9
WAY, 0      , 0      ,        6,        0,        6
WA_, 0.5    , 0.25   ,        2,        1,        1
WCY, 0      , 0      ,        2,        0,        2
WC_, 0      , 0      ,        1,        0,        1
WDW, 0      , 0      ,        5,        0,        5
WDY, 0      , 0      ,        4,        0,        4
WEW, 0      , 0      ,        1,        0,        1
WEY, 0      , 0      ,        7,        0,        7
WFW, 0      , 0      ,        2,        0,        2
WFY, 0      , 0      ,       24,        0,       24
WGY, 0      , 0      ,        4,        0,        4
WG_, 0      , 0      ,        8,        0,        8
WHW, 1      , 1      ,        2,        2,        0
WHY, 0      , 0      ,       10,        0,       10
WIY, 0      , 0      ,        6,        0,        6
WKW, 0      , 0      ,       16,        0,       16
WKY, 0.17647, 0.03114,       17,        3,       14
WK_, 0      , 0      ,        3,        0,        3
WLW, 0      , 0      ,        2,        0,        2
WLY, 0      , 0      ,       17,        0,       17
WL_, 0      , 0      ,        1,        0,        1
WNY, 0.33333, 0.11111,        9,        3,        6
WPY, 0      , 0      ,        8,        0,        8
WQY, 0.25   , 0.0625 ,        8,        2,        6
WQ_, 0      , 0      ,        2,        0,        2
WRW, 0      , 0      ,       17,        0,       17
WRY, 0.28125, 0.0791 ,       32,        9,       23
WR_, 0      , 0      ,        6,        0,        6
WSW, 0      , 0      ,        6,        0,        6
WSY, 0      , 0      ,        5,        0,        5
WTY, 0.07407, 0.00549,       27,        2,       25
WT_, 0      , 0      ,        1,        0,        1
WVY, 0      , 0      ,        5,        0,        5
WV_, 1      , 1      ,        1,        1,        0
WWY, 1      , 1      ,        4,        4,        0
WYW, 0      , 0      ,        4,        0,        4
WYY, 0      , 0      ,        5,        0,        5
WY_, 0      , 0      ,        2,        0,        2
YAY, 0.125  , 0.01562,        8,        1,        7
YA_, 0      , 0      ,        7,        0,        7
YDY, 0.03226, 0.00104,       31,        1,       30
YD_, 0      , 0      ,        1,        0,        1
YEY, 0.15789, 0.02493,       19,        3,       16
YE_, 0      , 0      ,        6,        0,        6
YFY, 0      , 0      ,        2,        0,        2
YF_, 0      , 0      ,       17,        0,       17
YGY, 0.3    , 0.09   ,       20,        6,       14
YG_, 0.4    , 0.16   ,        5,        2,        3
YHY, 0.25   , 0.0625 ,       20,        5,       15
YIY, 0      , 0      ,        6,        0,        6
YKY, 0.1    , 0.01   ,       20,        2,       18
YK_, 0.66667, 0.44444,        3,        2,        1
YLY, 0.23529, 0.05536,       17,        4,       13
YL_, 0      , 0      ,       10,        0,       10
YMY, 0      , 0      ,       10,        0,       10
YNY, 0      , 0      ,        9,        0,        9
YN_, 0      , 0      ,        7,        0,        7
YPY, 0      , 0      ,        5,        0,        5
YP_, 0      , 0      ,        4,        0,        4
YQY, 0.04   , 0.0016 ,       25,        1,       24
YQ_, 0      , 0      ,        7,        0,        7
YRY, 0.42857, 0.18367,       35,       15,       20
YR_, 0      , 0      ,        2,        0,        2
YSY, 0.18421, 0.03393,       38,        7,       31
YS_, 0      , 0      ,        6,        0,        6
YTY, 0      , 0      ,        1,        0,        1
YT_, 0      , 0      ,        2,        0,        2
YVY, 0.17143, 0.02939,       35,        6,       29
YV_, 0      , 0      ,        7,        0,        7
YYY, 0.6875 , 0.47266,       32,       22,       10
