key, propensity, propensity^2, count, pos, neg
?A, 0.30435, 0.09263,       23,        7,       16
?C, 0.33333, 0.11111,        6,        2,        4
?D, 0.11111, 0.01235,        9,        1,        8
?E, 0.1    , 0.01   ,       10,        1,        9
?F, 0.33333, 0.11111,        9,        3,        6
?G, 0.15   , 0.0225 ,       20,        3,       17
?H, 0.14286, 0.02041,        7,        1,        6
?I, 0.41176, 0.16955,       17,        7,       10
?K, 0      , 0      ,        7,        0,        7
?L, 0.22581, 0.05099,       31,        7,       24
?M, 0      , 0      ,        7,        0,        7
?N, 0      , 0      ,        5,        0,        5
?P, 0      , 0      ,        7,        0,        7
?Q, 0      , 0      ,       12,        0,       12
?R, 0.125  , 0.01562,        8,        1,        7
?S, 0.07143, 0.0051 ,       14,        1,       13
?T, 0      , 0      ,       11,        0,       11
?V, 0.25   , 0.0625 ,       20,        5,       15
?W, 0.5    , 0.25   ,        2,        1,        1
?Y, 0      , 0      ,       11,        0,       11
?_, 0      , 0      ,        4,        0,        4
A?, 0      , 0      ,       19,        0,       19
AA, 0.00052, 0      ,     3842,        2,     3840
AC, 0.00628, 0.00004,      637,        4,      633
AD, 0.00227, 0.00001,     2639,        6,     2633
AE, 0.00103, 0      ,     2905,        3,     2902
AF, 0.00123, 0      ,     1632,        2,     1630
AG, 0.00132, 0      ,     3034,        4,     3030
AH, 0.00278, 0.00001,     1078,        3,     1075
AI, 0.00131, 0      ,     2298,        3,     2295
AK, 0.00207, 0      ,     2421,        5,     2416
AL, 0.00049, 0      ,     4042,        2,     4040
AM, 0.00218, 0      ,      919,        2,      917
AN, 0.00118, 0      ,     1694,        2,     1692
AP, 0.00159, 0      ,     1890,        3,     1887
AQ, 0.00173, 0      ,     1738,        3,     1735
AR, 0.00091, 0      ,     2188,        2,     2186
AS, 0.00086, 0      ,     2315,        2,     2313
AT, 0.00181, 0      ,     2214,        4,     2210
AV, 0.0014 , 0      ,     2859,        4,     2855
AW, 0.00194, 0      ,      515,        1,      514
AY, 0.00232, 0.00001,     1291,        3,     1288
A_, 0.01031, 0.00011,      194,        2,      192
C?, 0.25   , 0.0625 ,        4,        1,        3
CA, 0.26387, 0.06963,      667,      176,      491
CC, 0.33962, 0.11534,      212,       72,      140
CD, 0.26255, 0.06893,      518,      136,      382
CE, 0.32703, 0.10695,      529,      173,      356
CF, 0.2619 , 0.06859,      378,       99,      279
CG, 0.39211, 0.15375,      760,      298,      462
CH, 0.3065 , 0.09394,      323,       99,      224
CI, 0.26339, 0.06938,      448,      118,      330
CK, 0.41495, 0.17219,      535,      222,      313
CL, 0.23611, 0.05575,      720,      170,      550
CM, 0.24713, 0.06107,      174,       43,      131
CN, 0.39164, 0.15339,      383,      150,      233
CP, 0.4765 , 0.22705,      468,      223,      245
CQ, 0.40568, 0.16458,      387,      157,      230
CR, 0.42678, 0.18214,      478,      204,      274
CS, 0.34185, 0.11686,      626,      214,      412
CT, 0.32998, 0.10889,      497,      164,      333
CV, 0.30147, 0.09088,      544,      164,      380
CW, 0.24638, 0.0607 ,      138,       34,      104
CY, 0.28857, 0.08327,      350,      101,      249
C_, 0.24242, 0.05877,       33,        8,       25
D?, 0      , 0      ,        9,        0,        9
DA, 0.04539, 0.00206,     2842,      129,     2713
DC, 0.05647, 0.00319,      549,       31,      518
DD, 0.04366, 0.00191,     1901,       83,     1818
DE, 0.03233, 0.00105,     2165,       70,     2095
DF, 0.04644, 0.00216,     1701,       79,     1622
DG, 0.06732, 0.00453,     2540,      171,     2369
DH, 0.0644 , 0.00415,      823,       53,      770
DI, 0.05315, 0.00282,     2333,      124,     2209
DK, 0.02891, 0.00084,     2041,       59,     1982
DL, 0.04296, 0.00185,     3445,      148,     3297
DM, 0.04756, 0.00226,      757,       36,      721
DN, 0.05038, 0.00254,     1330,       67,     1263
DP, 0.03813, 0.00145,     1836,       70,     1766
DQ, 0.03711, 0.00138,     1024,       38,      986
DR, 0.03298, 0.00109,     1698,       56,     1642
DS, 0.05944, 0.00353,     1918,      114,     1804
DT, 0.06404, 0.0041 ,     1780,      114,     1666
DV, 0.05527, 0.00306,     2569,      142,     2427
DW, 0.04323, 0.00187,      532,       23,      509
DY, 0.04298, 0.00185,     1396,       60,     1336
D_, 0.02703, 0.00073,      111,        3,      108
E?, 0      , 0      ,       10,        0,       10
EA, 0.04344, 0.00189,     3177,      138,     3039
EC, 0.03608, 0.0013 ,      582,       21,      561
ED, 0.04055, 0.00164,     2170,       88,     2082
EE, 0.04309, 0.00186,     3040,      131,     2909
EF, 0.04417, 0.00195,     1562,       69,     1493
EG, 0.05034, 0.00253,     2642,      133,     2509
EH, 0.06371, 0.00406,      926,       59,      867
EI, 0.04756, 0.00226,     2544,      121,     2423
EK, 0.02647, 0.0007 ,     2833,       75,     2758
EL, 0.03617, 0.00131,     3871,      140,     3731
EM, 0.04747, 0.00225,      948,       45,      903
EN, 0.04065, 0.00165,     1673,       68,     1605
EP, 0.03958, 0.00157,     1794,       71,     1723
EQ, 0.031  , 0.00096,     1516,       47,     1469
ER, 0.02957, 0.00087,     2164,       64,     2100
ES, 0.03566, 0.00127,     1991,       71,     1920
ET, 0.0438 , 0.00192,     1872,       82,     1790
EV, 0.03857, 0.00149,     2826,      109,     2717
EW, 0.03929, 0.00154,      560,       22,      538
EY, 0.03311, 0.0011 ,     1329,       44,     1285
E_, 0.02469, 0.00061,      162,        4,      158
F?, 0      , 0      ,        7,        0,        7
FA, 0.00288, 0.00001,     1734,        5,     1729
FC, 0.01256, 0.00016,      398,        5,      393
FD, 0.00305, 0.00001,     1641,        5,     1636
FE, 0.00332, 0.00001,     1505,        5,     1500
FF, 0.00114, 0      ,      879,        1,      878
FG, 0.00392, 0.00002,     1786,        7,     1779
FH, 0.0015 , 0      ,      666,        1,      665
FI, 0.00087, 0      ,     1156,        1,     1155
FK, 0.00154, 0      ,     1302,        2,     1300
FL, 0.0036 , 0.00001,     1946,        7,     1939
FM, 0      , 0      ,      427,        0,      427
FN, 0.00276, 0.00001,     1086,        3,     1083
FP, 0.00582, 0.00003,     1202,        7,     1195
FQ, 0.0012 , 0      ,      835,        1,      834
FR, 0.0027 , 0.00001,     1110,        3,     1107
FS, 0.00253, 0.00001,     1582,        4,     1578
FT, 0.00214, 0      ,     1401,        3,     1398
FV, 0.00064, 0      ,     1571,        1,     1570
FW, 0.00347, 0.00001,      288,        1,      287
FY, 0.00336, 0.00001,      894,        3,      891
F_, 0.01667, 0.00028,       60,        1,       59
G?, 0      , 0      ,       20,        0,       20
GA, 0.00099, 0      ,     3035,        3,     3032
GC, 0.02973, 0.00088,      740,       22,      718
GD, 0.00166, 0      ,     2412,        4,     2408
GE, 0.00239, 0.00001,     2507,        6,     2501
GF, 0.0012 , 0      ,     1666,        2,     1664
GG, 0.00333, 0.00001,     2704,        9,     2695
GH, 0.00257, 0.00001,     1168,        3,     1165
GI, 0.00095, 0      ,     2103,        2,     2101
GK, 0.00258, 0.00001,     2330,        6,     2324
GL, 0.00029, 0      ,     3396,        1,     3395
GM, 0.00122, 0      ,      820,        1,      819
GN, 0.00218, 0      ,     1838,        4,     1834
GP, 0.00276, 0.00001,     1814,        5,     1809
GQ, 0.00077, 0      ,     1302,        1,     1301
GR, 0.00158, 0      ,     1901,        3,     1898
GS, 0.00316, 0.00001,     2533,        8,     2525
GT, 0.00309, 0.00001,     2268,        7,     2261
GV, 0.00154, 0      ,     2590,        4,     2586
GW, 0.00193, 0      ,      518,        1,      517
GY, 0.00068, 0      ,     1467,        1,     1466
G_, 0.01648, 0.00027,      182,        3,      179
H?, 0      , 0      ,        7,        0,        7
HA, 0.2373 , 0.05631,     1201,      285,      916
HC, 0.22507, 0.05066,      351,       79,      272
HD, 0.20677, 0.04275,      827,      171,      656
HE, 0.23135, 0.05352,      925,      214,      711
HF, 0.20592, 0.0424 ,      709,      146,      563
HG, 0.26972, 0.07275,     1268,      342,      926
HH, 0.23011, 0.05295,      704,      162,      542
HI, 0.21223, 0.04504,      867,      184,      683
HK, 0.18414, 0.03391,      744,      137,      607
HL, 0.20949, 0.04389,     1475,      309,     1166
HM, 0.27174, 0.07384,      368,      100,      268
HN, 0.23469, 0.05508,      588,      138,      450
HP, 0.1736 , 0.03014,      841,      146,      695
HQ, 0.17926, 0.03213,      569,      102,      467
HR, 0.18031, 0.03251,      782,      141,      641
HS, 0.25076, 0.06288,      985,      247,      738
HT, 0.2454 , 0.06022,      815,      200,      615
HV, 0.20459, 0.04186,     1002,      205,      797
HW, 0.22973, 0.05278,      222,       51,      171
HY, 0.19967, 0.03987,      606,      121,      485
H_, 0.24242, 0.05877,       66,       16,       50
I?, 0      , 0      ,       14,        0,       14
IA, 0.0012 , 0      ,     2500,        3,     2497
IC, 0.01044, 0.00011,      479,        5,      474
ID, 0.00222, 0      ,     2251,        5,     2246
IE, 0      , 0      ,     2449,        0,     2449
IF, 0.00174, 0      ,     1149,        2,     1147
IG, 0.0013 , 0      ,     2307,        3,     2304
IH, 0.0012 , 0      ,      832,        1,      831
II, 0      , 0      ,     1658,        0,     1658
IK, 0.00097, 0      ,     2053,        2,     2051
IL, 0.00078, 0      ,     2555,        2,     2553
IM, 0.00159, 0      ,      627,        1,      626
IN, 0      , 0      ,     1629,        0,     1629
IP, 0.00534, 0.00003,     1499,        8,     1491
IQ, 0      , 0      ,     1223,        0,     1223
IR, 0.00121, 0      ,     1648,        2,     1646
IS, 0.00208, 0      ,     1923,        4,     1919
IT, 0.00232, 0.00001,     1726,        4,     1722
IV, 0      , 0      ,     2097,        0,     2097
IW, 0      , 0      ,      361,        0,      361
IY, 0      , 0      ,     1057,        0,     1057
I_, 0      , 0      ,       59,        0,       59
K?, 0      , 0      ,        7,        0,        7
KA, 0.00297, 0.00001,     2692,        8,     2684
KC, 0.00176, 0      ,      568,        1,      567
KD, 0.00489, 0.00002,     2044,       10,     2034
KE, 0.00564, 0.00003,     2835,       16,     2819
KF, 0.00515, 0.00003,     1358,        7,     1351
KG, 0.00694, 0.00005,     2449,       17,     2432
KH, 0.01074, 0.00012,      745,        8,      737
KI, 0.00599, 0.00004,     2171,       13,     2158
KK, 0.00419, 0.00002,     2384,       10,     2374
KL, 0.00475, 0.00002,     3579,       17,     3562
KM, 0.00756, 0.00006,      794,        6,      788
KN, 0.0051 , 0.00003,     1568,        8,     1560
KP, 0.00341, 0.00001,     1467,        5,     1462
KQ, 0.00385, 0.00001,     1300,        5,     1295
KR, 0.00452, 0.00002,     1549,        7,     1542
KS, 0.00384, 0.00001,     1822,        7,     1815
KT, 0.00646, 0.00004,     1702,       11,     1691
KV, 0.00676, 0.00005,     2513,       17,     2496
KW, 0.00395, 0.00002,      506,        2,      504
KY, 0.00539, 0.00003,     1299,        7,     1292
K_, 0.01087, 0.00012,      184,        2,      182
L?, 0      , 0      ,       27,        0,       27
LA, 0.00115, 0      ,     4354,        5,     4349
LC, 0.00522, 0.00003,      767,        4,      763
LD, 0.0015 , 0      ,     3342,        5,     3337
LE, 0.00081, 0      ,     3720,        3,     3717
LF, 0.00155, 0      ,     1934,        3,     1931
LG, 0.00028, 0      ,     3610,        1,     3609
LH, 0      , 0      ,     1428,        0,     1428
LI, 0.00193, 0      ,     2592,        5,     2587
LK, 0.00088, 0      ,     3419,        3,     3416
LL, 0.00109, 0      ,     4593,        5,     4588
LM, 0.00093, 0      ,     1075,        1,     1074
LN, 0.00169, 0      ,     2365,        4,     2361
LP, 0.00038, 0      ,     2611,        1,     2610
LQ, 0.00047, 0      ,     2143,        1,     2142
LR, 0.0007 , 0      ,     2847,        2,     2845
LS, 0.00031, 0      ,     3204,        1,     3203
LT, 0.00101, 0      ,     2976,        3,     2973
LV, 0.00058, 0      ,     3476,        2,     3474
LW, 0.00146, 0      ,      685,        1,      684
LY, 0.00114, 0      ,     1755,        2,     1753
L_, 0.02581, 0.00067,      155,        4,      151
M?, 0      , 0      ,        7,        0,        7
MA, 0.00409, 0.00002,      979,        4,      975
MC, 0.02128, 0.00045,      188,        4,      184
MD, 0.00139, 0      ,      722,        1,      721
ME, 0.00444, 0.00002,      900,        4,      896
MF, 0.00229, 0.00001,      436,        1,      435
MG, 0.00561, 0.00003,      891,        5,      886
MH, 0.0289 , 0.00084,      346,       10,      336
MI, 0.00478, 0.00002,      627,        3,      624
MK, 0.00262, 0.00001,      764,        2,      762
ML, 0.00286, 0.00001,     1049,        3,     1046
MM, 0.00329, 0.00001,      304,        1,      303
MN, 0.00189, 0      ,      528,        1,      527
MP, 0.00183, 0      ,      545,        1,      544
MQ, 0.00385, 0.00001,      520,        2,      518
MR, 0.00661, 0.00004,      605,        4,      601
MS, 0.00304, 0.00001,      658,        2,      656
MT, 0.00469, 0.00002,      639,        3,      636
MV, 0.00239, 0.00001,      836,        2,      834
MW, 0      , 0      ,      139,        0,      139
MY, 0.00265, 0.00001,      378,        1,      377
M_, 0.03828, 0.00147,      209,        8,      201
N?, 0      , 0      ,        5,        0,        5
NA, 0.00551, 0.00003,     1814,       10,     1804
NC, 0.02228, 0.0005 ,      404,        9,      395
ND, 0.00531, 0.00003,     1318,        7,     1311
NE, 0.0012 , 0      ,     1665,        2,     1663
NF, 0.00539, 0.00003,     1113,        6,     1107
NG, 0.01348, 0.00018,     1929,       26,     1903
NH, 0.01712, 0.00029,      584,       10,      574
NI, 0.00537, 0.00003,     1677,        9,     1668
NK, 0.00257, 0.00001,     1559,        4,     1555
NL, 0.00454, 0.00002,     2421,       11,     2410
NM, 0.00557, 0.00003,      539,        3,      536
NN, 0.00397, 0.00002,     1260,        5,     1255
NP, 0.0037 , 0.00001,     1351,        5,     1346
NQ, 0.00217, 0      ,      921,        2,      919
NR, 0.00081, 0      ,     1236,        1,     1235
NS, 0.00272, 0.00001,     1469,        4,     1465
NT, 0.00241, 0.00001,     1247,        3,     1244
NV, 0.00333, 0.00001,     1803,        6,     1797
NW, 0      , 0      ,      418,        0,      418
NY, 0.001  , 0      ,     1005,        1,     1004
N_, 0      , 0      ,       88,        0,       88
P?, 0      , 0      ,        7,        0,        7
PA, 0.00051, 0      ,     1956,        1,     1955
PC, 0.01237, 0.00015,      485,        6,      479
PD, 0.00055, 0      ,     1815,        1,     1814
PE, 0.00168, 0      ,     1784,        3,     1781
PF, 0      , 0      ,     1207,        0,     1207
PG, 0.00269, 0.00001,     1856,        5,     1851
PH, 0.00481, 0.00002,      832,        4,      828
PI, 0.00066, 0      ,     1517,        1,     1516
PK, 0.00138, 0      ,     1450,        2,     1448
PL, 0.0019 , 0      ,     2633,        5,     2628
PM, 0.00185, 0      ,      541,        1,      540
PN, 0.00225, 0.00001,     1336,        3,     1333
PP, 0.00169, 0      ,     1185,        2,     1183
PQ, 0.00095, 0      ,     1051,        1,     1050
PR, 0.0016 , 0      ,     1252,        2,     1250
PS, 0.00245, 0.00001,     1630,        4,     1626
PT, 0.00258, 0.00001,     1549,        4,     1545
PV, 0.001  , 0      ,     2006,        2,     2004
PW, 0      , 0      ,      380,        0,      380
PY, 0.0019 , 0      ,     1053,        2,     1051
P_, 0.00826, 0.00007,      121,        1,      120
Q?, 0      , 0      ,       12,        0,       12
QA, 0.00422, 0.00002,     1895,        8,     1887
QC, 0.0119 , 0.00014,      420,        5,      415
QD, 0.00688, 0.00005,     1018,        7,     1011
QE, 0.00528, 0.00003,     1514,        8,     1506
QF, 0.00346, 0.00001,      867,        3,      864
QG, 0.00729, 0.00005,     1371,       10,     1361
QH, 0.00526, 0.00003,      570,        3,      567
QI, 0.00549, 0.00003,     1276,        7,     1269
QK, 0.00154, 0      ,     1295,        2,     1293
QL, 0.00403, 0.00002,     2233,        9,     2224
QM, 0.00735, 0.00005,      544,        4,      540
QN, 0.01082, 0.00012,      924,       10,      914
QP, 0.00378, 0.00001,     1059,        4,     1055
QQ, 0.0122 , 0.00015,      984,       12,      972
QR, 0.00337, 0.00001,     1187,        4,     1183
QS, 0.00598, 0.00004,     1171,        7,     1164
QT, 0.00635, 0.00004,     1103,        7,     1096
QV, 0.00602, 0.00004,     1494,        9,     1485
QW, 0.00522, 0.00003,      383,        2,      381
QY, 0.00238, 0.00001,      839,        2,      837
Q_, 0.01031, 0.00011,       97,        1,       96
R?, 0      , 0      ,        8,        0,        8
RA, 0.00534, 0.00003,     2434,       13,     2421
RC, 0.0117 , 0.00014,      513,        6,      507
RD, 0.00528, 0.00003,     1706,        9,     1697
RE, 0.00417, 0.00002,     2157,        9,     2148
RF, 0.00684, 0.00005,     1170,        8,     1162
RG, 0.00897, 0.00008,     2007,       18,     1989
RH, 0.00505, 0.00003,      792,        4,      788
RI, 0.00852, 0.00007,     1761,       15,     1746
RK, 0.00774, 0.00006,     1551,       12,     1539
RL, 0.00336, 0.00001,     2976,       10,     2966
RM, 0      , 0      ,      644,        0,      644
RN, 0.00401, 0.00002,     1246,        5,     1241
RP, 0.00872, 0.00008,     1261,       11,     1250
RQ, 0.00419, 0.00002,     1193,        5,     1188
RR, 0.00511, 0.00003,     1566,        8,     1558
RS, 0.01006, 0.0001 ,     1591,       16,     1575
RT, 0.00694, 0.00005,     1440,       10,     1430
RV, 0.0046 , 0.00002,     2174,       10,     2164
RW, 0.00641, 0.00004,      468,        3,      465
RY, 0.00742, 0.00006,     1213,        9,     1204
R_, 0.0099 , 0.0001 ,      101,        1,      100
S?, 0      , 0      ,       14,        0,       14
SA, 0.00375, 0.00001,     2399,        9,     2390
SC, 0.01079, 0.00012,      649,        7,      642
SD, 0.00531, 0.00003,     1882,       10,     1872
SE, 0.00306, 0.00001,     1960,        6,     1954
SF, 0.00253, 0.00001,     1583,        4,     1579
SG, 0.00535, 0.00003,     2618,       14,     2604
SH, 0.00737, 0.00005,      950,        7,      943
SI, 0.00261, 0.00001,     1918,        5,     1913
SK, 0.00453, 0.00002,     1765,        8,     1757
SL, 0.00094, 0      ,     3183,        3,     3180
SM, 0.00603, 0.00004,      663,        4,      659
SN, 0.00277, 0.00001,     1443,        4,     1439
SP, 0.00495, 0.00002,     1616,        8,     1608
SQ, 0.00262, 0.00001,     1145,        3,     1142
SR, 0.00193, 0      ,     1551,        3,     1548
SS, 0.00448, 0.00002,     2234,       10,     2224
ST, 0.00405, 0.00002,     1729,        7,     1722
SV, 0.00219, 0      ,     2288,        5,     2283
SW, 0.00409, 0.00002,      489,        2,      487
SY, 0      , 0      ,     1266,        0,     1266
S_, 0.02463, 0.00061,      203,        5,      198
T?, 0      , 0      ,       11,        0,       11
TA, 0.00254, 0.00001,     2360,        6,     2354
TC, 0.00755, 0.00006,      530,        4,      526
TD, 0.00743, 0.00006,     1750,       13,     1737
TE, 0.00217, 0      ,     1843,        4,     1839
TF, 0.00349, 0.00001,     1434,        5,     1429
TG, 0.00295, 0.00001,     2375,        7,     2368
TH, 0.00256, 0.00001,      780,        2,      778
TI, 0.00281, 0.00001,     1779,        5,     1774
TK, 0.00299, 0.00001,     1675,        5,     1670
TL, 0.00231, 0.00001,     3033,        7,     3026
TM, 0      , 0      ,      642,        0,      642
TN, 0.00081, 0      ,     1237,        1,     1236
TP, 0.00388, 0.00002,     1545,        6,     1539
TQ, 0.00278, 0.00001,     1079,        3,     1076
TR, 0.00286, 0.00001,     1401,        4,     1397
TS, 0.00229, 0.00001,     1750,        4,     1746
TT, 0.00179, 0      ,     1674,        3,     1671
TV, 0.00309, 0.00001,     2263,        7,     2256
TW, 0.00474, 0.00002,      422,        2,      420
TY, 0.00357, 0.00001,     1119,        4,     1115
T_, 0.03704, 0.00137,      108,        4,      104
V?, 0      , 0      ,       18,        0,       18
VA, 0.00231, 0.00001,     3031,        7,     3024
VC, 0.00697, 0.00005,      574,        4,      570
VD, 0.00285, 0.00001,     2457,        7,     2450
VE, 0.00037, 0      ,     2667,        1,     2666
VF, 0.00132, 0      ,     1514,        2,     1512
VG, 0.00183, 0      ,     2736,        5,     2731
VH, 0.00327, 0.00001,      917,        3,      914
VI, 0.00096, 0      ,     2075,        2,     2073
VK, 0      , 0      ,     2364,        0,     2364
VL, 0.00089, 0      ,     3366,        3,     3363
VM, 0.00123, 0      ,      811,        1,      810
VN, 0.00175, 0      ,     1717,        3,     1714
VP, 0.00051, 0      ,     1974,        1,     1973
VQ, 0.00072, 0      ,     1395,        1,     1394
VR, 0.00199, 0      ,     2013,        4,     2009
VS, 0.00311, 0.00001,     2254,        7,     2247
VT, 0.00185, 0      ,     2163,        4,     2159
VV, 0.00178, 0      ,     2807,        5,     2802
VW, 0      , 0      ,      466,        0,      466
VY, 0.00077, 0      ,     1301,        1,     1300
V_, 0.01136, 0.00013,       88,        1,       87
W?, 0      , 0      ,        2,        0,        2
WA, 0.00523, 0.00003,      574,        3,      571
WC, 0      , 0      ,      149,        0,      149
WD, 0.01304, 0.00017,      537,        7,      530
WE, 0.00181, 0      ,      554,        1,      553
WF, 0.00334, 0.00001,      299,        1,      298
WG, 0.00349, 0.00001,      573,        2,      571
WH, 0.0045 , 0.00002,      222,        1,      221
WI, 0.00519, 0.00003,      385,        2,      383
WK, 0.00198, 0      ,      504,        1,      503
WL, 0.0042 , 0.00002,      715,        3,      712
WM, 0      , 0      ,      148,        0,      148
WN, 0.00955, 0.00009,      419,        4,      415
WP, 0.00783, 0.00006,      383,        3,      380
WQ, 0      , 0      ,      381,        0,      381
WR, 0.00434, 0.00002,      461,        2,      459
WS, 0.00595, 0.00004,      504,        3,      501
WT, 0.00459, 0.00002,      436,        2,      434
WV, 0.00598, 0.00004,      502,        3,      499
WW, 0      , 0      ,      101,        0,      101
WY, 0.0034 , 0.00001,      294,        1,      293
W_, 0.06667, 0.00444,       15,        1,       14
Y?, 0.09091, 0.00826,       11,        1,       10
YA, 0.00681, 0.00005,     1468,       10,     1458
YC, 0.01542, 0.00024,      389,        6,      383
YD, 0.00577, 0.00003,     1386,        8,     1378
YE, 0.00605, 0.00004,     1322,        8,     1314
YF, 0.00875, 0.00008,      914,        8,      906
YG, 0.00501, 0.00003,     1596,        8,     1588
YH, 0.00824, 0.00007,      607,        5,      602
YI, 0.00353, 0.00001,     1133,        4,     1129
YK, 0.00078, 0      ,     1290,        1,     1289
YL, 0.0027 , 0.00001,     1851,        5,     1846
YM, 0.00998, 0.0001 ,      401,        4,      397
YN, 0.01085, 0.00012,     1014,       11,     1003
YP, 0.00469, 0.00002,     1065,        5,     1060
YQ, 0.00725, 0.00005,      828,        6,      822
YR, 0.0058 , 0.00003,     1206,        7,     1199
YS, 0.00304, 0.00001,     1317,        4,     1313
YT, 0.00175, 0      ,     1140,        2,     1138
YV, 0.00704, 0.00005,     1421,       10,     1411
YW, 0.0034 , 0.00001,      294,        1,      293
YY, 0.00443, 0.00002,      903,        4,      899
Y_, 0      , 0      ,       46,        0,       46
