key, propensity, propensity^2, count, pos, neg
AA, 0.00286, 0.00001,    16445,       47,    16398
AC, 0.00243, 0.00001,     1648,        4,     1644
AD, 0.00438, 0.00002,    11186,       49,    11137
AE, 0.00268, 0.00001,    12305,       33,    12272
AF, 0.00226, 0.00001,     5763,       13,     5750
AG, 0.0057 , 0.00003,    12988,       74,    12914
AH, 0.00753, 0.00006,     3720,       28,     3692
AI, 0.00289, 0.00001,     8637,       25,     8612
AK, 0.00193, 0      ,     8808,       17,     8791
AL, 0.00309, 0.00001,    15526,       48,    15478
AM, 0.0042 , 0.00002,     3571,       15,     3556
AN, 0.00514, 0.00003,     6619,       34,     6585
AP, 0.00361, 0.00001,     7754,       28,     7726
AQ, 0.00317, 0.00001,     6625,       21,     6604
AR, 0.0024 , 0.00001,     9153,       22,     9131
AS, 0.00401, 0.00002,     9236,       37,     9199
AT, 0.00434, 0.00002,     8518,       37,     8481
AV, 0.002  , 0      ,    10516,       21,    10495
AW, 0.0021 , 0      ,     1905,        4,     1901
AY, 0.00289, 0.00001,     4500,       13,     4487
A_, 0.00467, 0.00002,      857,        4,      853
CA, 0.00699, 0.00005,     1574,       11,     1563
CC, 0.01619, 0.00026,      247,        4,      243
CD, 0.00681, 0.00005,     1321,        9,     1312
CE, 0.00226, 0.00001,     1328,        3,     1325
CF, 0.01356, 0.00018,      811,       11,      800
CG, 0.00773, 0.00006,     1940,       15,     1925
CH, 0.01019, 0.0001 ,      589,        6,      583
CI, 0.00195, 0      ,     1026,        2,     1024
CK, 0.00676, 0.00005,     1036,        7,     1029
CL, 0.00606, 0.00004,     1651,       10,     1641
CM, 0      , 0      ,      333,        0,      333
CN, 0.00521, 0.00003,      959,        5,      954
CP, 0.00087, 0      ,     1153,        1,     1152
CQ, 0.00566, 0.00003,      707,        4,      703
CR, 0.00265, 0.00001,     1133,        3,     1130
CS, 0.00539, 0.00003,     1298,        7,     1291
CT, 0.00538, 0.00003,     1116,        6,     1110
CV, 0.0025 , 0.00001,     1198,        3,     1195
CW, 0.00427, 0.00002,      234,        1,      233
CY, 0.00282, 0.00001,      709,        2,      707
C_, 0      , 0      ,       47,        0,       47
DA, 0.03335, 0.00111,    14154,      472,    13682
DC, 0.0621 , 0.00386,     1868,      116,     1752
DD, 0.04624, 0.00214,     8737,      404,     8333
DE, 0.02633, 0.00069,    10786,      284,    10502
DF, 0.04763, 0.00227,     7958,      379,     7579
DG, 0.06494, 0.00422,    12135,      788,    11347
DH, 0.03959, 0.00157,     3410,      135,     3275
DI, 0.05156, 0.00266,    11384,      587,    10797
DK, 0.01517, 0.00023,     8569,      130,     8439
DL, 0.03986, 0.00159,    16258,      648,    15610
DM, 0.04324, 0.00187,     3723,      161,     3562
DN, 0.04349, 0.00189,     6002,      261,     5741
DP, 0.02166, 0.00047,     8358,      181,     8177
DQ, 0.0268 , 0.00072,     4851,      130,     4721
DR, 0.02316, 0.00054,     8334,      193,     8141
DS, 0.04442, 0.00197,     8690,      386,     8304
DT, 0.04107, 0.00169,     8060,      331,     7729
DV, 0.04043, 0.00163,    12465,      504,    11961
DW, 0.03019, 0.00091,     2484,       75,     2409
DY, 0.03259, 0.00106,     6474,      211,     6263
D_, 0.04527, 0.00205,      486,       22,      464
EA, 0.01942, 0.00038,    16680,      324,    16356
EC, 0.036  , 0.0013 ,     2000,       72,     1928
ED, 0.0209 , 0.00044,    10956,      229,    10727
EE, 0.01311, 0.00017,    15489,      203,    15286
EF, 0.02641, 0.0007 ,     7496,      198,     7298
EG, 0.02292, 0.00053,    12830,      294,    12536
EH, 0.02879, 0.00083,     3855,      111,     3744
EI, 0.02478, 0.00061,    12390,      307,    12083
EK, 0.00771, 0.00006,    12574,       97,    12477
EL, 0.01969, 0.00039,    19246,      379,    18867
EM, 0.02294, 0.00053,     4490,      103,     4387
EN, 0.01524, 0.00023,     7548,      115,     7433
EP, 0.0159 , 0.00025,     9057,      144,     8913
EQ, 0.01895, 0.00036,     7178,      136,     7042
ER, 0.01669, 0.00028,    11263,      188,    11075
ES, 0.01882, 0.00035,     9618,      181,     9437
ET, 0.01759, 0.00031,     9098,      160,     8938
EV, 0.02431, 0.00059,    14232,      346,    13886
EW, 0.01724, 0.0003 ,     2610,       45,     2565
EY, 0.02264, 0.00051,     5963,      135,     5828
E_, 0.03318, 0.0011 ,      633,       21,      612
FA, 0.00293, 0.00001,     6140,       18,     6122
FC, 0.00309, 0.00001,      970,        3,      967
FD, 0.00407, 0.00002,     6391,       26,     6365
FE, 0.00399, 0.00002,     5763,       23,     5740
FF, 0.00359, 0.00001,     3065,       11,     3054
FG, 0.00418, 0.00002,     6932,       29,     6903
FH, 0.00045, 0      ,     2209,        1,     2208
FI, 0.00237, 0.00001,     3797,        9,     3788
FK, 0.0036 , 0.00001,     4450,       16,     4434
FL, 0.00451, 0.00002,     6213,       28,     6185
FM, 0.00273, 0.00001,     1465,        4,     1461
FN, 0.0041 , 0.00002,     3656,       15,     3641
FP, 0.00232, 0.00001,     4749,       11,     4738
FQ, 0.00395, 0.00002,     2788,       11,     2777
FR, 0.00349, 0.00001,     4585,       16,     4569
FS, 0.00397, 0.00002,     5547,       22,     5525
FT, 0.0021 , 0      ,     4758,       10,     4748
FV, 0.00205, 0      ,     4885,       10,     4875
FW, 0      , 0      ,      987,        0,      987
FY, 0.00178, 0      ,     2814,        5,     2809
F_, 0.00806, 0.00007,      248,        2,      246
GA, 0.00561, 0.00003,    13375,       75,    13300
GC, 0.00534, 0.00003,     2060,       11,     2049
GD, 0.00873, 0.00008,    10421,       91,    10330
GE, 0.00279, 0.00001,    11127,       31,    11096
GF, 0.00391, 0.00002,     6398,       25,     6373
GG, 0.01039, 0.00011,    12515,      130,    12385
GH, 0.00765, 0.00006,     3924,       30,     3894
GI, 0.00649, 0.00004,     8480,       55,     8425
GK, 0.00435, 0.00002,     9880,       43,     9837
GL, 0.00501, 0.00003,    14177,       71,    14106
GM, 0.0052 , 0.00003,     3268,       17,     3251
GN, 0.0065 , 0.00004,     6765,       44,     6721
GP, 0.00538, 0.00003,     7057,       38,     7019
GQ, 0.00722, 0.00005,     5544,       40,     5504
GR, 0.00368, 0.00001,     8414,       31,     8383
GS, 0.0069 , 0.00005,    10433,       72,    10361
GT, 0.00522, 0.00003,     9576,       50,     9526
GV, 0.00456, 0.00002,    10515,       48,    10467
GW, 0.00964, 0.00009,     1868,       18,     1850
GY, 0.00465, 0.00002,     5591,       26,     5565
G_, 0.00554, 0.00003,      722,        4,      718
HA, 0.02913, 0.00085,     4944,      144,     4800
HC, 0.03204, 0.00103,      905,       29,      876
HD, 0.03116, 0.00097,     3370,      105,     3265
HE, 0.01762, 0.00031,     3746,       66,     3680
HF, 0.015  , 0.00022,     2867,       43,     2824
HG, 0.02443, 0.0006 ,     4707,      115,     4592
HH, 0.02339, 0.00055,     2437,       57,     2380
HI, 0.01905, 0.00036,     3780,       72,     3708
HK, 0.01029, 0.00011,     3013,       31,     2982
HL, 0.02045, 0.00042,     6308,      129,     6179
HM, 0.02293, 0.00053,     1439,       33,     1406
HN, 0.0262 , 0.00069,     2290,       60,     2230
HP, 0.01327, 0.00018,     3315,       44,     3271
HQ, 0.02156, 0.00046,     2134,       46,     2088
HR, 0.01466, 0.00021,     3410,       50,     3360
HS, 0.02904, 0.00084,     3512,      102,     3410
HT, 0.02153, 0.00046,     3297,       71,     3226
HV, 0.018  , 0.00032,     4000,       72,     3928
HW, 0.02601, 0.00068,      961,       25,      936
HY, 0.02537, 0.00064,     2247,       57,     2190
H_, 0.03659, 0.00134,      410,       15,      395
IA, 0.00162, 0      ,     8657,       14,     8643
IC, 0.00092, 0      ,     1091,        1,     1090
ID, 0.00473, 0.00002,     8455,       40,     8415
IE, 0.00275, 0.00001,     8722,       24,     8698
IF, 0.00403, 0.00002,     3473,       14,     3459
IG, 0.00334, 0.00001,     8683,       29,     8654
IH, 0.00906, 0.00008,     2538,       23,     2515
II, 0.00131, 0      ,     5343,        7,     5336
IK, 0.00392, 0.00002,     6881,       27,     6854
IL, 0.00232, 0.00001,     8190,       19,     8171
IM, 0.00108, 0      ,     1847,        2,     1845
IN, 0.00164, 0      ,     5498,        9,     5489
IP, 0.0023 , 0.00001,     6088,       14,     6074
IQ, 0.00626, 0.00004,     3834,       24,     3810
IR, 0.00243, 0.00001,     5752,       14,     5738
IS, 0.00219, 0      ,     6845,       15,     6830
IT, 0.00337, 0.00001,     5641,       19,     5622
IV, 0.00218, 0      ,     6425,       14,     6411
IW, 0      , 0      ,     1038,        0,     1038
IY, 0.00166, 0      ,     3013,        5,     3008
I_, 0.00645, 0.00004,      310,        2,      308
K?, 0      , 0      ,        1,        0,        1
KA, 0.00687, 0.00005,    12377,       85,    12292
KC, 0.01576, 0.00025,     1459,       23,     1436
KD, 0.00646, 0.00004,     8669,       56,     8613
KE, 0.00521, 0.00003,    12664,       66,    12598
KF, 0.0073 , 0.00005,     5755,       42,     5713
KG, 0.01231, 0.00015,    11374,      140,    11234
KH, 0.00384, 0.00001,     3121,       12,     3109
KI, 0.01034, 0.00011,    10150,      105,    10045
KK, 0.00328, 0.00001,     9462,       31,     9431
KL, 0.00814, 0.00007,    15478,      126,    15352
KM, 0.00837, 0.00007,     3585,       30,     3555
KN, 0.00629, 0.00004,     6355,       40,     6315
KP, 0.01052, 0.00011,     6274,       66,     6208
KQ, 0.00429, 0.00002,     5366,       23,     5343
KR, 0.00643, 0.00004,     7620,       49,     7571
KS, 0.00535, 0.00003,     7848,       42,     7806
KT, 0.00798, 0.00006,     7266,       58,     7208
KV, 0.00749, 0.00006,    11081,       83,    10998
KW, 0.01141, 0.00013,     2016,       23,     1993
KY, 0.00504, 0.00003,     5553,       28,     5525
K_, 0.00756, 0.00006,      794,        6,      788
LA, 0.00285, 0.00001,    15788,       45,    15743
LC, 0.00286, 0.00001,     1747,        5,     1742
LD, 0.00526, 0.00003,    12352,       65,    12287
LE, 0.00182, 0      ,    13768,       25,    13743
LF, 0.00377, 0.00001,     5839,       22,     5817
LG, 0.00403, 0.00002,    14143,       57,    14086
LH, 0.00066, 0      ,     4577,        3,     4574
LI, 0.00288, 0.00001,     8320,       24,     8296
LK, 0.00192, 0      ,    10964,       21,    10943
LL, 0.00159, 0      ,    15082,       24,    15058
LM, 0.00139, 0      ,     3606,        5,     3601
LN, 0.00367, 0.00001,     7895,       29,     7866
LP, 0.0048 , 0.00002,    10412,       50,    10362
LQ, 0.00115, 0      ,     6984,        8,     6976
LR, 0.00284, 0.00001,    10197,       29,    10168
LS, 0.00388, 0.00002,    11608,       45,    11563
LT, 0.00258, 0.00001,     9687,       25,     9662
LV, 0.00157, 0      ,    10853,       17,    10836
LW, 0.00139, 0      ,     2152,        3,     2149
LY, 0.00095, 0      ,     5261,        5,     5256
L_, 0.00671, 0.00005,      745,        5,      740
MA, 0.00154, 0      ,     3900,        6,     3894
MC, 0.00243, 0.00001,      412,        1,      411
MD, 0.00546, 0.00003,     2928,       16,     2912
ME, 0.00368, 0.00001,     3535,       13,     3522
MF, 0.00438, 0.00002,     1370,        6,     1364
MG, 0.00355, 0.00001,     3380,       12,     3368
MH, 0.00731, 0.00005,     1094,        8,     1086
MI, 0.00318, 0.00001,     2199,        7,     2192
MK, 0.00363, 0.00001,     2753,       10,     2743
ML, 0.00433, 0.00002,     3929,       17,     3912
MM, 0.00501, 0.00003,      999,        5,      994
MN, 0.00357, 0.00001,     1959,        7,     1952
MP, 0.00379, 0.00001,     2113,        8,     2105
MQ, 0.00646, 0.00004,     1702,       11,     1691
MR, 0.00365, 0.00001,     2467,        9,     2458
MS, 0.00974, 0.00009,     2773,       27,     2746
MT, 0.01196, 0.00014,     2425,       29,     2396
MV, 0.00313, 0.00001,     2877,        9,     2868
MW, 0.00409, 0.00002,      489,        2,      487
MY, 0.00243, 0.00001,     1237,        3,     1234
M_, 0.00374, 0.00001,     1069,        4,     1065
NA, 0.01781, 0.00032,     8252,      147,     8105
NC, 0.00877, 0.00008,     1368,       12,     1356
ND, 0.02207, 0.00049,     5981,      132,     5849
NE, 0.01037, 0.00011,     7332,       76,     7256
NF, 0.01155, 0.00013,     4503,       52,     4451
NG, 0.02181, 0.00048,     7703,      168,     7535
NH, 0.00849, 0.00007,     2238,       19,     2219
NI, 0.01681, 0.00028,     7200,      121,     7079
NK, 0.01075, 0.00012,     6141,       66,     6075
NL, 0.01203, 0.00014,    10225,      123,    10102
NM, 0.01612, 0.00026,     2357,       38,     2319
NN, 0.02134, 0.00046,     5014,      107,     4907
NP, 0.01204, 0.00014,     5566,       67,     5499
NQ, 0.01686, 0.00028,     3795,       64,     3731
NR, 0.00754, 0.00006,     5175,       39,     5136
NS, 0.01518, 0.00023,     6193,       94,     6099
NT, 0.01088, 0.00012,     5237,       57,     5180
NV, 0.01552, 0.00024,     7601,      118,     7483
NW, 0.01314, 0.00017,     1751,       23,     1728
NY, 0.00874, 0.00008,     3889,       34,     3855
N_, 0.01166, 0.00014,      429,        5,      424
PA, 0.00273, 0.00001,     8440,       23,     8417
PC, 0.00138, 0      ,     1448,        2,     1446
PD, 0.00392, 0.00002,     7907,       31,     7876
PE, 0.00325, 0.00001,     8611,       28,     8583
PF, 0.00287, 0.00001,     4885,       14,     4871
PG, 0.00289, 0.00001,     7614,       22,     7592
PH, 0.00261, 0.00001,     3065,        8,     3057
PI, 0.00087, 0      ,     6904,        6,     6898
PK, 0.00242, 0.00001,     5789,       14,     5775
PL, 0.00349, 0.00001,    11453,       40,    11413
PM, 0.00223, 0      ,     2240,        5,     2235
PN, 0.00543, 0.00003,     5345,       29,     5316
PP, 0.00203, 0      ,     4916,       10,     4906
PQ, 0.00269, 0.00001,     4092,       11,     4081
PR, 0.00262, 0.00001,     5349,       14,     5335
PS, 0.00389, 0.00002,     6677,       26,     6651
PT, 0.00278, 0.00001,     6840,       19,     6821
PV, 0.00276, 0.00001,     8704,       24,     8680
PW, 0.00201, 0      ,     1491,        3,     1488
PY, 0.00171, 0      ,     4088,        7,     4081
P_, 0.01681, 0.00028,      476,        8,      468
QA, 0.00525, 0.00003,     8757,       46,     8711
QC, 0.00595, 0.00004,     1008,        6,     1002
QD, 0.01046, 0.00011,     4779,       50,     4729
QE, 0.00431, 0.00002,     6964,       30,     6934
QF, 0.0106 , 0.00011,     3680,       39,     3641
QG, 0.0132 , 0.00017,     6437,       85,     6352
QH, 0.00748, 0.00006,     2138,       16,     2122
QI, 0.00987, 0.0001 ,     5575,       55,     5520
QK, 0.00516, 0.00003,     5229,       27,     5202
QL, 0.00687, 0.00005,     9891,       68,     9823
QM, 0.00812, 0.00007,     2217,       18,     2199
QN, 0.00861, 0.00007,     3834,       33,     3801
QP, 0.00719, 0.00005,     4312,       31,     4281
QQ, 0.00456, 0.00002,     4168,       19,     4149
QR, 0.00626, 0.00004,     5113,       32,     5081
QS, 0.01091, 0.00012,     5135,       56,     5079
QT, 0.00785, 0.00006,     4716,       37,     4679
QV, 0.0078 , 0.00006,     6409,       50,     6359
QW, 0.00496, 0.00002,     1612,        8,     1604
QY, 0.00574, 0.00003,     3484,       20,     3464
Q_, 0.00621, 0.00004,      322,        2,      320
RA, 0.00929, 0.00009,    13023,      121,    12902
RC, 0.00915, 0.00008,     1858,       17,     1841
RD, 0.00854, 0.00007,     8545,       73,     8472
RE, 0.00664, 0.00004,    11288,       75,    11213
RF, 0.00835, 0.00007,     6110,       51,     6059
RG, 0.00712, 0.00005,    10115,       72,    10043
RH, 0.00773, 0.00006,     3621,       28,     3593
RI, 0.01039, 0.00011,     9142,       95,     9047
RK, 0.00699, 0.00005,     7580,       53,     7527
RL, 0.0083 , 0.00007,    15305,      127,    15178
RM, 0.00703, 0.00005,     3416,       24,     3392
RN, 0.00803, 0.00006,     5355,       43,     5312
RP, 0.00967, 0.00009,     5792,       56,     5736
RQ, 0.00815, 0.00007,     5273,       43,     5230
RR, 0.00647, 0.00004,     8497,       55,     8442
RS, 0.01093, 0.00012,     7962,       87,     7875
RT, 0.00945, 0.00009,     6669,       63,     6606
RV, 0.00755, 0.00006,    10864,       82,    10782
RW, 0.00779, 0.00006,     2055,       16,     2039
RY, 0.00929, 0.00009,     5385,       50,     5335
R_, 0.01044, 0.00011,      479,        5,      474
SA, 0.00942, 0.00009,    10611,      100,    10511
SC, 0.00945, 0.00009,     1587,       15,     1572
SD, 0.00806, 0.00007,     7938,       64,     7874
SE, 0.0073 , 0.00005,     8772,       64,     8708
SF, 0.00966, 0.00009,     6208,       60,     6148
SG, 0.01196, 0.00014,    11041,      132,    10909
SH, 0.01288, 0.00017,     3183,       41,     3142
SI, 0.00814, 0.00007,     7981,       65,     7916
SK, 0.02058, 0.00042,     7192,      148,     7044
SL, 0.00853, 0.00007,    13948,      119,    13829
SM, 0.0135 , 0.00018,     2963,       40,     2923
SN, 0.01059, 0.00011,     5665,       60,     5605
SP, 0.00766, 0.00006,     6526,       50,     6476
SQ, 0.00815, 0.00007,     4661,       38,     4623
SR, 0.00589, 0.00003,     6962,       41,     6921
SS, 0.01505, 0.00023,     8704,      131,     8573
ST, 0.01426, 0.0002 ,     6942,       99,     6843
SV, 0.00785, 0.00006,     9301,       73,     9228
SW, 0.01475, 0.00022,     1831,       27,     1804
SY, 0.01078, 0.00012,     4640,       50,     4590
S_, 0.00345, 0.00001,      870,        3,      867
T?, 0      , 0      ,        1,        0,        1
TA, 0.00802, 0.00006,    10095,       81,    10014
TC, 0.00778, 0.00006,     1414,       11,     1403
TD, 0.01336, 0.00018,     7262,       97,     7165
TE, 0.00635, 0.00004,     8032,       51,     7981
TF, 0.00656, 0.00004,     5338,       35,     5303
TG, 0.00891, 0.00008,    10211,       91,    10120
TH, 0.00908, 0.00008,     2865,       26,     2839
TI, 0.00641, 0.00004,     7490,       48,     7442
TK, 0.03043, 0.00093,     6408,      195,     6213
TL, 0.00746, 0.00006,    12201,       91,    12110
TM, 0.0085 , 0.00007,     2705,       23,     2682
TN, 0.00532, 0.00003,     4891,       26,     4865
TP, 0.00644, 0.00004,     6834,       44,     6790
TQ, 0.00887, 0.00008,     4172,       37,     4135
TR, 0.00565, 0.00003,     5664,       32,     5632
TS, 0.00795, 0.00006,     7042,       56,     6986
TT, 0.01786, 0.00032,     6886,      123,     6763
TV, 0.00815, 0.00007,     9322,       76,     9246
TW, 0.00832, 0.00007,     1563,       13,     1550
TY, 0.00866, 0.00008,     4155,       36,     4119
T_, 0.00825, 0.00007,      485,        4,      481
VA, 0.00257, 0.00001,    10501,       27,    10474
VC, 0.00152, 0      ,     1317,        2,     1315
VD, 0.00718, 0.00005,     9337,       67,     9270
VE, 0.00368, 0.00001,    10339,       38,    10301
VF, 0.0044 , 0.00002,     4321,       19,     4302
VG, 0.00442, 0.00002,    10411,       46,    10365
VH, 0.00506, 0.00003,     2768,       14,     2754
VI, 0.00389, 0.00002,     6420,       25,     6395
VK, 0.00187, 0      ,     7487,       14,     7473
VL, 0.00259, 0.00001,    10796,       28,    10768
VM, 0.00376, 0.00001,     2394,        9,     2385
VN, 0.00389, 0.00002,     5654,       22,     5632
VP, 0.00303, 0.00001,     7587,       23,     7564
VQ, 0.00367, 0.00001,     4627,       17,     4610
VR, 0.00204, 0      ,     6853,       14,     6839
VS, 0.00681, 0.00005,     7777,       53,     7724
VT, 0.00427, 0.00002,     7256,       31,     7225
VV, 0.00152, 0      ,     8540,       13,     8527
VW, 0.00307, 0.00001,     1305,        4,     1301
VY, 0.0045 , 0.00002,     3558,       16,     3542
V_, 0.00435, 0.00002,      460,        2,      458
WA, 0.0048 , 0.00002,     2498,       12,     2486
WC, 0.00752, 0.00006,      399,        3,      396
WD, 0.0043 , 0.00002,     2325,       10,     2315
WE, 0.00342, 0.00001,     2342,        8,     2334
WF, 0.00082, 0      ,     1221,        1,     1220
WG, 0.01157, 0.00013,     2421,       28,     2393
WH, 0.00557, 0.00003,      898,        5,      893
WI, 0.00421, 0.00002,     1424,        6,     1418
WK, 0.00341, 0.00001,     1762,        6,     1756
WL, 0.00203, 0      ,     2955,        6,     2949
WM, 0.00522, 0.00003,      575,        3,      572
WN, 0.00727, 0.00005,     1650,       12,     1638
WP, 0.00196, 0      ,     1528,        3,     1525
WQ, 0.00334, 0.00001,     1497,        5,     1492
WR, 0.00225, 0.00001,     1775,        4,     1771
WS, 0.00724, 0.00005,     1933,       14,     1919
WT, 0.0031 , 0.00001,     1613,        5,     1608
WV, 0.00666, 0.00004,     1951,       13,     1938
WW, 0.00797, 0.00006,      502,        4,      498
WY, 0.00616, 0.00004,      974,        6,      968
W_, 0.02985, 0.00089,       67,        2,       65
YA, 0.00815, 0.00007,     6138,       50,     6088
YC, 0.00844, 0.00007,     1066,        9,     1057
YD, 0.00675, 0.00005,     6076,       41,     6035
YE, 0.00447, 0.00002,     5364,       24,     5340
YF, 0.00394, 0.00002,     3555,       14,     3541
YG, 0.00509, 0.00003,     6873,       35,     6838
YH, 0.00845, 0.00007,     2130,       18,     2112
YI, 0.00481, 0.00002,     4571,       22,     4549
YK, 0.00562, 0.00003,     4984,       28,     4956
YL, 0.00485, 0.00002,     7211,       35,     7176
YM, 0.00392, 0.00002,     1529,        6,     1523
YN, 0.00432, 0.00002,     3703,       16,     3687
YP, 0.00692, 0.00005,     4189,       29,     4160
YQ, 0.0053 , 0.00003,     3210,       17,     3193
YR, 0.00599, 0.00004,     4675,       28,     4647
YS, 0.00808, 0.00007,     5077,       41,     5036
YT, 0.00689, 0.00005,     4351,       30,     4321
YV, 0.00971, 0.00009,     5148,       50,     5098
YW, 0.00784, 0.00006,     1021,        8,     1013
YY, 0.00606, 0.00004,     3133,       19,     3114
Y_, 0.01282, 0.00016,      156,        2,      154
