key, propensity, propensity^2, count, pos, neg
?KT, 0      , 0      ,        1,        0,        1
?TF, 0      , 0      ,        1,        0,        1
AAA, 0      , 0      ,      874,        0,      874
AAC, 0      , 0      ,      184,        0,      184
AAD, 0.00755, 0.00006,     1060,        8,     1052
AAE, 0.00086, 0      ,     1166,        1,     1165
AAF, 0      , 0      ,      586,        0,      586
AAG, 0.00162, 0      ,     1234,        2,     1232
AAH, 0.00287, 0.00001,      348,        1,      347
AAI, 0.00508, 0.00003,      787,        4,      783
AAK, 0      , 0      ,      774,        0,      774
AAL, 0.00488, 0.00002,     1641,        8,     1633
AAM, 0.00268, 0.00001,      373,        1,      372
AAN, 0.00368, 0.00001,      544,        2,      542
AAP, 0.00557, 0.00003,      539,        3,      536
AAQ, 0.00166, 0      ,      602,        1,      601
AAR, 0.00725, 0.00005,      966,        7,      959
AAS, 0.00118, 0      ,      847,        1,      846
AAT, 0.0024 , 0.00001,      833,        2,      831
AAV, 0.00272, 0.00001,     1101,        3,     1098
AAW, 0      , 0      ,      155,        0,      155
AAY, 0      , 0      ,      384,        0,      384
AA_, 0.02174, 0.00047,       46,        1,       45
ACA, 0.02778, 0.00077,       72,        2,       70
ACC, 0      , 0      ,       19,        0,       19
ACD, 0.02273, 0.00052,       88,        2,       86
ACE, 0      , 0      ,       71,        0,       71
ACF, 0      , 0      ,       79,        0,       79
ACG, 0.01099, 0.00012,      182,        2,      180
ACH, 0      , 0      ,       51,        0,       51
ACI, 0      , 0      ,       69,        0,       69
ACK, 0      , 0      ,       67,        0,       67
ACL, 0.00781, 0.00006,      128,        1,      127
ACM, 0      , 0      ,       40,        0,       40
ACN, 0.05   , 0.0025 ,       40,        2,       38
ACP, 0      , 0      ,       98,        0,       98
ACQ, 0      , 0      ,       63,        0,       63
ACR, 0      , 0      ,      101,        0,      101
ACS, 0      , 0      ,       94,        0,       94
ACT, 0      , 0      ,       66,        0,       66
ACV, 0      , 0      ,       81,        0,       81
ACW, 0      , 0      ,       15,        0,       15
ACY, 0      , 0      ,       42,        0,       42
AC_, 0      , 0      ,        4,        0,        4
ADA, 0.02083, 0.00043,      672,       14,      658
ADC, 0.0614 , 0.00377,      114,        7,      107
ADD, 0.04859, 0.00236,      638,       31,      607
ADE, 0.03823, 0.00146,      837,       32,      805
ADF, 0.04252, 0.00181,      588,       25,      563
ADG, 0.04766, 0.00227,     1049,       50,      999
ADH, 0.04015, 0.00161,      274,       11,      263
ADI, 0.03289, 0.00108,      973,       32,      941
ADK, 0.01488, 0.00022,      672,       10,      662
ADL, 0.04193, 0.00176,     1431,       60,     1371
ADM, 0.02687, 0.00072,      335,        9,      326
ADN, 0.02808, 0.00079,      463,       13,      450
ADP, 0.02266, 0.00051,      662,       15,      647
ADQ, 0.03581, 0.00128,      391,       14,      377
ADR, 0.02007, 0.0004 ,      847,       17,      830
ADS, 0.04134, 0.00171,      629,       26,      603
ADT, 0.03181, 0.00101,      723,       23,      700
ADV, 0.02957, 0.00087,     1082,       32,     1050
ADW, 0.00444, 0.00002,      225,        1,      224
ADY, 0.03327, 0.00111,      541,       18,      523
AD_, 0.05263, 0.00277,       38,        2,       36
AEA, 0.02689, 0.00072,      818,       22,      796
AEC, 0.05072, 0.00257,      138,        7,      131
AED, 0.02187, 0.00048,      960,       21,      939
AEE, 0.01278, 0.00016,     1330,       17,     1313
AEF, 0.03297, 0.00109,      546,       18,      528
AEG, 0.02361, 0.00056,      932,       22,      910
AEH, 0.0231 , 0.00053,      303,        7,      296
AEI, 0.01481, 0.00022,     1013,       15,      998
AEK, 0.01411, 0.0002 ,     1063,       15,     1048
AEL, 0.01694, 0.00029,     1712,       29,     1683
AEM, 0.01613, 0.00026,      372,        6,      366
AEN, 0.00901, 0.00008,      555,        5,      550
AEP, 0.01248, 0.00016,      721,        9,      712
AEQ, 0.00719, 0.00005,      695,        5,      690
AER, 0.01011, 0.0001 ,     1088,       11,     1077
AES, 0.01884, 0.00036,      743,       14,      729
AET, 0.00856, 0.00007,      818,        7,      811
AEV, 0.01591, 0.00025,     1194,       19,     1175
AEW, 0.03049, 0.00093,      164,        5,      159
AEY, 0.0179 , 0.00032,      391,        7,      384
AE_, 0      , 0      ,       25,        0,       25
AFA, 0      , 0      ,      255,        0,      255
AFC, 0      , 0      ,       52,        0,       52
AFD, 0      , 0      ,      534,        0,      534
AFE, 0.00444, 0.00002,      450,        2,      448
AFF, 0      , 0      ,      236,        0,      236
AFG, 0.00946, 0.00009,      423,        4,      419
AFH, 0      , 0      ,      171,        0,      171
AFI, 0.00763, 0.00006,      262,        2,      260
AFK, 0.01031, 0.00011,      291,        3,      288
AFL, 0.0021 , 0      ,      477,        1,      476
AFM, 0      , 0      ,       89,        0,       89
AFN, 0      , 0      ,      235,        0,      235
AFP, 0.01127, 0.00013,      355,        4,      351
AFQ, 0      , 0      ,      224,        0,      224
AFR, 0      , 0      ,      378,        0,      378
AFS, 0.00485, 0.00002,      412,        2,      410
AFT, 0.00293, 0.00001,      341,        1,      340
AFV, 0.00272, 0.00001,      368,        1,      367
AFW, 0      , 0      ,       57,        0,       57
AFY, 0      , 0      ,      225,        0,      225
AF_, 0      , 0      ,        7,        0,        7
AGA, 0.003  , 0.00001,      666,        2,      664
AGC, 0.00535, 0.00003,      187,        1,      186
AGD, 0.01767, 0.00031,      679,       12,      667
AGE, 0.0023 , 0.00001,      871,        2,      869
AGF, 0.00399, 0.00002,      501,        2,      499
AGG, 0.00274, 0.00001,     1096,        3,     1093
AGH, 0.0125 , 0.00016,      320,        4,      316
AGI, 0.00437, 0.00002,      686,        3,      683
AGK, 0.00716, 0.00005,      698,        5,      693
AGL, 0.0017 , 0      ,     1179,        2,     1177
AGM, 0.00781, 0.00006,      256,        2,      254
AGN, 0.00899, 0.00008,      445,        4,      441
AGP, 0.00183, 0      ,      547,        1,      546
AGQ, 0      , 0      ,      423,        0,      423
AGR, 0.00307, 0.00001,      651,        2,      649
AGS, 0.00719, 0.00005,      834,        6,      828
AGT, 0.00263, 0.00001,      761,        2,      759
AGV, 0.00401, 0.00002,      997,        4,      993
AGW, 0.03472, 0.00121,      144,        5,      139
AGY, 0      , 0      ,      432,        0,      432
AG_, 0      , 0      ,       44,        0,       44
AHA, 0.06989, 0.00488,      186,       13,      173
AHC, 0.1236 , 0.01528,       89,       11,       78
AHD, 0.05   , 0.0025 ,      260,       13,      247
AHE, 0.0155 , 0.00024,      258,        4,      254
AHF, 0.00881, 0.00008,      227,        2,      225
AHG, 0.04626, 0.00214,      454,       21,      433
AHH, 0      , 0      ,      150,        0,      150
AHI, 0.00772, 0.00006,      259,        2,      257
AHK, 0.02985, 0.00089,      201,        6,      195
AHL, 0.03668, 0.00135,      518,       19,      499
AHM, 0.0119 , 0.00014,       84,        1,       83
AHN, 0.04889, 0.00239,      225,       11,      214
AHP, 0.02239, 0.0005 ,      268,        6,      262
AHQ, 0.04242, 0.0018 ,      165,        7,      158
AHR, 0      , 0      ,      297,        0,      297
AHS, 0.02151, 0.00046,      279,        6,      273
AHT, 0.00806, 0.00007,      248,        2,      246
AHV, 0.00735, 0.00005,      272,        2,      270
AHW, 0.0641 , 0.00411,       78,        5,       73
AHY, 0.01852, 0.00034,      162,        3,      159
AH_, 0      , 0      ,       12,        0,       12
AIA, 0      , 0      ,      417,        0,      417
AIC, 0      , 0      ,       68,        0,       68
AID, 0.00146, 0      ,      685,        1,      684
AIE, 0.0051 , 0.00003,      785,        4,      781
AIF, 0.00431, 0.00002,      232,        1,      231
AIG, 0.00148, 0      ,      674,        1,      673
AIH, 0.03419, 0.00117,      234,        8,      226
AII, 0      , 0      ,      345,        0,      345
AIK, 0.00385, 0.00001,      519,        2,      517
AIL, 0      , 0      ,      616,        0,      616
AIM, 0      , 0      ,      112,        0,      112
AIN, 0      , 0      ,      319,        0,      319
AIP, 0.00272, 0.00001,      367,        1,      366
AIQ, 0.00296, 0.00001,      338,        1,      337
AIR, 0      , 0      ,      480,        0,      480
AIS, 0.00186, 0      ,      538,        1,      537
AIT, 0.00276, 0.00001,      362,        1,      361
AIV, 0.00176, 0      ,      569,        1,      568
AIW, 0      , 0      ,       68,        0,       68
AIY, 0      , 0      ,      204,        0,      204
AI_, 0      , 0      ,       25,        0,       25
AKA, 0.00323, 0.00001,      620,        2,      618
AKC, 0      , 0      ,      101,        0,      101
AKD, 0.0052 , 0.00003,      577,        3,      574
AKE, 0.00355, 0.00001,     1128,        4,     1124
AKF, 0.00836, 0.00007,      359,        3,      356
AKG, 0.00439, 0.00002,      683,        3,      680
AKH, 0.00844, 0.00007,      237,        2,      235
AKI, 0.00788, 0.00006,      761,        6,      755
AKK, 0      , 0      ,      701,        0,      701
AKL, 0.00568, 0.00003,     1232,        7,     1225
AKM, 0.00391, 0.00002,      256,        1,      255
AKN, 0.01528, 0.00023,      458,        7,      451
AKP, 0.00664, 0.00004,      452,        3,      449
AKQ, 0      , 0      ,      430,        0,      430
AKR, 0.01408, 0.0002 ,      710,       10,      700
AKS, 0.00175, 0      ,      573,        1,      572
AKT, 0.0051 , 0.00003,      588,        3,      585
AKV, 0.0089 , 0.00008,      899,        8,      891
AKW, 0.0241 , 0.00058,      166,        4,      162
AKY, 0      , 0      ,      390,        0,      390
AK_, 0.08163, 0.00666,       49,        4,       45
ALA, 0.0023 , 0.00001,      870,        2,      868
ALC, 0.01198, 0.00014,      167,        2,      165
ALD, 0.00427, 0.00002,      937,        4,      933
ALE, 0.00081, 0      ,     1230,        1,     1229
ALF, 0.00217, 0      ,      461,        1,      460
ALG, 0.01075, 0.00012,     1116,       12,     1104
ALH, 0.00258, 0.00001,      388,        1,      387
ALI, 0.00469, 0.00002,      639,        3,      636
ALK, 0.00199, 0      ,     1005,        2,     1003
ALL, 0.00221, 0      ,     1356,        3,     1353
ALM, 0      , 0      ,      280,        0,      280
ALN, 0.00532, 0.00003,      564,        3,      561
ALP, 0.0073 , 0.00005,      822,        6,      816
ALQ, 0.00159, 0      ,      628,        1,      627
ALR, 0      , 0      ,     1021,        0,     1021
ALS, 0.00209, 0      ,      956,        2,      954
ALT, 0      , 0      ,      800,        0,      800
ALV, 0      , 0      ,      964,        0,      964
ALW, 0      , 0      ,      192,        0,      192
ALY, 0      , 0      ,      361,        0,      361
AL_, 0      , 0      ,       37,        0,       37
AMA, 0      , 0      ,      195,        0,      195
AMC, 0      , 0      ,       23,        0,       23
AMD, 0      , 0      ,      233,        0,      233
AME, 0      , 0      ,      353,        0,      353
AMF, 0      , 0      ,      100,        0,      100
AMG, 0      , 0      ,      274,        0,      274
AMH, 0      , 0      ,       99,        0,       99
AMI, 0.01042, 0.00011,      192,        2,      190
AMK, 0      , 0      ,      216,        0,      216
AML, 0      , 0      ,      377,        0,      377
AMM, 0      , 0      ,       92,        0,       92
AMN, 0      , 0      ,      143,        0,      143
AMP, 0.00629, 0.00004,      159,        1,      158
AMQ, 0      , 0      ,       98,        0,       98
AMR, 0      , 0      ,      204,        0,      204
AMS, 0.0042 , 0.00002,      238,        1,      237
AMT, 0      , 0      ,      200,        0,      200
AMV, 0.00389, 0.00002,      257,        1,      256
AMW, 0      , 0      ,       27,        0,       27
AMY, 0      , 0      ,      103,        0,      103
AM_, 0      , 0      ,       40,        0,       40
ANA, 0.00576, 0.00003,      347,        2,      345
ANC, 0.0125 , 0.00016,       80,        1,       79
AND, 0.03504, 0.00123,      371,       13,      358
ANE, 0      , 0      ,      461,        0,      461
ANF, 0.0125 , 0.00016,      320,        4,      316
ANG, 0.00954, 0.00009,      629,        6,      623
ANH, 0.01648, 0.00027,      182,        3,      179
ANI, 0.01093, 0.00012,      549,        6,      543
ANK, 0.01272, 0.00016,      393,        5,      388
ANL, 0.00246, 0.00001,      812,        2,      810
ANM, 0.025  , 0.00063,      200,        5,      195
ANN, 0.04558, 0.00208,      373,       17,      356
ANP, 0      , 0      ,      404,        0,      404
ANQ, 0.06209, 0.00386,      306,       19,      287
ANR, 0.01235, 0.00015,      405,        5,      400
ANS, 0.04167, 0.00174,      480,       20,      460
ANT, 0.01102, 0.00012,      363,        4,      359
ANV, 0.03059, 0.00094,      523,       16,      507
ANW, 0      , 0      ,      105,        0,      105
ANY, 0.01623, 0.00026,      308,        5,      303
AN_, 0      , 0      ,       61,        0,       61
APA, 0.00662, 0.00004,      302,        2,      300
APC, 0      , 0      ,       83,        0,       83
APD, 0.0015 , 0      ,      666,        1,      665
APE, 0.02161, 0.00047,      509,       11,      498
APF, 0.00308, 0.00001,      325,        1,      324
APG, 0.00339, 0.00001,      590,        2,      588
APH, 0      , 0      ,      235,        0,      235
API, 0      , 0      ,      528,        0,      528
APK, 0.00319, 0.00001,      313,        1,      312
APL, 0      , 0      ,      881,        0,      881
APM, 0      , 0      ,      146,        0,      146
APN, 0.00585, 0.00003,      342,        2,      340
APP, 0      , 0      ,      305,        0,      305
APQ, 0      , 0      ,      229,        0,      229
APR, 0      , 0      ,      379,        0,      379
APS, 0      , 0      ,      427,        0,      427
APT, 0      , 0      ,      493,        0,      493
APV, 0      , 0      ,      673,        0,      673
APW, 0      , 0      ,      153,        0,      153
APY, 0      , 0      ,      275,        0,      275
AP_, 0      , 0      ,       45,        0,       45
AQA, 0.00218, 0      ,      458,        1,      457
AQC, 0.00862, 0.00007,      116,        1,      115
AQD, 0.00937, 0.00009,      320,        3,      317
AQE, 0.0044 , 0.00002,      682,        3,      679
AQF, 0.01056, 0.00011,      284,        3,      281
AQG, 0.00957, 0.00009,      627,        6,      621
AQH, 0      , 0      ,      161,        0,      161
AQI, 0.00451, 0.00002,      443,        2,      441
AQK, 0.00204, 0      ,      489,        1,      488
AQL, 0.00346, 0.00001,      867,        3,      864
AQM, 0      , 0      ,      231,        0,      231
AQN, 0.00664, 0.00004,      301,        2,      299
AQP, 0.00352, 0.00001,      284,        1,      283
AQQ, 0.01928, 0.00037,      415,        8,      407
AQR, 0.00564, 0.00003,      532,        3,      529
AQS, 0.00473, 0.00002,      423,        2,      421
AQT, 0.01274, 0.00016,      471,        6,      465
AQV, 0.00156, 0      ,      639,        1,      638
AQW, 0      , 0      ,      126,        0,      126
AQY, 0.00888, 0.00008,      338,        3,      335
AQ_, 0.04348, 0.00189,       23,        1,       22
ARA, 0.0053 , 0.00003,      755,        4,      751
ARC, 0.01818, 0.00033,      165,        3,      162
ARD, 0.00859, 0.00007,      582,        5,      577
ARE, 0.0063 , 0.00004,      952,        6,      946
ARF, 0.0062 , 0.00004,      484,        3,      481
ARG, 0.00771, 0.00006,      778,        6,      772
ARH, 0.00831, 0.00007,      361,        3,      358
ARI, 0.02033, 0.00041,      787,       16,      771
ARK, 0.00332, 0.00001,      603,        2,      601
ARL, 0.01701, 0.00029,     1293,       22,     1271
ARM, 0.00297, 0.00001,      337,        1,      336
ARN, 0.0026 , 0.00001,      385,        1,      384
ARP, 0      , 0      ,      384,        0,      384
ARQ, 0.01296, 0.00017,      540,        7,      533
ARR, 0.00372, 0.00001,      807,        3,      804
ARS, 0.00628, 0.00004,      637,        4,      633
ART, 0.03079, 0.00095,      617,       19,      598
ARV, 0.00745, 0.00006,      940,        7,      933
ARW, 0.01299, 0.00017,      154,        2,      152
ARY, 0.01782, 0.00032,      449,        8,      441
AR_, 0      , 0      ,       26,        0,       26
ASA, 0.00214, 0      ,      468,        1,      467
ASC, 0      , 0      ,      148,        0,      148
ASD, 0.01134, 0.00013,      529,        6,      523
ASE, 0.00159, 0      ,      627,        1,      626
ASF, 0      , 0      ,      438,        0,      438
ASG, 0.00806, 0.00006,      869,        7,      862
ASH, 0      , 0      ,      276,        0,      276
ASI, 0.00776, 0.00006,      644,        5,      639
ASK, 0.01713, 0.00029,      467,        8,      459
ASL, 0.00529, 0.00003,     1135,        6,     1129
ASM, 0.02174, 0.00047,      230,        5,      225
ASN, 0.00238, 0.00001,      420,        1,      419
ASP, 0.01411, 0.0002 ,      496,        7,      489
ASQ, 0.00601, 0.00004,      333,        2,      331
ASR, 0.00703, 0.00005,      569,        4,      565
ASS, 0.03236, 0.00105,      618,       20,      598
AST, 0.01689, 0.00029,      533,        9,      524
ASV, 0.00477, 0.00002,      629,        3,      626
ASW, 0.01887, 0.00036,      159,        3,      156
ASY, 0.02303, 0.00053,      304,        7,      297
AS_, 0      , 0      ,       45,        0,       45
ATA, 0.00213, 0      ,      469,        1,      468
ATC, 0      , 0      ,      110,        0,      110
ATD, 0.03285, 0.00108,      548,       18,      530
ATE, 0.00325, 0.00001,      615,        2,      613
ATF, 0.00275, 0.00001,      363,        1,      362
ATG, 0.00686, 0.00005,      875,        6,      869
ATH, 0.00429, 0.00002,      233,        1,      232
ATI, 0.0107 , 0.00011,      561,        6,      555
ATK, 0.02262, 0.00051,      442,       10,      432
ATL, 0.00502, 0.00003,      996,        5,      991
ATM, 0.00797, 0.00006,      251,        2,      249
ATN, 0.01319, 0.00017,      379,        5,      374
ATP, 0.0153 , 0.00023,      523,        8,      515
ATQ, 0.0098 , 0.0001 ,      306,        3,      303
ATR, 0.00452, 0.00002,      442,        2,      440
ATS, 0.0069 , 0.00005,      580,        4,      576
ATT, 0.00349, 0.00001,      573,        2,      571
ATV, 0.00149, 0      ,      669,        1,      668
ATW, 0      , 0      ,      109,        0,      109
ATY, 0.01042, 0.00011,      288,        3,      285
AT_, 0      , 0      ,       35,        0,       35
AVA, 0.00212, 0      ,      471,        1,      470
AVC, 0.00877, 0.00008,      114,        1,      113
AVD, 0.00875, 0.00008,      686,        6,      680
AVE, 0      , 0      ,      886,        0,      886
AVF, 0      , 0      ,      268,        0,      268
AVG, 0.00126, 0      ,      792,        1,      791
AVH, 0      , 0      ,      191,        0,      191
AVI, 0      , 0      ,      461,        0,      461
AVK, 0.00189, 0      ,      529,        1,      528
AVL, 0.0023 , 0.00001,      868,        2,      866
AVM, 0      , 0      ,      151,        0,      151
AVN, 0.00792, 0.00006,      379,        3,      376
AVP, 0.00385, 0.00001,      519,        2,      517
AVQ, 0      , 0      ,      432,        0,      432
AVR, 0.00327, 0.00001,      612,        2,      610
AVS, 0.00723, 0.00005,      553,        4,      549
AVT, 0.00341, 0.00001,      587,        2,      585
AVV, 0.00576, 0.00003,      695,        4,      691
AVW, 0      , 0      ,       96,        0,       96
AVY, 0      , 0      ,      256,        0,      256
AV_, 0      , 0      ,       22,        0,       22
AWA, 0      , 0      ,       97,        0,       97
AWC, 0      , 0      ,       27,        0,       27
AWD, 0.00571, 0.00003,      175,        1,      174
AWE, 0      , 0      ,      182,        0,      182
AWF, 0      , 0      ,       79,        0,       79
AWG, 0.01149, 0.00013,      174,        2,      172
AWH, 0.01923, 0.00037,       52,        1,       51
AWI, 0      , 0      ,       83,        0,       83
AWK, 0.01754, 0.00031,      171,        3,      168
AWL, 0.00427, 0.00002,      234,        1,      233
AWM, 0.01316, 0.00017,       76,        1,       75
AWN, 0.00962, 0.00009,      104,        1,      103
AWP, 0      , 0      ,      114,        0,      114
AWQ, 0      , 0      ,      113,        0,      113
AWR, 0      , 0      ,      154,        0,      154
AWS, 0      , 0      ,      140,        0,      140
AWT, 0.02041, 0.00042,       98,        2,       96
AWV, 0      , 0      ,      170,        0,      170
AWW, 0      , 0      ,       31,        0,       31
AWY, 0.08696, 0.00756,       69,        6,       63
AW_, 0      , 0      ,        1,        0,        1
AYA, 0.02166, 0.00047,      277,        6,      271
AYC, 0.02105, 0.00044,       95,        2,       93
AYD, 0.01549, 0.00024,      452,        7,      445
AYE, 0.00264, 0.00001,      379,        1,      378
AYF, 0.01508, 0.00023,      199,        3,      196
AYG, 0.00628, 0.00004,      478,        3,      475
AYH, 0      , 0      ,      140,        0,      140
AYI, 0.01582, 0.00025,      316,        5,      311
AYK, 0.0035 , 0.00001,      286,        1,      285
AYL, 0.01464, 0.00021,      478,        7,      471
AYM, 0.02419, 0.00059,      124,        3,      121
AYN, 0      , 0      ,      262,        0,      262
AYP, 0.00823, 0.00007,      243,        2,      241
AYQ, 0      , 0      ,      235,        0,      235
AYR, 0.00249, 0.00001,      402,        1,      401
AYS, 0.00606, 0.00004,      330,        2,      328
AYT, 0.00662, 0.00004,      302,        2,      300
AYV, 0      , 0      ,      331,        0,      331
AYW, 0      , 0      ,       60,        0,       60
AYY, 0      , 0      ,      215,        0,      215
AY_, 0      , 0      ,        4,        0,        4
CAC, 0      , 0      ,       12,        0,       12
CAD, 0      , 0      ,      110,        0,      110
CAE, 0      , 0      ,      132,        0,      132
CAF, 0      , 0      ,       50,        0,       50
CAG, 0.01156, 0.00013,      173,        2,      171
CAH, 0      , 0      ,       48,        0,       48
CAI, 0      , 0      ,       72,        0,       72
CAK, 0      , 0      ,       86,        0,       86
CAL, 0      , 0      ,      105,        0,      105
CAM, 0      , 0      ,       39,        0,       39
CAN, 0      , 0      ,       99,        0,       99
CAP, 0      , 0      ,       66,        0,       66
CAQ, 0      , 0      ,       48,        0,       48
CAR, 0.01316, 0.00017,       76,        1,       75
CAS, 0.0098 , 0.0001 ,      102,        1,      101
CAT, 0      , 0      ,       94,        0,       94
CAV, 0      , 0      ,       80,        0,       80
CAW, 0      , 0      ,       15,        0,       15
CAY, 0      , 0      ,       31,        0,       31
CA_, 0      , 0      ,        7,        0,        7
CCC, 0      , 0      ,        2,        0,        2
CCD, 0      , 0      ,       21,        0,       21
CCE, 0      , 0      ,       19,        0,       19
CCF, 0      , 0      ,       29,        0,       29
CCG, 0      , 0      ,       15,        0,       15
CCH, 0.28571, 0.08163,       14,        4,       10
CCI, 0      , 0      ,        3,        0,        3
CCK, 0      , 0      ,        9,        0,        9
CCL, 0      , 0      ,       17,        0,       17
CCM, 0      , 0      ,        2,        0,        2
CCN, 0      , 0      ,       25,        0,       25
CCP, 0      , 0      ,       11,        0,       11
CCQ, 0      , 0      ,        3,        0,        3
CCR, 0      , 0      ,       13,        0,       13
CCS, 0      , 0      ,       31,        0,       31
CCT, 0      , 0      ,       10,        0,       10
CCV, 0      , 0      ,        5,        0,        5
CCW, 0      , 0      ,        3,        0,        3
CCY, 0      , 0      ,        4,        0,        4
CDC, 0      , 0      ,       20,        0,       20
CDD, 0.03061, 0.00094,       98,        3,       95
CDE, 0.01786, 0.00032,      112,        2,      110
CDF, 0.17895, 0.03202,       95,       17,       78
CDG, 0.13287, 0.01765,      143,       19,      124
CDH, 0      , 0      ,       16,        0,       16
CDI, 0.02247, 0.0005 ,      178,        4,      174
CDK, 0.10092, 0.01018,      109,       11,       98
CDL, 0.05556, 0.00309,      162,        9,      153
CDM, 0.09302, 0.00865,       43,        4,       39
CDN, 0.04286, 0.00184,       70,        3,       67
CDP, 0.05618, 0.00316,       89,        5,       84
CDQ, 0      , 0      ,       64,        0,       64
CDR, 0      , 0      ,       89,        0,       89
CDS, 0      , 0      ,      100,        0,      100
CDT, 0.125  , 0.01562,       80,       10,       70
CDV, 0.11594, 0.01344,      138,       16,      122
CDW, 0      , 0      ,       10,        0,       10
CDY, 0.04348, 0.00189,       92,        4,       88
CD_, 0      , 0      ,        5,        0,        5
CEC, 0      , 0      ,        9,        0,        9
CED, 0.04   , 0.0016 ,       75,        3,       72
CEE, 0.04636, 0.00215,      151,        7,      144
CEF, 0.03571, 0.00128,       84,        3,       81
CEG, 0.04861, 0.00236,      144,        7,      137
CEH, 0.05882, 0.00346,       34,        2,       32
CEI, 0.11364, 0.01291,      132,       15,      117
CEK, 0.03315, 0.0011 ,      181,        6,      175
CEL, 0.02105, 0.00044,      190,        4,      186
CEM, 0.08333, 0.00694,       72,        6,       66
CEN, 0      , 0      ,       90,        0,       90
CEP, 0.01163, 0.00014,       86,        1,       85
CEQ, 0.0597 , 0.00356,       67,        4,       63
CER, 0.00971, 0.00009,      103,        1,      102
CES, 0      , 0      ,      135,        0,      135
CET, 0.02062, 0.00043,       97,        2,       95
CEV, 0.04545, 0.00207,      110,        5,      105
CEW, 0      , 0      ,       17,        0,       17
CEY, 0.03448, 0.00119,       58,        2,       56
CE_, 0      , 0      ,        1,        0,        1
CFC, 0      , 0      ,       11,        0,       11
CFD, 0      , 0      ,       51,        0,       51
CFE, 0      , 0      ,      110,        0,      110
CFF, 0      , 0      ,       21,        0,       21
CFG, 0.02857, 0.00082,       70,        2,       68
CFH, 0      , 0      ,       33,        0,       33
CFI, 0      , 0      ,       26,        0,       26
CFK, 0      , 0      ,       34,        0,       34
CFL, 0      , 0      ,       53,        0,       53
CFM, 0      , 0      ,       10,        0,       10
CFN, 0      , 0      ,       46,        0,       46
CFP, 0      , 0      ,       38,        0,       38
CFQ, 0      , 0      ,       58,        0,       58
CFR, 0      , 0      ,       59,        0,       59
CFS, 0      , 0      ,       50,        0,       50
CFT, 0.01538, 0.00024,       65,        1,       64
CFV, 0      , 0      ,       79,        0,       79
CFW, 0      , 0      ,        9,        0,        9
CFY, 0      , 0      ,       27,        0,       27
CF_, 0      , 0      ,        4,        0,        4
CGC, 0      , 0      ,       11,        0,       11
CGD, 0      , 0      ,      129,        0,      129
CGE, 0.01639, 0.00027,      122,        2,      120
CGF, 0.01136, 0.00013,       88,        1,       87
CGG, 0      , 0      ,      145,        0,      145
CGH, 0      , 0      ,       50,        0,       50
CGI, 0      , 0      ,      130,        0,      130
CGK, 0      , 0      ,      128,        0,      128
CGL, 0.02286, 0.00052,      175,        4,      171
CGM, 0      , 0      ,       39,        0,       39
CGN, 0      , 0      ,       86,        0,       86
CGP, 0      , 0      ,       83,        0,       83
CGQ, 0      , 0      ,       59,        0,       59
CGR, 0      , 0      ,      115,        0,      115
CGS, 0      , 0      ,      177,        0,      177
CGT, 0.02857, 0.00082,      105,        3,      102
CGV, 0      , 0      ,      118,        0,      118
CGW, 0      , 0      ,       22,        0,       22
CGY, 0      , 0      ,       43,        0,       43
CG_, 0      , 0      ,        3,        0,        3
CHC, 0      , 0      ,        3,        0,        3
CHD, 0.10909, 0.0119 ,       55,        6,       49
CHE, 0.03448, 0.00119,       29,        1,       28
CHF, 0      , 0      ,       40,        0,       40
CHG, 0      , 0      ,       68,        0,       68
CHH, 0      , 0      ,       24,        0,       24
CHI, 0.01852, 0.00034,       54,        1,       53
CHK, 0.01923, 0.00037,       52,        1,       51
CHL, 0.04211, 0.00177,       95,        4,       91
CHM, 0.2    , 0.04   ,       30,        6,       24
CHN, 0      , 0      ,       41,        0,       41
CHP, 0      , 0      ,       68,        0,       68
CHQ, 0.05882, 0.00346,       34,        2,       32
CHR, 0      , 0      ,       60,        0,       60
CHS, 0.02703, 0.00073,       37,        1,       36
CHT, 0      , 0      ,       49,        0,       49
CHV, 0.13725, 0.01884,       51,        7,       44
CHW, 0.125  , 0.01562,        8,        1,        7
CHY, 0      , 0      ,       17,        0,       17
CIC, 0      , 0      ,        2,        0,        2
CID, 0.01075, 0.00012,       93,        1,       92
CIE, 0      , 0      ,       86,        0,       86
CIF, 0      , 0      ,       32,        0,       32
CIG, 0      , 0      ,       85,        0,       85
CIH, 0      , 0      ,       13,        0,       13
CII, 0      , 0      ,       45,        0,       45
CIK, 0      , 0      ,       83,        0,       83
CIL, 0      , 0      ,       64,        0,       64
CIM, 0      , 0      ,       14,        0,       14
CIN, 0      , 0      ,       77,        0,       77
CIP, 0      , 0      ,       62,        0,       62
CIQ, 0      , 0      ,       51,        0,       51
CIR, 0      , 0      ,       64,        0,       64
CIS, 0      , 0      ,       71,        0,       71
CIT, 0      , 0      ,       70,        0,       70
CIV, 0      , 0      ,       67,        0,       67
CIW, 0      , 0      ,        4,        0,        4
CIY, 0      , 0      ,       16,        0,       16
CI_, 0      , 0      ,        1,        0,        1
CKC, 0      , 0      ,       10,        0,       10
CKD, 0.03896, 0.00152,       77,        3,       74
CKE, 0.0069 , 0.00005,      145,        1,      144
CKF, 0      , 0      ,       25,        0,       25
CKG, 0      , 0      ,       84,        0,       84
CKH, 0      , 0      ,       19,        0,       19
CKI, 0.01449, 0.00021,       69,        1,       68
CKK, 0      , 0      ,       62,        0,       62
CKL, 0.02   , 0.0004 ,      150,        3,      147
CKM, 0      , 0      ,       38,        0,       38
CKN, 0.01471, 0.00022,       68,        1,       67
CKP, 0.00893, 0.00008,      112,        1,      111
CKQ, 0.04651, 0.00216,       86,        4,       82
CKR, 0      , 0      ,       74,        0,       74
CKS, 0.01429, 0.0002 ,       70,        1,       69
CKT, 0.03896, 0.00152,       77,        3,       74
CKV, 0.03279, 0.00107,      122,        4,      118
CKW, 0      , 0      ,       16,        0,       16
CKY, 0      , 0      ,       55,        0,       55
CK_, 0      , 0      ,        4,        0,        4
CLC, 0      , 0      ,       10,        0,       10
CLD, 0      , 0      ,      113,        0,      113
CLE, 0      , 0      ,      128,        0,      128
CLF, 0      , 0      ,       53,        0,       53
CLG, 0      , 0      ,      174,        0,      174
CLH, 0      , 0      ,       33,        0,       33
CLI, 0      , 0      ,       77,        0,       77
CLK, 0      , 0      ,       84,        0,       84
CLL, 0      , 0      ,      141,        0,      141
CLM, 0      , 0      ,       31,        0,       31
CLN, 0      , 0      ,       58,        0,       58
CLP, 0.0098 , 0.0001 ,      102,        1,      101
CLQ, 0      , 0      ,       61,        0,       61
CLR, 0      , 0      ,       85,        0,       85
CLS, 0      , 0      ,       88,        0,       88
CLT, 0      , 0      ,       70,        0,       70
CLV, 0.0177 , 0.00031,      113,        2,      111
CLW, 0      , 0      ,       20,        0,       20
CLY, 0      , 0      ,       43,        0,       43
CL_, 0      , 0      ,        4,        0,        4
CMD, 0      , 0      ,       35,        0,       35
CME, 0      , 0      ,       43,        0,       43
CMF, 0      , 0      ,       20,        0,       20
CMG, 0      , 0      ,       30,        0,       30
CMH, 0      , 0      ,        5,        0,        5
CMI, 0      , 0      ,       21,        0,       21
CMK, 0      , 0      ,       11,        0,       11
CML, 0      , 0      ,       36,        0,       36
CMM, 0      , 0      ,       16,        0,       16
CMN, 0      , 0      ,       16,        0,       16
CMP, 0.04545, 0.00207,       22,        1,       21
CMQ, 0      , 0      ,       24,        0,       24
CMR, 0      , 0      ,       18,        0,       18
CMS, 0      , 0      ,       19,        0,       19
CMT, 0      , 0      ,       25,        0,       25
CMV, 0      , 0      ,       39,        0,       39
CMW, 0      , 0      ,        5,        0,        5
CMY, 0      , 0      ,        4,        0,        4
CNC, 0      , 0      ,        6,        0,        6
CND, 0.02632, 0.00069,       38,        1,       37
CNE, 0.01111, 0.00012,       90,        1,       89
CNF, 0      , 0      ,       26,        0,       26
CNG, 0.00741, 0.00005,      135,        1,      134
CNH, 0      , 0      ,       44,        0,       44
CNI, 0      , 0      ,      110,        0,      110
CNK, 0      , 0      ,       66,        0,       66
CNL, 0.01961, 0.00038,      102,        2,      100
CNM, 0      , 0      ,       33,        0,       33
CNN, 0.03279, 0.00107,       61,        2,       59
CNP, 0      , 0      ,      125,        0,      125
CNQ, 0      , 0      ,       47,        0,       47
CNR, 0.01515, 0.00023,       66,        1,       65
CNS, 0      , 0      ,      100,        0,      100
CNT, 0      , 0      ,       52,        0,       52
CNV, 0.05263, 0.00277,       57,        3,       54
CNW, 0      , 0      ,       13,        0,       13
CNY, 0      , 0      ,       40,        0,       40
CN_, 0      , 0      ,        2,        0,        2
CPC, 0      , 0      ,        7,        0,        7
CPD, 0      , 0      ,       61,        0,       61
CPE, 0      , 0      ,      103,        0,      103
CPF, 0      , 0      ,       72,        0,       72
CPG, 0      , 0      ,      124,        0,      124
CPH, 0      , 0      ,       49,        0,       49
CPI, 0      , 0      ,       57,        0,       57
CPK, 0      , 0      ,      100,        0,      100
CPL, 0      , 0      ,      100,        0,      100
CPM, 0      , 0      ,       23,        0,       23
CPN, 0      , 0      ,      105,        0,      105
CPP, 0      , 0      ,       52,        0,       52
CPQ, 0      , 0      ,       45,        0,       45
CPR, 0.01613, 0.00026,       62,        1,       61
CPS, 0      , 0      ,       78,        0,       78
CPT, 0      , 0      ,       67,        0,       67
CPV, 0      , 0      ,      141,        0,      141
CPW, 0      , 0      ,       16,        0,       16
CPY, 0      , 0      ,       44,        0,       44
CP_, 0      , 0      ,        3,        0,        3
CQC, 0      , 0      ,       11,        0,       11
CQD, 0      , 0      ,       42,        0,       42
CQE, 0      , 0      ,       76,        0,       76
CQF, 0      , 0      ,       52,        0,       52
CQG, 0.04082, 0.00167,       49,        2,       47
CQH, 0      , 0      ,       24,        0,       24
CQI, 0      , 0      ,       73,        0,       73
CQK, 0.01667, 0.00028,       60,        1,       59
CQL, 0      , 0      ,       96,        0,       96
CQM, 0.04545, 0.00207,       22,        1,       21
CQN, 0      , 0      ,       28,        0,       28
CQP, 0.02   , 0.0004 ,       50,        1,       49
CQQ, 0      , 0      ,       38,        0,       38
CQR, 0      , 0      ,       73,        0,       73
CQS, 0      , 0      ,       49,        0,       49
CQT, 0      , 0      ,       28,        0,       28
CQV, 0      , 0      ,       57,        0,       57
CQW, 0      , 0      ,       17,        0,       17
CQY, 0      , 0      ,       43,        0,       43
CQ_, 0      , 0      ,        1,        0,        1
CRC, 0      , 0      ,       13,        0,       13
CRD, 0      , 0      ,      121,        0,      121
CRE, 0.02158, 0.00047,      139,        3,      136
CRF, 0.02326, 0.00054,       86,        2,       84
CRG, 0      , 0      ,      115,        0,      115
CRH, 0      , 0      ,       37,        0,       37
CRI, 0.01709, 0.00029,      117,        2,      115
CRK, 0.00962, 0.00009,      104,        1,      103
CRL, 0      , 0      ,      148,        0,      148
CRM, 0      , 0      ,       20,        0,       20
CRN, 0.02985, 0.00089,       67,        2,       65
CRP, 0      , 0      ,       55,        0,       55
CRQ, 0      , 0      ,      107,        0,      107
CRR, 0      , 0      ,      115,        0,      115
CRS, 0.0098 , 0.0001 ,      102,        1,      101
CRT, 0.03333, 0.00111,       60,        2,       58
CRV, 0.01111, 0.00012,       90,        1,       89
CRW, 0      , 0      ,       31,        0,       31
CRY, 0      , 0      ,       56,        0,       56
CR_, 0      , 0      ,       11,        0,       11
CSC, 0      , 0      ,       29,        0,       29
CSD, 0      , 0      ,       54,        0,       54
CSE, 0.01064, 0.00011,       94,        1,       93
CSF, 0      , 0      ,       61,        0,       61
CSG, 0.03252, 0.00106,      123,        4,      119
CSH, 0      , 0      ,       43,        0,       43
CSI, 0.02941, 0.00087,      102,        3,       99
CSK, 0.01053, 0.00011,       95,        1,       94
CSL, 0      , 0      ,      139,        0,      139
CSM, 0      , 0      ,       27,        0,       27
CSN, 0      , 0      ,       83,        0,       83
CSP, 0.01587, 0.00025,       63,        1,       62
CSQ, 0.01961, 0.00038,       51,        1,       50
CSR, 0.01351, 0.00018,       74,        1,       73
CSS, 0      , 0      ,       72,        0,       72
CST, 0.01136, 0.00013,       88,        1,       87
CSV, 0.00699, 0.00005,      143,        1,      142
CSW, 0      , 0      ,       12,        0,       12
CSY, 0      , 0      ,       41,        0,       41
CS_, 0      , 0      ,        3,        0,        3
CTC, 0      , 0      ,       20,        0,       20
CTD, 0      , 0      ,       83,        0,       83
CTE, 0      , 0      ,      117,        0,      117
CTF, 0      , 0      ,       36,        0,       36
CTG, 0.02837, 0.0008 ,      141,        4,      137
CTH, 0      , 0      ,       43,        0,       43
CTI, 0.05063, 0.00256,       79,        4,       75
CTK, 0      , 0      ,       50,        0,       50
CTL, 0.0102 , 0.0001 ,       98,        1,       97
CTM, 0      , 0      ,       29,        0,       29
CTN, 0      , 0      ,       55,        0,       55
CTP, 0      , 0      ,       86,        0,       86
CTQ, 0      , 0      ,       28,        0,       28
CTR, 0      , 0      ,       62,        0,       62
CTS, 0      , 0      ,       81,        0,       81
CTT, 0      , 0      ,      112,        0,      112
CTV, 0.02105, 0.00044,       95,        2,       93
CTW, 0      , 0      ,       13,        0,       13
CTY, 0      , 0      ,       38,        0,       38
CT_, 0      , 0      ,        1,        0,        1
CVC, 0      , 0      ,        3,        0,        3
CVD, 0      , 0      ,       86,        0,       86
CVE, 0      , 0      ,      120,        0,      120
CVF, 0      , 0      ,       41,        0,       41
CVG, 0      , 0      ,      107,        0,      107
CVH, 0.04167, 0.00174,       24,        1,       23
CVI, 0      , 0      ,       79,        0,       79
CVK, 0      , 0      ,       83,        0,       83
CVL, 0      , 0      ,       87,        0,       87
CVM, 0      , 0      ,       15,        0,       15
CVN, 0      , 0      ,       74,        0,       74
CVP, 0      , 0      ,       59,        0,       59
CVQ, 0      , 0      ,       45,        0,       45
CVR, 0      , 0      ,       84,        0,       84
CVS, 0      , 0      ,       79,        0,       79
CVT, 0      , 0      ,       65,        0,       65
CVV, 0      , 0      ,       81,        0,       81
CVW, 0      , 0      ,       17,        0,       17
CVY, 0      , 0      ,       35,        0,       35
CV_, 0      , 0      ,        1,        0,        1
CWC, 0      , 0      ,        5,        0,        5
CWD, 0      , 0      ,       45,        0,       45
CWE, 0      , 0      ,       19,        0,       19
CWF, 0      , 0      ,        8,        0,        8
CWG, 0.025  , 0.00063,       40,        1,       39
CWH, 0      , 0      ,        7,        0,        7
CWI, 0      , 0      ,       14,        0,       14
CWK, 0      , 0      ,       24,        0,       24
CWL, 0      , 0      ,       28,        0,       28
CWM, 0      , 0      ,        5,        0,        5
CWN, 0      , 0      ,       18,        0,       18
CWP, 0      , 0      ,       27,        0,       27
CWQ, 0      , 0      ,       17,        0,       17
CWR, 0      , 0      ,       20,        0,       20
CWS, 0.03846, 0.00148,       26,        1,       25
CWT, 0      , 0      ,       10,        0,       10
CWV, 0      , 0      ,       18,        0,       18
CWW, 0      , 0      ,       12,        0,       12
CWY, 0      , 0      ,        9,        0,        9
CYC, 0      , 0      ,        3,        0,        3
CYD, 0.02469, 0.00061,       81,        2,       79
CYE, 0      , 0      ,       86,        0,       86
CYF, 0.03448, 0.00119,       29,        1,       28
CYG, 0.02985, 0.00089,       67,        2,       65
CYH, 0.02326, 0.00054,       43,        1,       42
CYI, 0.01724, 0.0003 ,       58,        1,       57
CYK, 0      , 0      ,       93,        0,       93
CYL, 0      , 0      ,       70,        0,       70
CYM, 0      , 0      ,       19,        0,       19
CYN, 0      , 0      ,       44,        0,       44
CYP, 0      , 0      ,       48,        0,       48
CYQ, 0      , 0      ,       17,        0,       17
CYR, 0      , 0      ,       59,        0,       59
CYS, 0      , 0      ,       63,        0,       63
CYT, 0      , 0      ,       60,        0,       60
CYV, 0      , 0      ,       62,        0,       62
CYW, 0      , 0      ,       13,        0,       13
CYY, 0      , 0      ,       36,        0,       36
DAD, 0      , 0      ,      424,        0,      424
DAE, 0.00163, 0      ,      612,        1,      611
DAF, 0.00444, 0.00002,      450,        2,      448
DAG, 0.00761, 0.00006,      920,        7,      913
DAH, 0.0339 , 0.00115,      236,        8,      228
DAI, 0.00557, 0.00003,      718,        4,      714
DAK, 0.00186, 0      ,      537,        1,      536
DAL, 0.0025 , 0.00001,     1199,        3,     1196
DAM, 0.0082 , 0.00007,      244,        2,      242
DAN, 0.01489, 0.00022,      403,        6,      397
DAP, 0.00167, 0      ,      598,        1,      597
DAQ, 0.00643, 0.00004,      311,        2,      309
DAR, 0.00219, 0      ,      457,        1,      456
DAS, 0.00343, 0.00001,      583,        2,      581
DAT, 0.00862, 0.00007,      464,        4,      460
DAV, 0      , 0      ,      827,        0,      827
DAW, 0      , 0      ,      114,        0,      114
DAY, 0.01618, 0.00026,      309,        5,      304
DA_, 0.03448, 0.00119,       29,        1,       28
DCD, 0.08333, 0.00694,       36,        3,       33
DCE, 0.01429, 0.0002 ,       70,        1,       69
DCF, 0      , 0      ,       55,        0,       55
DCG, 0      , 0      ,      149,        0,      149
DCH, 0.04167, 0.00174,       24,        1,       23
DCI, 0      , 0      ,       71,        0,       71
DCK, 0      , 0      ,       69,        0,       69
DCL, 0.00629, 0.00004,      159,        1,      158
DCM, 0      , 0      ,       42,        0,       42
DCN, 0      , 0      ,       32,        0,       32
DCP, 0      , 0      ,       34,        0,       34
DCQ, 0      , 0      ,       48,        0,       48
DCR, 0      , 0      ,       62,        0,       62
DCS, 0      , 0      ,       77,        0,       77
DCT, 0.01389, 0.00019,       72,        1,       71
DCV, 0.01351, 0.00018,       74,        1,       73
DCW, 0      , 0      ,       14,        0,       14
DCY, 0      , 0      ,       70,        0,       70
DC_, 0      , 0      ,        3,        0,        3
DDD, 0.09091, 0.00826,      198,       18,      180
DDE, 0.04403, 0.00194,      477,       21,      456
DDF, 0.02748, 0.00076,      473,       13,      460
DDG, 0.07504, 0.00563,      573,       43,      530
DDH, 0.07306, 0.00534,      219,       16,      203
DDI, 0.10526, 0.01108,      627,       66,      561
DDK, 0.01397, 0.0002 ,      358,        5,      353
DDL, 0.05983, 0.00358,      936,       56,      880
DDM, 0.01418, 0.0002 ,      141,        2,      139
DDN, 0.03354, 0.00112,      328,       11,      317
DDP, 0.02083, 0.00043,      480,       10,      470
DDQ, 0.02203, 0.00049,      227,        5,      222
DDR, 0.04032, 0.00163,      372,       15,      357
DDS, 0.03854, 0.00149,      493,       19,      474
DDT, 0.0404 , 0.00163,      495,       20,      475
DDV, 0.03827, 0.00146,      784,       30,      754
DDW, 0.048  , 0.0023 ,      125,        6,      119
DDY, 0.02089, 0.00044,      383,        8,      375
DD_, 0      , 0      ,       11,        0,       11
DED, 0.01304, 0.00017,      230,        3,      227
DEE, 0.01353, 0.00018,      739,       10,      729
DEF, 0.03509, 0.00123,      456,       16,      440
DEG, 0.01739, 0.0003 ,      575,       10,      565
DEH, 0.02116, 0.00045,      189,        4,      185
DEI, 0.03109, 0.00097,      804,       25,      779
DEK, 0.00338, 0.00001,      591,        2,      589
DEL, 0.02383, 0.00057,     1259,       30,     1229
DEM, 0.02128, 0.00045,      235,        5,      230
DEN, 0.01392, 0.00019,      431,        6,      425
DEP, 0.0434 , 0.00188,      553,       24,      529
DEQ, 0.00643, 0.00004,      311,        2,      309
DER, 0.02768, 0.00077,      578,       16,      562
DES, 0.02214, 0.00049,      542,       12,      530
DET, 0.01845, 0.00034,      542,       10,      532
DEV, 0.01722, 0.0003 ,      813,       14,      799
DEW, 0      , 0      ,      119,        0,      119
DEY, 0.01488, 0.00022,      336,        5,      331
DE_, 0.05882, 0.00346,       17,        1,       16
DFD, 0.00935, 0.00009,      214,        2,      212
DFE, 0.00515, 0.00003,      388,        2,      386
DFF, 0.00351, 0.00001,      285,        1,      284
DFG, 0.00394, 0.00002,      507,        2,      505
DFH, 0      , 0      ,      175,        0,      175
DFI, 0.00588, 0.00003,      340,        2,      338
DFK, 0.00326, 0.00001,      307,        1,      306
DFL, 0.00374, 0.00001,      535,        2,      533
DFM, 0.02542, 0.00065,      118,        3,      115
DFN, 0.00746, 0.00006,      268,        2,      266
DFP, 0.00319, 0.00001,      313,        1,      312
DFQ, 0.00645, 0.00004,      155,        1,      154
DFR, 0      , 0      ,      344,        0,      344
DFS, 0.008  , 0.00006,      375,        3,      372
DFT, 0.00291, 0.00001,      344,        1,      343
DFV, 0.00241, 0.00001,      415,        1,      414
DFW, 0      , 0      ,      101,        0,      101
DFY, 0.00446, 0.00002,      224,        1,      223
DF_, 0      , 0      ,       16,        0,       16
DGD, 0.01056, 0.00011,      284,        3,      281
DGE, 0.00663, 0.00004,      603,        4,      599
DGF, 0.00452, 0.00002,      442,        2,      440
DGG, 0.00763, 0.00006,      655,        5,      650
DGH, 0.02881, 0.00083,      243,        7,      236
DGI, 0.00923, 0.00009,      650,        6,      644
DGK, 0.00858, 0.00007,      699,        6,      693
DGL, 0.00528, 0.00003,      758,        4,      754
DGM, 0.01093, 0.00012,      183,        2,      181
DGN, 0.00833, 0.00007,      360,        3,      357
DGP, 0.00211, 0      ,      474,        1,      473
DGQ, 0.01877, 0.00035,      373,        7,      366
DGR, 0.00574, 0.00003,      523,        3,      520
DGS, 0.00575, 0.00003,      696,        4,      692
DGT, 0.0103 , 0.00011,      777,        8,      769
DGV, 0.01421, 0.0002 ,      774,       11,      763
DGW, 0      , 0      ,      128,        0,      128
DGY, 0.01183, 0.00014,      338,        4,      334
DG_, 0      , 0      ,       31,        0,       31
DHD, 0.02985, 0.00089,       67,        2,       65
DHE, 0.02721, 0.00074,      147,        4,      143
DHF, 0.02513, 0.00063,      199,        5,      194
DHG, 0.01773, 0.00031,      282,        5,      277
DHH, 0.04301, 0.00185,       93,        4,       89
DHI, 0.03556, 0.00126,      225,        8,      217
DHK, 0.00862, 0.00007,      116,        1,      115
DHL, 0.02761, 0.00076,      326,        9,      317
DHM, 0.10784, 0.01163,      102,       11,       91
DHN, 0      , 0      ,       80,        0,       80
DHP, 0.01235, 0.00015,      162,        2,      160
DHQ, 0.01   , 0.0001 ,      100,        1,       99
DHR, 0.00658, 0.00004,      152,        1,      151
DHS, 0.0625 , 0.00391,      208,       13,      195
DHT, 0.02907, 0.00085,      172,        5,      167
DHV, 0.02847, 0.00081,      281,        8,      273
DHW, 0.04255, 0.00181,       47,        2,       45
DHY, 0.04348, 0.00189,      138,        6,      132
DID, 0      , 0      ,      267,        0,      267
DIE, 0.00606, 0.00004,      660,        4,      656
DIF, 0.00635, 0.00004,      315,        2,      313
DIG, 0.00295, 0.00001,      677,        2,      675
DIH, 0.02239, 0.0005 ,      134,        3,      131
DII, 0.00577, 0.00003,      520,        3,      517
DIK, 0      , 0      ,      436,        0,      436
DIL, 0.00375, 0.00001,      801,        3,      798
DIM, 0.00606, 0.00004,      165,        1,      164
DIN, 0.0026 , 0.00001,      384,        1,      383
DIP, 0.00901, 0.00008,      444,        4,      440
DIQ, 0.02727, 0.00074,      220,        6,      214
DIR, 0.00565, 0.00003,      354,        2,      352
DIS, 0.0041 , 0.00002,      488,        2,      486
DIT, 0.00242, 0.00001,      413,        1,      412
DIV, 0.00181, 0      ,      551,        1,      550
DIW, 0      , 0      ,       89,        0,       89
DIY, 0.00407, 0.00002,      246,        1,      245
DI_, 0.04167, 0.00174,       24,        1,       23
DKD, 0.00382, 0.00001,      262,        1,      261
DKE, 0.00701, 0.00005,      571,        4,      567
DKF, 0      , 0      ,      428,        0,      428
DKG, 0.00986, 0.0001 ,      507,        5,      502
DKH, 0.0129 , 0.00017,      155,        2,      153
DKI, 0.00441, 0.00002,      681,        3,      678
DKK, 0.00457, 0.00002,      438,        2,      436
DKL, 0.00697, 0.00005,     1005,        7,      998
DKM, 0.00562, 0.00003,      178,        1,      177
DKN, 0.00641, 0.00004,      312,        2,      310
DKP, 0.00548, 0.00003,      365,        2,      363
DKQ, 0.00424, 0.00002,      236,        1,      235
DKR, 0.00649, 0.00004,      308,        2,      306
DKS, 0      , 0      ,      443,        0,      443
DKT, 0.00701, 0.00005,      428,        3,      425
DKV, 0.00145, 0      ,      689,        1,      688
DKW, 0.0596 , 0.00355,      151,        9,      142
DKY, 0.00685, 0.00005,      292,        2,      290
DK_, 0      , 0      ,       35,        0,       35
DLD, 0.00509, 0.00003,      393,        2,      391
DLE, 0.00769, 0.00006,      780,        6,      774
DLF, 0.01339, 0.00018,      448,        6,      442
DLG, 0.00521, 0.00003,      960,        5,      955
DLH, 0      , 0      ,      233,        0,      233
DLI, 0.00485, 0.00002,      618,        3,      615
DLK, 0.00353, 0.00001,      567,        2,      565
DLL, 0.00256, 0.00001,     1170,        3,     1167
DLM, 0.00326, 0.00001,      307,        1,      306
DLN, 0.00594, 0.00004,      505,        3,      502
DLP, 0.01302, 0.00017,      691,        9,      682
DLQ, 0      , 0      ,      403,        0,      403
DLR, 0      , 0      ,      513,        0,      513
DLS, 0.01556, 0.00024,      771,       12,      759
DLT, 0.00277, 0.00001,      723,        2,      721
DLV, 0.00454, 0.00002,      882,        4,      878
DLW, 0      , 0      ,      157,        0,      157
DLY, 0.00487, 0.00002,      411,        2,      409
DL_, 0.02174, 0.00047,       46,        1,       45
DMD, 0.04301, 0.00185,       93,        4,       89
DME, 0.00565, 0.00003,      177,        1,      176
DMF, 0.00962, 0.00009,      104,        1,      103
DMG, 0      , 0      ,      240,        0,      240
DMH, 0.01923, 0.00037,       52,        1,       51
DMI, 0      , 0      ,      163,        0,      163
DMK, 0      , 0      ,      116,        0,      116
DML, 0.0031 , 0.00001,      323,        1,      322
DMM, 0      , 0      ,       70,        0,       70
DMN, 0.01053, 0.00011,       95,        1,       94
DMP, 0      , 0      ,      154,        0,      154
DMQ, 0      , 0      ,       51,        0,       51
DMR, 0      , 0      ,      130,        0,      130
DMS, 0.00637, 0.00004,      157,        1,      156
DMT, 0.00685, 0.00005,      146,        1,      145
DMV, 0      , 0      ,      194,        0,      194
DMW, 0      , 0      ,       47,        0,       47
DMY, 0.01639, 0.00027,       61,        1,       60
DM_, 0      , 0      ,       48,        0,       48
DND, 0.06061, 0.00367,      165,       10,      155
DNE, 0.02279, 0.00052,      351,        8,      343
DNF, 0.00315, 0.00001,      317,        1,      316
DNG, 0.01269, 0.00016,      394,        5,      389
DNH, 0.01923, 0.00037,      104,        2,      102
DNI, 0.01717, 0.00029,      466,        8,      458
DNK, 0.03819, 0.00146,      288,       11,      277
DNL, 0.00782, 0.00006,      639,        5,      634
DNM, 0.0411 , 0.00169,      146,        6,      140
DNN, 0.03791, 0.00144,      211,        8,      203
DNP, 0.02402, 0.00058,      333,        8,      325
DNQ, 0.01053, 0.00011,      190,        2,      188
DNR, 0.01762, 0.00031,      227,        4,      223
DNS, 0.0412 , 0.0017 ,      267,       11,      256
DNT, 0.0129 , 0.00017,      310,        4,      306
DNV, 0.02509, 0.00063,      558,       14,      544
DNW, 0.0495 , 0.00245,      101,        5,       96
DNY, 0.00549, 0.00003,      182,        1,      181
DN_, 0.04167, 0.00174,       24,        1,       23
DPD, 0.00355, 0.00001,      282,        1,      281
DPE, 0.00371, 0.00001,      539,        2,      537
DPF, 0.01645, 0.00027,      304,        5,      299
DPG, 0      , 0      ,      394,        0,      394
DPH, 0.00515, 0.00003,      194,        1,      193
DPI, 0.00253, 0.00001,      396,        1,      395
DPK, 0.01795, 0.00032,      390,        7,      383
DPL, 0.00169, 0      ,      593,        1,      592
DPM, 0      , 0      ,      141,        0,      141
DPN, 0      , 0      ,      565,        0,      565
DPP, 0      , 0      ,      188,        0,      188
DPQ, 0      , 0      ,      287,        0,      287
DPR, 0.00193, 0      ,      518,        1,      517
DPS, 0.00561, 0.00003,      535,        3,      532
DPT, 0.00208, 0      ,      480,        1,      479
DPV, 0.00421, 0.00002,      475,        2,      473
DPW, 0      , 0      ,       92,        0,       92
DPY, 0.00357, 0.00001,      280,        1,      279
DP_, 0      , 0      ,       16,        0,       16
DQD, 0.0082 , 0.00007,      122,        1,      121
DQE, 0.00397, 0.00002,      252,        1,      251
DQF, 0      , 0      ,      233,        0,      233
DQG, 0.03409, 0.00116,      264,        9,      255
DQH, 0.02083, 0.00043,       96,        2,       94
DQI, 0      , 0      ,      331,        0,      331
DQK, 0.00599, 0.00004,      167,        1,      166
DQL, 0.01165, 0.00014,      601,        7,      594
DQM, 0.0155 , 0.00024,      129,        2,      127
DQN, 0.00488, 0.00002,      205,        1,      204
DQP, 0.0073 , 0.00005,      274,        2,      272
DQQ, 0.01657, 0.00027,      181,        3,      178
DQR, 0.01807, 0.00033,      166,        3,      163
DQS, 0.03241, 0.00105,      216,        7,      209
DQT, 0.00873, 0.00008,      229,        2,      227
DQV, 0.00726, 0.00005,      413,        3,      410
DQW, 0.01408, 0.0002 ,      142,        2,      140
DQY, 0      , 0      ,      179,        0,      179
DQ_, 0      , 0      ,       17,        0,       17
DRD, 0.01802, 0.00032,      222,        4,      218
DRE, 0.00661, 0.00004,      454,        3,      451
DRF, 0.0073 , 0.00005,      411,        3,      408
DRG, 0.01139, 0.00013,      439,        5,      434
DRH, 0.01818, 0.00033,      220,        4,      216
DRI, 0.0102 , 0.0001 ,      686,        7,      679
DRK, 0.00923, 0.00009,      325,        3,      322
DRL, 0.00391, 0.00002,     1022,        4,     1018
DRM, 0.00444, 0.00002,      225,        1,      224
DRN, 0.0033 , 0.00001,      303,        1,      302
DRP, 0.0407 , 0.00166,      344,       14,      330
DRQ, 0.00758, 0.00006,      264,        2,      262
DRR, 0      , 0      ,      338,        0,      338
DRS, 0.00701, 0.00005,      428,        3,      425
DRT, 0.01323, 0.00017,      378,        5,      373
DRV, 0.00512, 0.00003,      781,        4,      777
DRW, 0.00621, 0.00004,      161,        1,      160
DRY, 0.00268, 0.00001,      373,        1,      372
DR_, 0      , 0      ,       13,        0,       13
DSD, 0      , 0      ,      197,        0,      197
DSE, 0.01171, 0.00014,      427,        5,      422
DSF, 0.00645, 0.00004,      465,        3,      462
DSG, 0.00935, 0.00009,      535,        5,      530
DSH, 0.00694, 0.00005,      144,        1,      143
DSI, 0.00163, 0      ,      615,        1,      614
DSK, 0      , 0      ,      346,        0,      346
DSL, 0.01339, 0.00018,      971,       13,      958
DSM, 0      , 0      ,      143,        0,      143
DSN, 0.00583, 0.00003,      343,        2,      341
DSP, 0.00239, 0.00001,      418,        1,      417
DSQ, 0.00985, 0.0001 ,      203,        2,      201
DSR, 0      , 0      ,      314,        0,      314
DSS, 0.00964, 0.00009,      415,        4,      411
DST, 0.01609, 0.00026,      435,        7,      428
DSV, 0.00985, 0.0001 ,      609,        6,      603
DSW, 0.00833, 0.00007,      120,        1,      119
DSY, 0.01299, 0.00017,      308,        4,      304
DS_, 0      , 0      ,       15,        0,       15
DTD, 0.02688, 0.00072,      186,        5,      181
DTE, 0.0169 , 0.00029,      355,        6,      349
DTF, 0      , 0      ,      390,        0,      390
DTG, 0.0043 , 0.00002,      465,        2,      463
DTH, 0.02941, 0.00087,      170,        5,      165
DTI, 0.00444, 0.00002,      450,        2,      448
DTK, 0.0102 , 0.0001 ,      294,        3,      291
DTL, 0.00622, 0.00004,      804,        5,      799
DTM, 0.02128, 0.00045,      141,        3,      138
DTN, 0.01689, 0.00029,      296,        5,      291
DTP, 0.02096, 0.00044,      334,        7,      327
DTQ, 0.00476, 0.00002,      210,        1,      209
DTR, 0.00331, 0.00001,      302,        1,      301
DTS, 0.01639, 0.00027,      427,        7,      420
DTT, 0.00279, 0.00001,      359,        1,      358
DTV, 0.0122 , 0.00015,      656,        8,      648
DTW, 0.01923, 0.00037,      104,        2,      102
DTY, 0.01938, 0.00038,      258,        5,      253
DT_, 0.0625 , 0.00391,       16,        1,       15
DVD, 0.00282, 0.00001,      354,        1,      353
DVE, 0.01774, 0.00031,      620,       11,      609
DVF, 0.01737, 0.0003 ,      403,        7,      396
DVG, 0.00613, 0.00004,      653,        4,      649
DVH, 0.01523, 0.00023,      197,        3,      194
DVI, 0.00417, 0.00002,      480,        2,      478
DVK, 0.00676, 0.00005,      444,        3,      441
DVL, 0.00207, 0      ,      964,        2,      962
DVM, 0      , 0      ,      147,        0,      147
DVN, 0      , 0      ,      420,        0,      420
DVP, 0.00386, 0.00001,      518,        2,      516
DVQ, 0.01027, 0.00011,      292,        3,      289
DVR, 0      , 0      ,      420,        0,      420
DVS, 0.01978, 0.00039,      556,       11,      545
DVT, 0.00193, 0      ,      518,        1,      517
DVV, 0.00144, 0      ,      695,        1,      694
DVW, 0      , 0      ,       79,        0,       79
DVY, 0.00719, 0.00005,      278,        2,      276
DV_, 0      , 0      ,       27,        0,       27
DWD, 0      , 0      ,       34,        0,       34
DWE, 0.00769, 0.00006,      130,        1,      129
DWF, 0      , 0      ,       79,        0,       79
DWG, 0      , 0      ,      172,        0,      172
DWH, 0      , 0      ,       86,        0,       86
DWI, 0      , 0      ,      161,        0,      161
DWK, 0      , 0      ,      106,        0,      106
DWL, 0      , 0      ,      227,        0,      227
DWM, 0      , 0      ,       31,        0,       31
DWN, 0.04082, 0.00167,       98,        4,       94
DWP, 0      , 0      ,       95,        0,       95
DWQ, 0      , 0      ,       87,        0,       87
DWR, 0      , 0      ,       82,        0,       82
DWS, 0.00725, 0.00005,      138,        1,      137
DWT, 0.01379, 0.00019,      145,        2,      143
DWV, 0.01471, 0.00022,      136,        2,      134
DWW, 0      , 0      ,       42,        0,       42
DWY, 0      , 0      ,       88,        0,       88
DW_, 0      , 0      ,        2,        0,        2
DYD, 0      , 0      ,      173,        0,      173
DYE, 0.00637, 0.00004,      314,        2,      312
DYF, 0      , 0      ,      270,        0,      270
DYG, 0.00526, 0.00003,      380,        2,      378
DYH, 0      , 0      ,      162,        0,      162
DYI, 0.00249, 0.00001,      402,        1,      401
DYK, 0.01042, 0.00011,      288,        3,      285
DYL, 0.00822, 0.00007,      608,        5,      603
DYM, 0      , 0      ,      103,        0,      103
DYN, 0.0076 , 0.00006,      263,        2,      261
DYP, 0.01384, 0.00019,      289,        4,      285
DYQ, 0.01515, 0.00023,      198,        3,      195
DYR, 0      , 0      ,      266,        0,      266
DYS, 0.01124, 0.00013,      356,        4,      352
DYT, 0      , 0      ,      313,        0,      313
DYV, 0.00683, 0.00005,      439,        3,      436
DYW, 0.00962, 0.00009,      104,        1,      103
DYY, 0      , 0      ,      278,        0,      278
DY_, 0      , 0      ,       13,        0,       13
EAE, 0.0086 , 0.00007,      349,        3,      346
EAF, 0.00445, 0.00002,      449,        2,      447
EAG, 0.00111, 0      ,      904,        1,      903
EAH, 0.00463, 0.00002,      216,        1,      215
EAI, 0.00118, 0      ,      851,        1,      850
EAK, 0      , 0      ,      535,        0,      535
EAL, 0.00242, 0.00001,     1651,        4,     1647
EAM, 0      , 0      ,      331,        0,      331
EAN, 0      , 0      ,      402,        0,      402
EAP, 0.00412, 0.00002,      486,        2,      484
EAQ, 0      , 0      ,      400,        0,      400
EAR, 0      , 0      ,      617,        0,      617
EAS, 0.00154, 0      ,      648,        1,      647
EAT, 0.00901, 0.00008,      555,        5,      550
EAV, 0.00435, 0.00002,      920,        4,      916
EAW, 0      , 0      ,      181,        0,      181
EAY, 0      , 0      ,      371,        0,      371
EA_, 0      , 0      ,       50,        0,       50
ECE, 0      , 0      ,       42,        0,       42
ECF, 0.01852, 0.00034,       54,        1,       53
ECG, 0      , 0      ,      147,        0,      147
ECH, 0      , 0      ,       44,        0,       44
ECI, 0      , 0      ,       86,        0,       86
ECK, 0.02326, 0.00054,       86,        2,       84
ECL, 0      , 0      ,      124,        0,      124
ECM, 0      , 0      ,       18,        0,       18
ECN, 0      , 0      ,       43,        0,       43
ECP, 0      , 0      ,       55,        0,       55
ECQ, 0      , 0      ,       34,        0,       34
ECR, 0      , 0      ,       72,        0,       72
ECS, 0.01111, 0.00012,       90,        1,       89
ECT, 0      , 0      ,       32,        0,       32
ECV, 0      , 0      ,       99,        0,       99
ECW, 0      , 0      ,       20,        0,       20
ECY, 0      , 0      ,       72,        0,       72
EC_, 0      , 0      ,        3,        0,        3
EDE, 0.01413, 0.0002 ,      283,        4,      279
EDF, 0.03063, 0.00094,      555,       17,      538
EDG, 0.01966, 0.00039,      712,       14,      698
EDH, 0.03209, 0.00103,      187,        6,      181
EDI, 0.02662, 0.00071,      939,       25,      914
EDK, 0.01856, 0.00034,      431,        8,      423
EDL, 0.03175, 0.00101,     1197,       38,     1159
EDM, 0.05941, 0.00353,      303,       18,      285
EDN, 0.04638, 0.00215,      345,       16,      329
EDP, 0.00849, 0.00007,      471,        4,      467
EDQ, 0.0249 , 0.00062,      241,        6,      235
EDR, 0.00569, 0.00003,      527,        3,      524
EDS, 0.03393, 0.00115,      501,       17,      484
EDT, 0.0061 , 0.00004,      492,        3,      489
EDV, 0.03406, 0.00116,      969,       33,      936
EDW, 0.00833, 0.00007,      120,        1,      119
EDY, 0.01386, 0.00019,      433,        6,      427
ED_, 0      , 0      ,       32,        0,       32
EEE, 0.01075, 0.00012,      465,        5,      460
EEF, 0.0174 , 0.0003 ,      747,       13,      734
EEG, 0.01469, 0.00022,      885,       13,      872
EEH, 0.02101, 0.00044,      238,        5,      233
EEI, 0.00874, 0.00008,     1030,        9,     1021
EEK, 0.00617, 0.00004,      810,        5,      805
EEL, 0.01005, 0.0001 ,     1791,       18,     1773
EEM, 0.02604, 0.00068,      384,       10,      374
EEN, 0.00628, 0.00004,      478,        3,      475
EEP, 0      , 0      ,      703,        0,      703
EEQ, 0.00998, 0.0001 ,      401,        4,      397
EER, 0.00677, 0.00005,      739,        5,      734
EES, 0.02568, 0.00066,      662,       17,      645
EET, 0.03292, 0.00108,      729,       24,      705
EEV, 0.01627, 0.00026,     1168,       19,     1149
EEW, 0      , 0      ,      189,        0,      189
EEY, 0.02004, 0.0004 ,      499,       10,      489
EE_, 0      , 0      ,       36,        0,       36
EFE, 0      , 0      ,      177,        0,      177
EFF, 0.01339, 0.00018,      224,        3,      221
EFG, 0.00202, 0      ,      495,        1,      494
EFH, 0      , 0      ,      161,        0,      161
EFI, 0      , 0      ,      310,        0,      310
EFK, 0      , 0      ,      268,        0,      268
EFL, 0      , 0      ,      499,        0,      499
EFM, 0      , 0      ,      149,        0,      149
EFN, 0.00844, 0.00007,      237,        2,      235
EFP, 0      , 0      ,      260,        0,      260
EFQ, 0      , 0      ,      187,        0,      187
EFR, 0.01402, 0.0002 ,      214,        3,      211
EFS, 0.00294, 0.00001,      340,        1,      339
EFT, 0.00329, 0.00001,      304,        1,      303
EFV, 0.00294, 0.00001,      340,        1,      339
EFW, 0      , 0      ,       94,        0,       94
EFY, 0      , 0      ,      182,        0,      182
EF_, 0      , 0      ,       18,        0,       18
EGE, 0      , 0      ,      409,        0,      409
EGF, 0      , 0      ,      491,        0,      491
EGG, 0      , 0      ,      737,        0,      737
EGH, 0.01277, 0.00016,      235,        3,      232
EGI, 0.00152, 0      ,      657,        1,      656
EGK, 0.00394, 0.00002,      762,        3,      759
EGL, 0.00197, 0      ,     1013,        2,     1011
EGM, 0.00417, 0.00002,      240,        1,      239
EGN, 0.00625, 0.00004,      480,        3,      477
EGP, 0      , 0      ,      423,        0,      423
EGQ, 0.00612, 0.00004,      327,        2,      325
EGR, 0.00168, 0      ,      596,        1,      595
EGS, 0.00358, 0.00001,      558,        2,      556
EGT, 0.00151, 0      ,      662,        1,      661
EGV, 0.00435, 0.00002,      690,        3,      687
EGW, 0      , 0      ,      127,        0,      127
EGY, 0.00265, 0.00001,      377,        1,      376
EG_, 0      , 0      ,       33,        0,       33
EHE, 0.02174, 0.00047,       92,        2,       90
EHF, 0.0107 , 0.00011,      187,        2,      185
EHG, 0.02308, 0.00053,      260,        6,      254
EHH, 0.05357, 0.00287,      112,        6,      106
EHI, 0.00651, 0.00004,      307,        2,      305
EHK, 0      , 0      ,      135,        0,      135
EHL, 0.02209, 0.00049,      498,       11,      487
EHM, 0      , 0      ,       86,        0,       86
EHN, 0.0404 , 0.00163,       99,        4,       95
EHP, 0.00565, 0.00003,      177,        1,      176
EHQ, 0      , 0      ,       97,        0,       97
EHR, 0.00526, 0.00003,      190,        1,      189
EHS, 0.03784, 0.00143,      185,        7,      178
EHT, 0.02062, 0.00043,      194,        4,      190
EHV, 0.02247, 0.0005 ,      267,        6,      261
EHW, 0.01639, 0.00027,       61,        1,       60
EHY, 0      , 0      ,      134,        0,      134
EH_, 0      , 0      ,       39,        0,       39
EIE, 0      , 0      ,      270,        0,      270
EIF, 0      , 0      ,      365,        0,      365
EIG, 0.0052 , 0.00003,      577,        3,      574
EIH, 0      , 0      ,      161,        0,      161
EII, 0      , 0      ,      545,        0,      545
EIK, 0.01713, 0.00029,      467,        8,      459
EIL, 0.00252, 0.00001,      794,        2,      792
EIM, 0      , 0      ,      151,        0,      151
EIN, 0.00288, 0.00001,      347,        1,      346
EIP, 0.00278, 0.00001,      360,        1,      359
EIQ, 0.00826, 0.00007,      242,        2,      240
EIR, 0      , 0      ,      445,        0,      445
EIS, 0      , 0      ,      577,        0,      577
EIT, 0      , 0      ,      442,        0,      442
EIV, 0.00195, 0      ,      514,        1,      513
EIW, 0      , 0      ,       73,        0,       73
EIY, 0      , 0      ,      197,        0,      197
EI_, 0      , 0      ,       26,        0,       26
EKE, 0.0137 , 0.00019,      365,        5,      360
EKF, 0.00194, 0      ,      515,        1,      514
EKG, 0.00834, 0.00007,      839,        7,      832
EKH, 0.01389, 0.00019,      288,        4,      284
EKI, 0.00102, 0      ,      984,        1,      983
EKK, 0.00184, 0      ,      544,        1,      543
EKL, 0.00568, 0.00003,     1760,       10,     1750
EKM, 0.00283, 0.00001,      353,        1,      352
EKN, 0.00525, 0.00003,      381,        2,      379
EKP, 0.00875, 0.00008,      457,        4,      453
EKQ, 0.00567, 0.00003,      353,        2,      351
EKR, 0.00383, 0.00001,      522,        2,      520
EKS, 0.00166, 0      ,      602,        1,      601
EKT, 0.00766, 0.00006,      522,        4,      518
EKV, 0.00532, 0.00003,      939,        5,      934
EKW, 0.00599, 0.00004,      167,        1,      166
EKY, 0.00205, 0      ,      488,        1,      487
EK_, 0      , 0      ,       52,        0,       52
ELE, 0      , 0      ,      463,        0,      463
ELF, 0.00411, 0.00002,      487,        2,      485
ELG, 0      , 0      ,     1136,        0,     1136
ELH, 0      , 0      ,      284,        0,      284
ELI, 0      , 0      ,      835,        0,      835
ELK, 0.00408, 0.00002,      736,        3,      733
ELL, 0.00137, 0      ,     1464,        2,     1462
ELM, 0      , 0      ,      357,        0,      357
ELN, 0.00642, 0.00004,      467,        3,      464
ELP, 0.00155, 0      ,      647,        1,      646
ELQ, 0      , 0      ,      386,        0,      386
ELR, 0.00593, 0.00004,      675,        4,      671
ELS, 0      , 0      ,      740,        0,      740
ELT, 0.00152, 0      ,      660,        1,      659
ELV, 0.00104, 0      ,      964,        1,      963
ELW, 0      , 0      ,      182,        0,      182
ELY, 0      , 0      ,      380,        0,      380
EL_, 0      , 0      ,       47,        0,       47
EME, 0      , 0      ,      108,        0,      108
EMF, 0.04348, 0.00189,       92,        4,       88
EMG, 0      , 0      ,      244,        0,      244
EMH, 0      , 0      ,       84,        0,       84
EMI, 0      , 0      ,      165,        0,      165
EMK, 0      , 0      ,      144,        0,      144
EML, 0.00255, 0.00001,      392,        1,      391
EMM, 0      , 0      ,       94,        0,       94
EMN, 0      , 0      ,      118,        0,      118
EMP, 0      , 0      ,      160,        0,      160
EMQ, 0.0082 , 0.00007,      122,        1,      121
EMR, 0      , 0      ,      155,        0,      155
EMS, 0.00457, 0.00002,      219,        1,      218
EMT, 0      , 0      ,      184,        0,      184
EMV, 0.00364, 0.00001,      275,        1,      274
EMW, 0      , 0      ,       41,        0,       41
EMY, 0.02469, 0.00061,       81,        2,       79
EM_, 0.02247, 0.0005 ,       89,        2,       87
ENE, 0.00966, 0.00009,      207,        2,      205
ENF, 0      , 0      ,      351,        0,      351
ENG, 0.00514, 0.00003,      584,        3,      581
ENH, 0      , 0      ,      124,        0,      124
ENI, 0.02867, 0.00082,      558,       16,      542
ENK, 0.00612, 0.00004,      327,        2,      325
ENL, 0.0104 , 0.00011,      769,        8,      761
ENM, 0.0061 , 0.00004,      164,        1,      163
ENN, 0.00656, 0.00004,      305,        2,      303
ENP, 0.03747, 0.0014 ,      427,       16,      411
ENQ, 0.01   , 0.0001 ,      200,        2,      198
ENR, 0.00623, 0.00004,      321,        2,      319
ENS, 0.00809, 0.00007,      371,        3,      368
ENT, 0.01167, 0.00014,      257,        3,      254
ENV, 0.00705, 0.00005,      567,        4,      563
ENW, 0      , 0      ,      102,        0,      102
ENY, 0      , 0      ,      278,        0,      278
EN_, 0      , 0      ,       21,        0,       21
EPE, 0      , 0      ,      256,        0,      256
EPF, 0      , 0      ,      375,        0,      375
EPG, 0.00674, 0.00005,      445,        3,      442
EPH, 0      , 0      ,      285,        0,      285
EPI, 0.00192, 0      ,      521,        1,      520
EPK, 0      , 0      ,      414,        0,      414
EPL, 0.00611, 0.00004,      982,        6,      976
EPM, 0      , 0      ,      178,        0,      178
EPN, 0.00308, 0.00001,      325,        1,      324
EPP, 0      , 0      ,      424,        0,      424
EPQ, 0.00407, 0.00002,      246,        1,      245
EPR, 0      , 0      ,      343,        0,      343
EPS, 0.00364, 0.00001,      550,        2,      548
EPT, 0      , 0      ,      575,        0,      575
EPV, 0      , 0      ,      578,        0,      578
EPW, 0.0098 , 0.0001 ,      102,        1,      101
EPY, 0.00287, 0.00001,      349,        1,      348
EP_, 0      , 0      ,       29,        0,       29
EQE, 0.01205, 0.00015,      166,        2,      164
EQF, 0      , 0      ,      311,        0,      311
EQG, 0.00228, 0.00001,      438,        1,      437
EQH, 0.03077, 0.00095,      130,        4,      126
EQI, 0      , 0      ,      480,        0,      480
EQK, 0      , 0      ,      307,        0,      307
EQL, 0.00551, 0.00003,      908,        5,      903
EQM, 0.00966, 0.00009,      207,        2,      205
EQN, 0.00592, 0.00004,      169,        1,      168
EQP, 0.0119 , 0.00014,      336,        4,      332
EQQ, 0.0037 , 0.00001,      270,        1,      269
EQR, 0.00311, 0.00001,      322,        1,      321
EQS, 0.00694, 0.00005,      288,        2,      286
EQT, 0.00588, 0.00003,      340,        2,      338
EQV, 0.00407, 0.00002,      491,        2,      489
EQW, 0      , 0      ,      159,        0,      159
EQY, 0      , 0      ,      240,        0,      240
EQ_, 0      , 0      ,       13,        0,       13
ERE, 0.00549, 0.00003,      364,        2,      362
ERF, 0.00797, 0.00006,      502,        4,      498
ERG, 0.00713, 0.00005,      701,        5,      696
ERH, 0.00549, 0.00003,      182,        1,      181
ERI, 0.00675, 0.00005,      889,        6,      883
ERK, 0.01296, 0.00017,      463,        6,      457
ERL, 0.00325, 0.00001,     1538,        5,     1533
ERM, 0.00997, 0.0001 ,      301,        3,      298
ERN, 0      , 0      ,      318,        0,      318
ERP, 0.01282, 0.00016,      390,        5,      385
ERQ, 0.01159, 0.00013,      345,        4,      341
ERR, 0.00505, 0.00003,      594,        3,      591
ERS, 0      , 0      ,      444,        0,      444
ERT, 0.0076 , 0.00006,      526,        4,      522
ERV, 0.00806, 0.00007,      868,        7,      861
ERW, 0      , 0      ,      176,        0,      176
ERY, 0.01188, 0.00014,      421,        5,      416
ER_, 0      , 0      ,       31,        0,       31
ESE, 0.01278, 0.00016,      313,        4,      309
ESF, 0.00378, 0.00001,      529,        2,      527
ESG, 0.00469, 0.00002,      640,        3,      637
ESH, 0.01852, 0.00034,      162,        3,      159
ESI, 0.00319, 0.00001,      627,        2,      625
ESK, 0.01099, 0.00012,      364,        4,      360
ESL, 0.00277, 0.00001,     1082,        3,     1079
ESM, 0.00444, 0.00002,      225,        1,      224
ESN, 0      , 0      ,      285,        0,      285
ESP, 0      , 0      ,      320,        0,      320
ESQ, 0.00939, 0.00009,      213,        2,      211
ESR, 0.00559, 0.00003,      358,        2,      356
ESS, 0.00911, 0.00008,      439,        4,      435
EST, 0.00526, 0.00003,      380,        2,      378
ESV, 0.00739, 0.00005,      677,        5,      672
ESW, 0.00709, 0.00005,      141,        1,      140
ESY, 0.01718, 0.0003 ,      291,        5,      286
ES_, 0      , 0      ,       64,        0,       64
ETE, 0      , 0      ,      192,        0,      192
ETF, 0.00546, 0.00003,      366,        2,      364
ETG, 0.0134 , 0.00018,      597,        8,      589
ETH, 0      , 0      ,      165,        0,      165
ETI, 0.00915, 0.00008,      656,        6,      650
ETK, 0.01437, 0.00021,      348,        5,      343
ETL, 0.00312, 0.00001,      961,        3,      958
ETM, 0.00917, 0.00008,      218,        2,      216
ETN, 0.00369, 0.00001,      271,        1,      270
ETP, 0      , 0      ,      365,        0,      365
ETQ, 0.02456, 0.0006 ,      285,        7,      278
ETR, 0      , 0      ,      331,        0,      331
ETS, 0      , 0      ,      374,        0,      374
ETT, 0.00803, 0.00006,      498,        4,      494
ETV, 0.00643, 0.00004,      622,        4,      618
ETW, 0.00909, 0.00008,      110,        1,      109
ETY, 0.00422, 0.00002,      237,        1,      236
ET_, 0.03571, 0.00128,       28,        1,       27
EVE, 0.00568, 0.00003,      352,        2,      350
EVF, 0      , 0      ,      448,        0,      448
EVG, 0.00794, 0.00006,      630,        5,      625
EVH, 0      , 0      ,      216,        0,      216
EVI, 0      , 0      ,      612,        0,      612
EVK, 0.00195, 0      ,      514,        1,      513
EVL, 0.00187, 0      ,     1070,        2,     1068
EVM, 0      , 0      ,      230,        0,      230
EVN, 0.01385, 0.00019,      361,        5,      356
EVP, 0      , 0      ,      541,        0,      541
EVQ, 0.02   , 0.0004 ,      300,        6,      294
EVR, 0      , 0      ,      468,        0,      468
EVS, 0.00723, 0.00005,      553,        4,      549
EVT, 0.00588, 0.00003,      510,        3,      507
EVV, 0      , 0      ,      721,        0,      721
EVW, 0      , 0      ,      135,        0,      135
EVY, 0.00725, 0.00005,      276,        2,      274
EV_, 0      , 0      ,       25,        0,       25
EWE, 0      , 0      ,       76,        0,       76
EWF, 0      , 0      ,      101,        0,      101
EWG, 0      , 0      ,      129,        0,      129
EWH, 0      , 0      ,       66,        0,       66
EWI, 0.01802, 0.00032,      111,        2,      109
EWK, 0      , 0      ,      123,        0,      123
EWL, 0      , 0      ,      274,        0,      274
EWM, 0      , 0      ,       86,        0,       86
EWN, 0      , 0      ,       82,        0,       82
EWP, 0      , 0      ,       87,        0,       87
EWQ, 0.02041, 0.00042,       98,        2,       96
EWR, 0.01961, 0.00038,      102,        2,      100
EWS, 0      , 0      ,      109,        0,      109
EWT, 0      , 0      ,      120,        0,      120
EWV, 0      , 0      ,      161,        0,      161
EWW, 0      , 0      ,       27,        0,       27
EWY, 0      , 0      ,       76,        0,       76
EW_, 0      , 0      ,        2,        0,        2
EYE, 0      , 0      ,      156,        0,      156
EYF, 0      , 0      ,      267,        0,      267
EYG, 0.00251, 0.00001,      399,        1,      398
EYH, 0.01852, 0.00034,      108,        2,      106
EYI, 0      , 0      ,      355,        0,      355
EYK, 0      , 0      ,      226,        0,      226
EYL, 0.00202, 0      ,      496,        1,      495
EYM, 0      , 0      ,      116,        0,      116
EYN, 0.00508, 0.00003,      197,        1,      196
EYP, 0      , 0      ,      233,        0,      233
EYQ, 0.00515, 0.00003,      194,        1,      193
EYR, 0.00781, 0.00006,      256,        2,      254
EYS, 0      , 0      ,      310,        0,      310
EYT, 0.00858, 0.00007,      233,        2,      231
EYV, 0.0274 , 0.00075,      438,       12,      426
EYW, 0      , 0      ,       68,        0,       68
EYY, 0      , 0      ,      179,        0,      179
EY_, 0.22222, 0.04938,        9,        2,        7
FAF, 0      , 0      ,       64,        0,       64
FAG, 0.00711, 0.00005,      422,        3,      419
FAH, 0.01626, 0.00026,      123,        2,      121
FAI, 0      , 0      ,      223,        0,      223
FAK, 0      , 0      ,      353,        0,      353
FAL, 0      , 0      ,      425,        0,      425
FAM, 0      , 0      ,      107,        0,      107
FAN, 0      , 0      ,      244,        0,      244
FAP, 0      , 0      ,      300,        0,      300
FAQ, 0      , 0      ,      237,        0,      237
FAR, 0      , 0      ,      421,        0,      421
FAS, 0.00268, 0.00001,      373,        1,      372
FAT, 0.00623, 0.00004,      321,        2,      319
FAV, 0      , 0      ,      301,        0,      301
FAW, 0.01493, 0.00022,       67,        1,       66
FAY, 0      , 0      ,      107,        0,      107
FA_, 0      , 0      ,       28,        0,       28
FCF, 0      , 0      ,       13,        0,       13
FCG, 0.06154, 0.00379,       65,        4,       61
FCH, 0      , 0      ,       18,        0,       18
FCI, 0      , 0      ,       27,        0,       27
FCK, 0.01887, 0.00036,       53,        1,       52
FCL, 0      , 0      ,       57,        0,       57
FCM, 0      , 0      ,        1,        0,        1
FCN, 0      , 0      ,       42,        0,       42
FCP, 0.03125, 0.00098,       32,        1,       31
FCQ, 0      , 0      ,       17,        0,       17
FCR, 0.02857, 0.00082,       70,        2,       68
FCS, 0      , 0      ,       46,        0,       46
FCT, 0      , 0      ,       31,        0,       31
FCV, 0      , 0      ,       31,        0,       31
FCW, 0      , 0      ,        9,        0,        9
FCY, 0.07692, 0.00592,       26,        2,       24
FDF, 0.05528, 0.00306,      199,       11,      188
FDG, 0.05937, 0.00353,      640,       38,      602
FDH, 0.05161, 0.00266,      155,        8,      147
FDI, 0.07253, 0.00526,      455,       33,      422
FDK, 0.02802, 0.00078,      464,       13,      451
FDL, 0.05564, 0.0031 ,      647,       36,      611
FDM, 0.18548, 0.0344 ,      124,       23,      101
FDN, 0.05363, 0.00288,      317,       17,      300
FDP, 0.02603, 0.00068,      461,       12,      449
FDQ, 0.02299, 0.00053,      261,        6,      255
FDR, 0.02158, 0.00047,      417,        9,      408
FDS, 0.03722, 0.00139,      403,       15,      388
FDT, 0.04848, 0.00235,      330,       16,      314
FDV, 0.05253, 0.00276,      533,       28,      505
FDW, 0.02299, 0.00053,       87,        2,       85
FDY, 0.04301, 0.00185,      279,       12,      267
FD_, 0      , 0      ,       12,        0,       12
FEF, 0.02609, 0.00068,      115,        3,      112
FEG, 0.02119, 0.00045,      519,       11,      508
FEH, 0.04487, 0.00201,      156,        7,      149
FEI, 0.03722, 0.00139,      403,       15,      388
FEK, 0.01498, 0.00022,      534,        8,      526
FEL, 0.0501 , 0.00251,      499,       25,      474
FEM, 0      , 0      ,      176,        0,      176
FEN, 0.01038, 0.00011,      289,        3,      286
FEP, 0.01493, 0.00022,      335,        5,      330
FEQ, 0.00673, 0.00005,      297,        2,      295
FER, 0.02433, 0.00059,      411,       10,      401
FES, 0.01385, 0.00019,      361,        5,      356
FET, 0.02459, 0.0006 ,      366,        9,      357
FEV, 0.01793, 0.00032,      502,        9,      493
FEW, 0.01266, 0.00016,       79,        1,       78
FEY, 0.00524, 0.00003,      191,        1,      190
FE_, 0      , 0      ,       39,        0,       39
FFF, 0      , 0      ,       50,        0,       50
FFG, 0.00452, 0.00002,      221,        1,      220
FFH, 0      , 0      ,       74,        0,       74
FFI, 0.0084 , 0.00007,      119,        1,      118
FFK, 0      , 0      ,      192,        0,      192
FFL, 0      , 0      ,      150,        0,      150
FFM, 0      , 0      ,       51,        0,       51
FFN, 0.00752, 0.00006,      133,        1,      132
FFP, 0.00472, 0.00002,      212,        1,      211
FFQ, 0.01709, 0.00029,      117,        2,      115
FFR, 0.01105, 0.00012,      181,        2,      179
FFS, 0      , 0      ,      189,        0,      189
FFT, 0      , 0      ,      139,        0,      139
FFV, 0      , 0      ,      139,        0,      139
FFW, 0      , 0      ,       46,        0,       46
FFY, 0      , 0      ,      103,        0,      103
FF_, 0      , 0      ,        8,        0,        8
FGF, 0      , 0      ,       93,        0,       93
FGG, 0.00958, 0.00009,      522,        5,      517
FGH, 0      , 0      ,      170,        0,      170
FGI, 0      , 0      ,      282,        0,      282
FGK, 0.00517, 0.00003,      387,        2,      385
FGL, 0.01107, 0.00012,      542,        6,      536
FGM, 0      , 0      ,      116,        0,      116
FGN, 0      , 0      ,      297,        0,      297
FGP, 0.00888, 0.00008,      338,        3,      335
FGQ, 0.00481, 0.00002,      208,        1,      207
FGR, 0.00348, 0.00001,      287,        1,      286
FGS, 0.00756, 0.00006,      397,        3,      394
FGT, 0.00536, 0.00003,      373,        2,      371
FGV, 0      , 0      ,      316,        0,      316
FGW, 0      , 0      ,       79,        0,       79
FGY, 0      , 0      ,      211,        0,      211
FG_, 0      , 0      ,       42,        0,       42
FHF, 0      , 0      ,       36,        0,       36
FHG, 0.05195, 0.0027 ,      154,        8,      146
FHH, 0.04762, 0.00227,       84,        4,       80
FHI, 0.00813, 0.00007,      123,        1,      122
FHK, 0.02098, 0.00044,      143,        3,      140
FHL, 0.01154, 0.00013,      260,        3,      257
FHM, 0      , 0      ,       50,        0,       50
FHN, 0.05217, 0.00272,      115,        6,      109
FHP, 0      , 0      ,      165,        0,      165
FHQ, 0.0101 , 0.0001 ,       99,        1,       98
FHR, 0.00588, 0.00003,      170,        1,      169
FHS, 0.00575, 0.00003,      174,        1,      173
FHT, 0.01667, 0.00028,      180,        3,      177
FHV, 0.01754, 0.00031,      171,        3,      168
FHW, 0      , 0      ,       34,        0,       34
FHY, 0      , 0      ,      112,        0,      112
FH_, 0      , 0      ,       16,        0,       16
FIF, 0      , 0      ,       43,        0,       43
FIG, 0.00463, 0.00002,      216,        1,      215
FIH, 0      , 0      ,       70,        0,       70
FII, 0      , 0      ,      145,        0,      145
FIK, 0.02326, 0.00054,      301,        7,      294
FIL, 0.0049 , 0.00002,      204,        1,      203
FIM, 0      , 0      ,       61,        0,       61
FIN, 0      , 0      ,      217,        0,      217
FIP, 0      , 0      ,      217,        0,      217
FIQ, 0      , 0      ,      126,        0,      126
FIR, 0      , 0      ,      183,        0,      183
FIS, 0      , 0      ,      220,        0,      220
FIT, 0.01266, 0.00016,      158,        2,      156
FIV, 0      , 0      ,      153,        0,      153
FIW, 0      , 0      ,       27,        0,       27
FIY, 0      , 0      ,       71,        0,       71
FI_, 0      , 0      ,       10,        0,       10
FKF, 0      , 0      ,       84,        0,       84
FKG, 0.01023, 0.0001 ,      391,        4,      387
FKH, 0      , 0      ,      122,        0,      122
FKI, 0.00386, 0.00001,      259,        1,      258
FKK, 0.00253, 0.00001,      395,        1,      394
FKL, 0.0045 , 0.00002,      444,        2,      442
FKM, 0.00893, 0.00008,      112,        1,      111
FKN, 0.01261, 0.00016,      238,        3,      235
FKP, 0      , 0      ,      216,        0,      216
FKQ, 0.02905, 0.00084,      241,        7,      234
FKR, 0.01412, 0.0002 ,      354,        5,      349
FKS, 0      , 0      ,      334,        0,      334
FKT, 0.0035 , 0.00001,      286,        1,      285
FKV, 0.03038, 0.00092,      395,       12,      383
FKW, 0      , 0      ,       65,        0,       65
FKY, 0      , 0      ,      170,        0,      170
FK_, 0      , 0      ,       16,        0,       16
FLF, 0      , 0      ,       72,        0,       72
FLG, 0      , 0      ,      429,        0,      429
FLH, 0      , 0      ,      137,        0,      137
FLI, 0.01064, 0.00011,      188,        2,      186
FLK, 0.002  , 0      ,      499,        1,      498
FLL, 0      , 0      ,      324,        0,      324
FLM, 0      , 0      ,       75,        0,       75
FLN, 0      , 0      ,      278,        0,      278
FLP, 0.00563, 0.00003,      355,        2,      353
FLQ, 0      , 0      ,      265,        0,      265
FLR, 0.00283, 0.00001,      353,        1,      352
FLS, 0      , 0      ,      374,        0,      374
FLT, 0.00377, 0.00001,      265,        1,      264
FLV, 0      , 0      ,      309,        0,      309
FLW, 0      , 0      ,       39,        0,       39
FLY, 0      , 0      ,      167,        0,      167
FL_, 0.14286, 0.02041,       14,        2,       12
FMF, 0      , 0      ,       18,        0,       18
FMG, 0.01449, 0.00021,       69,        1,       68
FMH, 0      , 0      ,       45,        0,       45
FMI, 0      , 0      ,       41,        0,       41
FMK, 0      , 0      ,      100,        0,      100
FML, 0      , 0      ,       65,        0,       65
FMM, 0      , 0      ,       27,        0,       27
FMN, 0      , 0      ,       42,        0,       42
FMP, 0      , 0      ,       95,        0,       95
FMQ, 0      , 0      ,       78,        0,       78
FMR, 0      , 0      ,       75,        0,       75
FMS, 0      , 0      ,       88,        0,       88
FMT, 0      , 0      ,       71,        0,       71
FMV, 0      , 0      ,      105,        0,      105
FMW, 0      , 0      ,       12,        0,       12
FMY, 0      , 0      ,       21,        0,       21
FM_, 0      , 0      ,       16,        0,       16
FNF, 0      , 0      ,      100,        0,      100
FNG, 0.01064, 0.00011,      282,        3,      279
FNH, 0      , 0      ,      132,        0,      132
FNI, 0.02247, 0.0005 ,      267,        6,      261
FNK, 0.03767, 0.00142,      292,       11,      281
FNL, 0.02089, 0.00044,      383,        8,      375
FNM, 0.0119 , 0.00014,       84,        1,       83
FNN, 0      , 0      ,      223,        0,      223
FNP, 0.00444, 0.00002,      225,        1,      224
FNQ, 0.01198, 0.00014,      167,        2,      165
FNR, 0.00855, 0.00007,      234,        2,      232
FNS, 0.02609, 0.00068,      230,        6,      224
FNT, 0.00995, 0.0001 ,      201,        2,      199
FNV, 0.00366, 0.00001,      273,        1,      272
FNW, 0      , 0      ,       88,        0,       88
FNY, 0.01471, 0.00022,      136,        2,      134
FN_, 0      , 0      ,       23,        0,       23
FPF, 0      , 0      ,       97,        0,       97
FPG, 0      , 0      ,      334,        0,      334
FPH, 0.016  , 0.00026,      125,        2,      123
FPI, 0.00287, 0.00001,      348,        1,      347
FPK, 0      , 0      ,      298,        0,      298
FPL, 0.00253, 0.00001,      396,        1,      395
FPM, 0      , 0      ,       81,        0,       81
FPN, 0      , 0      ,      234,        0,      234
FPP, 0      , 0      ,      197,        0,      197
FPQ, 0      , 0      ,      211,        0,      211
FPR, 0.00467, 0.00002,      214,        1,      213
FPS, 0.00357, 0.00001,      280,        1,      279
FPT, 0.00336, 0.00001,      298,        1,      297
FPV, 0      , 0      ,      254,        0,      254
FPW, 0      , 0      ,       39,        0,       39
FPY, 0.0051 , 0.00003,      196,        1,      195
FP_, 0      , 0      ,       14,        0,       14
FQF, 0      , 0      ,       52,        0,       52
FQG, 0      , 0      ,      264,        0,      264
FQH, 0.01282, 0.00016,       78,        1,       77
FQI, 0.0362 , 0.00131,      221,        8,      213
FQK, 0.00467, 0.00002,      214,        1,      213
FQL, 0.0188 , 0.00035,      266,        5,      261
FQM, 0.08955, 0.00802,       67,        6,       61
FQN, 0      , 0      ,      165,        0,      165
FQP, 0.01389, 0.00019,      216,        3,      213
FQQ, 0      , 0      ,      189,        0,      189
FQR, 0.00633, 0.00004,      158,        1,      157
FQS, 0.01026, 0.00011,      195,        2,      193
FQT, 0      , 0      ,      221,        0,      221
FQV, 0.04145, 0.00172,      193,        8,      185
FQW, 0      , 0      ,       57,        0,       57
FQY, 0.01111, 0.00012,       90,        1,       89
FQ_, 0      , 0      ,       14,        0,       14
FRF, 0      , 0      ,      107,        0,      107
FRG, 0.00429, 0.00002,      466,        2,      464
FRH, 0.00735, 0.00005,      136,        1,      135
FRI, 0.00877, 0.00008,      228,        2,      226
FRK, 0.00272, 0.00001,      368,        1,      367
FRL, 0      , 0      ,      406,        0,      406
FRM, 0.02679, 0.00072,      112,        3,      109
FRN, 0.0076 , 0.00006,      263,        2,      261
FRP, 0      , 0      ,      216,        0,      216
FRQ, 0.00362, 0.00001,      276,        1,      275
FRR, 0.01309, 0.00017,      382,        5,      377
FRS, 0.01531, 0.00023,      392,        6,      386
FRT, 0.00376, 0.00001,      266,        1,      265
FRV, 0.01542, 0.00024,      454,        7,      447
FRW, 0.02985, 0.00089,       67,        2,       65
FRY, 0.01075, 0.00012,      186,        2,      184
FR_, 0      , 0      ,       24,        0,       24
FSF, 0      , 0      ,       92,        0,       92
FSG, 0.02791, 0.00078,      430,       12,      418
FSH, 0      , 0      ,      173,        0,      173
FSI, 0.00356, 0.00001,      281,        1,      280
FSK, 0.01554, 0.00024,      386,        6,      380
FSL, 0.0086 , 0.00007,      465,        4,      461
FSM, 0.01961, 0.00038,      102,        2,      100
FSN, 0.04983, 0.00248,      301,       15,      286
FSP, 0.00885, 0.00008,      339,        3,      336
FSQ, 0      , 0      ,      220,        0,      220
FSR, 0      , 0      ,      336,        0,      336
FSS, 0.00811, 0.00007,      370,        3,      367
FST, 0.00629, 0.00004,      318,        2,      316
FSV, 0.0099 , 0.0001 ,      303,        3,      300
FSW, 0      , 0      ,       57,        0,       57
FSY, 0.01111, 0.00012,      270,        3,      267
FS_, 0.02326, 0.00054,       43,        1,       42
FTF, 0.01042, 0.00011,       96,        1,       95
FTG, 0.00236, 0.00001,      423,        1,      422
FTH, 0.04167, 0.00174,      120,        5,      115
FTI, 0      , 0      ,      227,        0,      227
FTK, 0.02473, 0.00061,      364,        9,      355
FTL, 0.0084 , 0.00007,      357,        3,      354
FTM, 0      , 0      ,       88,        0,       88
FTN, 0      , 0      ,      236,        0,      236
FTP, 0.0027 , 0.00001,      371,        1,      370
FTQ, 0.02162, 0.00047,      185,        4,      181
FTR, 0      , 0      ,      299,        0,      299
FTS, 0.0088 , 0.00008,      341,        3,      338
FTT, 0.00758, 0.00006,      264,        2,      262
FTV, 0      , 0      ,      368,        0,      368
FTW, 0      , 0      ,       55,        0,       55
FTY, 0.0184 , 0.00034,      163,        3,      160
FT_, 0      , 0      ,       17,        0,       17
FVF, 0      , 0      ,       62,        0,       62
FVG, 0.00299, 0.00001,      334,        1,      333
FVH, 0.00926, 0.00009,      108,        1,      107
FVI, 0.02721, 0.00074,      147,        4,      143
FVK, 0      , 0      ,      313,        0,      313
FVL, 0      , 0      ,      350,        0,      350
FVM, 0      , 0      ,       38,        0,       38
FVN, 0      , 0      ,      180,        0,      180
FVP, 0      , 0      ,      249,        0,      249
FVQ, 0.01143, 0.00013,      175,        2,      173
FVR, 0      , 0      ,      241,        0,      241
FVS, 0.00826, 0.00007,      242,        2,      240
FVT, 0      , 0      ,      244,        0,      244
FVV, 0      , 0      ,      214,        0,      214
FVW, 0      , 0      ,       39,        0,       39
FVY, 0      , 0      ,       74,        0,       74
FV_, 0.22222, 0.04938,        9,        2,        7
FWF, 0      , 0      ,       16,        0,       16
FWG, 0      , 0      ,       62,        0,       62
FWH, 0      , 0      ,       43,        0,       43
FWI, 0      , 0      ,       46,        0,       46
FWK, 0      , 0      ,       89,        0,       89
FWL, 0      , 0      ,      103,        0,      103
FWM, 0      , 0      ,       11,        0,       11
FWN, 0      , 0      ,       35,        0,       35
FWP, 0      , 0      ,       59,        0,       59
FWQ, 0      , 0      ,       64,        0,       64
FWR, 0      , 0      ,       66,        0,       66
FWS, 0      , 0      ,       66,        0,       66
FWT, 0      , 0      ,       64,        0,       64
FWV, 0      , 0      ,       54,        0,       54
FWW, 0.04   , 0.0016 ,       25,        1,       24
FWY, 0      , 0      ,       45,        0,       45
FW_, 0      , 0      ,       14,        0,       14
FYF, 0      , 0      ,       44,        0,       44
FYG, 0.00379, 0.00001,      264,        1,      263
FYH, 0      , 0      ,       90,        0,       90
FYI, 0      , 0      ,      136,        0,      136
FYK, 0.00405, 0.00002,      247,        1,      246
FYL, 0.00448, 0.00002,      223,        1,      222
FYM, 0      , 0      ,       44,        0,       44
FYN, 0.00535, 0.00003,      187,        1,      186
FYP, 0      , 0      ,      227,        0,      227
FYQ, 0      , 0      ,      146,        0,      146
FYR, 0      , 0      ,      257,        0,      257
FYS, 0.00388, 0.00002,      258,        1,      257
FYT, 0.00562, 0.00003,      178,        1,      177
FYV, 0.00606, 0.00004,      165,        1,      164
FYW, 0      , 0      ,       38,        0,       38
FYY, 0.04167, 0.00174,       96,        4,       92
FY_, 0      , 0      ,        9,        0,        9
GAG, 0.01686, 0.00028,      593,       10,      583
GAH, 0.0035 , 0.00001,      286,        1,      285
GAI, 0.00544, 0.00003,      551,        3,      548
GAK, 0.0029 , 0.00001,      689,        2,      687
GAL, 0.00191, 0      ,     1049,        2,     1047
GAM, 0.01681, 0.00028,      238,        4,      234
GAN, 0.00665, 0.00004,      451,        3,      448
GAP, 0.00153, 0      ,      652,        1,      651
GAQ, 0.01008, 0.0001 ,      496,        5,      491
GAR, 0.00417, 0.00002,      719,        3,      716
GAS, 0.00589, 0.00003,      679,        4,      675
GAT, 0.00432, 0.00002,      694,        3,      691
GAV, 0.00802, 0.00006,      748,        6,      742
GAW, 0.01361, 0.00019,      147,        2,      145
GAY, 0.00273, 0.00001,      366,        1,      365
GA_, 0      , 0      ,       19,        0,       19
GCG, 0.01818, 0.00033,      110,        2,      108
GCH, 0      , 0      ,       36,        0,       36
GCI, 0      , 0      ,      105,        0,      105
GCK, 0.01087, 0.00012,       92,        1,       91
GCL, 0      , 0      ,      103,        0,      103
GCM, 0      , 0      ,       29,        0,       29
GCN, 0      , 0      ,       83,        0,       83
GCP, 0      , 0      ,      103,        0,      103
GCQ, 0      , 0      ,       64,        0,       64
GCR, 0      , 0      ,      107,        0,      107
GCS, 0.008  , 0.00006,      125,        1,      124
GCT, 0      , 0      ,      102,        0,      102
GCV, 0.0155 , 0.00024,      129,        2,      127
GCW, 0      , 0      ,        5,        0,        5
GCY, 0      , 0      ,       60,        0,       60
GC_, 0      , 0      ,        6,        0,        6
GDG, 0.22864, 0.05228,      398,       91,      307
GDH, 0.04911, 0.00241,      224,       11,      213
GDI, 0.06636, 0.0044 ,      859,       57,      802
GDK, 0.01543, 0.00024,      648,       10,      638
GDL, 0.07149, 0.00511,     1105,       79,     1026
GDM, 0.05603, 0.00314,      232,       13,      219
GDN, 0.09259, 0.00857,      324,       30,      294
GDP, 0.01802, 0.00032,      666,       12,      654
GDQ, 0.0443 , 0.00196,      316,       14,      302
GDR, 0.04722, 0.00223,      593,       28,      565
GDS, 0.10436, 0.01089,      642,       67,      575
GDT, 0.06944, 0.00482,      648,       45,      603
GDV, 0.05248, 0.00275,     1010,       53,      957
GDW, 0.0266 , 0.00071,      188,        5,      183
GDY, 0.02688, 0.00072,      372,       10,      362
GD_, 0.09091, 0.00826,       11,        1,       10
GEG, 0.00491, 0.00002,      407,        2,      405
GEH, 0.04127, 0.0017 ,      315,       13,      302
GEI, 0.01934, 0.00037,      879,       17,      862
GEK, 0.00132, 0      ,      760,        1,      759
GEL, 0.01786, 0.00032,     1232,       22,     1210
GEM, 0.03252, 0.00106,      246,        8,      238
GEN, 0.04265, 0.00182,      422,       18,      404
GEP, 0.01168, 0.00014,      685,        8,      677
GEQ, 0.05634, 0.00317,      426,       24,      402
GER, 0.03014, 0.00091,      730,       22,      708
GES, 0.00861, 0.00007,      581,        5,      576
GET, 0.02134, 0.00046,      656,       14,      642
GEV, 0.03804, 0.00145,      999,       38,      961
GEW, 0.01667, 0.00028,      180,        3,      177
GEY, 0.02928, 0.00086,      444,       13,      431
GE_, 0      , 0      ,       48,        0,       48
GFG, 0.01282, 0.00016,      312,        4,      308
GFH, 0.02041, 0.00042,      147,        3,      144
GFI, 0      , 0      ,      329,        0,      329
GFK, 0      , 0      ,      378,        0,      378
GFL, 0.00192, 0      ,      520,        1,      519
GFM, 0      , 0      ,      136,        0,      136
GFN, 0.01071, 0.00011,      280,        3,      277
GFP, 0.00266, 0.00001,      376,        1,      375
GFQ, 0      , 0      ,      252,        0,      252
GFR, 0.00674, 0.00005,      445,        3,      442
GFS, 0.00469, 0.00002,      426,        2,      424
GFT, 0      , 0      ,      372,        0,      372
GFV, 0.00241, 0.00001,      415,        1,      414
GFW, 0      , 0      ,      101,        0,      101
GFY, 0      , 0      ,      224,        0,      224
GF_, 0      , 0      ,       11,        0,       11
GGG, 0.01709, 0.00029,      585,       10,      575
GGH, 0.0101 , 0.0001 ,      297,        3,      294
GGI, 0.01198, 0.00014,      668,        8,      660
GGK, 0.00653, 0.00004,      613,        4,      609
GGL, 0.00951, 0.00009,     1157,       11,     1146
GGM, 0.00866, 0.00007,      231,        2,      229
GGN, 0.02548, 0.00065,      471,       12,      459
GGP, 0.02941, 0.00087,      476,       14,      462
GGQ, 0.05537, 0.00307,      307,       17,      290
GGR, 0.01194, 0.00014,      670,        8,      662
GGS, 0.00508, 0.00003,      787,        4,      783
GGT, 0.00271, 0.00001,      739,        2,      737
GGV, 0.00482, 0.00002,      830,        4,      826
GGW, 0.02174, 0.00047,      138,        3,      135
GGY, 0.00739, 0.00005,      406,        3,      403
GG_, 0      , 0      ,       52,        0,       52
GHG, 0      , 0      ,      187,        0,      187
GHH, 0.05825, 0.00339,      103,        6,       97
GHI, 0.0132 , 0.00017,      303,        4,      299
GHK, 0.0042 , 0.00002,      238,        1,      237
GHL, 0.0235 , 0.00055,      468,       11,      457
GHM, 0.01429, 0.0002 ,      140,        2,      138
GHN, 0.01948, 0.00038,      154,        3,      151
GHP, 0.02222, 0.00049,      225,        5,      220
GHQ, 0.05263, 0.00277,      152,        8,      144
GHR, 0.05179, 0.00268,      251,       13,      238
GHS, 0.00791, 0.00006,      253,        2,      251
GHT, 0.04151, 0.00172,      265,       11,      254
GHV, 0.01266, 0.00016,      316,        4,      312
GHW, 0.03226, 0.00104,       31,        1,       30
GHY, 0.03429, 0.00118,      175,        6,      169
GH_, 0      , 0      ,       25,        0,       25
GIG, 0.00538, 0.00003,      372,        2,      370
GIH, 0.00562, 0.00003,      178,        1,      177
GII, 0.00674, 0.00005,      445,        3,      442
GIK, 0.00815, 0.00007,      491,        4,      487
GIL, 0      , 0      ,      658,        0,      658
GIM, 0      , 0      ,      134,        0,      134
GIN, 0      , 0      ,      363,        0,      363
GIP, 0.00175, 0      ,      570,        1,      569
GIQ, 0.01674, 0.00028,      239,        4,      235
GIR, 0.01035, 0.00011,      483,        5,      478
GIS, 0      , 0      ,      536,        0,      536
GIT, 0.00209, 0      ,      479,        1,      478
GIV, 0.0031 , 0.00001,      646,        2,      644
GIW, 0      , 0      ,      109,        0,      109
GIY, 0.0087 , 0.00008,      230,        2,      228
GI_, 0      , 0      ,       15,        0,       15
GKG, 0.02439, 0.00059,      451,       11,      440
GKH, 0.00976, 0.0001 ,      205,        2,      203
GKI, 0.0129 , 0.00017,      775,       10,      765
GKK, 0.00832, 0.00007,      721,        6,      715
GKL, 0.01339, 0.00018,     1120,       15,     1105
GKM, 0.01442, 0.00021,      208,        3,      205
GKN, 0      , 0      ,      367,        0,      367
GKP, 0.01948, 0.00038,      616,       12,      604
GKQ, 0.00292, 0.00001,      343,        1,      342
GKR, 0.00524, 0.00003,      572,        3,      569
GKS, 0.02589, 0.00067,      618,       16,      602
GKT, 0.03392, 0.00115,      796,       27,      769
GKV, 0      , 0      ,      766,        0,      766
GKW, 0      , 0      ,      142,        0,      142
GKY, 0.00484, 0.00002,      413,        2,      411
GK_, 0.03333, 0.00111,       30,        1,       29
GLG, 0.00914, 0.00008,      547,        5,      542
GLH, 0      , 0      ,      356,        0,      356
GLI, 0      , 0      ,      623,        0,      623
GLK, 0      , 0      ,      788,        0,      788
GLL, 0.00257, 0.00001,     1166,        3,     1163
GLM, 0      , 0      ,      258,        0,      258
GLN, 0.00942, 0.00009,      531,        5,      526
GLP, 0.00933, 0.00009,      750,        7,      743
GLQ, 0      , 0      ,      477,        0,      477
GLR, 0.00347, 0.00001,      865,        3,      862
GLS, 0.0148 , 0.00022,      946,       14,      932
GLT, 0.00122, 0      ,      822,        1,      821
GLV, 0.00487, 0.00002,      821,        4,      817
GLW, 0      , 0      ,      178,        0,      178
GLY, 0      , 0      ,      363,        0,      363
GL_, 0      , 0      ,       46,        0,       46
GMG, 0.00735, 0.00005,      136,        1,      135
GMH, 0      , 0      ,       66,        0,       66
GMI, 0.00699, 0.00005,      143,        1,      142
GMK, 0.01875, 0.00035,      160,        3,      157
GML, 0.0087 , 0.00008,      230,        2,      228
GMM, 0      , 0      ,       71,        0,       71
GMN, 0      , 0      ,      135,        0,      135
GMP, 0      , 0      ,      151,        0,      151
GMQ, 0      , 0      ,       89,        0,       89
GMR, 0      , 0      ,      191,        0,      191
GMS, 0.00469, 0.00002,      213,        1,      212
GMT, 0.00797, 0.00006,      251,        2,      249
GMV, 0      , 0      ,      255,        0,      255
GMW, 0      , 0      ,       33,        0,       33
GMY, 0      , 0      ,       83,        0,       83
GM_, 0      , 0      ,       33,        0,       33
GNG, 0.03008, 0.0009 ,      266,        8,      258
GNH, 0.0219 , 0.00048,      137,        3,      134
GNI, 0.03377, 0.00114,      533,       18,      515
GNK, 0.02968, 0.00088,      438,       13,      425
GNL, 0.02954, 0.00087,      677,       20,      657
GNM, 0.05   , 0.0025 ,      160,        8,      152
GNN, 0.04834, 0.00234,      331,       16,      315
GNP, 0.01978, 0.00039,      455,        9,      446
GNQ, 0.00897, 0.00008,      223,        2,      221
GNR, 0.00654, 0.00004,      306,        2,      304
GNS, 0.0292 , 0.00085,      411,       12,      399
GNT, 0.01326, 0.00018,      377,        5,      372
GNV, 0.03094, 0.00096,      614,       19,      595
GNW, 0.03425, 0.00117,      146,        5,      141
GNY, 0.00781, 0.00006,      256,        2,      254
GN_, 0      , 0      ,       18,        0,       18
GPG, 0.00405, 0.00002,      247,        1,      246
GPH, 0      , 0      ,      204,        0,      204
GPI, 0.00254, 0.00001,      394,        1,      393
GPK, 0      , 0      ,      347,        0,      347
GPL, 0.00126, 0      ,      791,        1,      790
GPM, 0      , 0      ,      168,        0,      168
GPN, 0.00356, 0.00001,      281,        1,      280
GPP, 0      , 0      ,      350,        0,      350
GPQ, 0.01049, 0.00011,      286,        3,      283
GPR, 0      , 0      ,      410,        0,      410
GPS, 0.00716, 0.00005,      419,        3,      416
GPT, 0      , 0      ,      427,        0,      427
GPV, 0.00351, 0.00001,      570,        2,      568
GPW, 0      , 0      ,      124,        0,      124
GPY, 0      , 0      ,      276,        0,      276
GP_, 0      , 0      ,       17,        0,       17
GQG, 0.01304, 0.00017,      230,        3,      227
GQH, 0      , 0      ,      109,        0,      109
GQI, 0.05013, 0.00251,      379,       19,      360
GQK, 0.00595, 0.00004,      336,        2,      334
GQL, 0.01151, 0.00013,      608,        7,      601
GQM, 0      , 0      ,      134,        0,      134
GQN, 0.01613, 0.00026,      248,        4,      244
GQP, 0.00554, 0.00003,      361,        2,      359
GQQ, 0.00909, 0.00008,      220,        2,      218
GQR, 0.00952, 0.00009,      315,        3,      312
GQS, 0.0169 , 0.00029,      355,        6,      349
GQT, 0.02809, 0.00079,      356,       10,      346
GQV, 0.00922, 0.00008,      434,        4,      430
GQW, 0      , 0      ,      124,        0,      124
GQY, 0.01896, 0.00036,      211,        4,      207
GQ_, 0      , 0      ,        7,        0,        7
GRG, 0.01466, 0.00021,      341,        5,      336
GRH, 0      , 0      ,      237,        0,      237
GRI, 0.00681, 0.00005,      587,        4,      583
GRK, 0.00716, 0.00005,      559,        4,      555
GRL, 0.001  , 0      ,     1003,        1,     1002
GRM, 0.01064, 0.00011,      188,        2,      186
GRN, 0.00552, 0.00003,      362,        2,      360
GRP, 0.00386, 0.00001,      518,        2,      516
GRQ, 0.00662, 0.00004,      302,        2,      300
GRR, 0.00537, 0.00003,      559,        3,      556
GRS, 0.00561, 0.00003,      535,        3,      532
GRT, 0.00976, 0.0001 ,      410,        4,      406
GRV, 0.00236, 0.00001,      847,        2,      845
GRW, 0.02614, 0.00068,      153,        4,      149
GRY, 0.00538, 0.00003,      372,        2,      370
GR_, 0      , 0      ,       27,        0,       27
GSG, 0.00769, 0.00006,      650,        5,      645
GSH, 0.01087, 0.00012,      276,        3,      273
GSI, 0.02569, 0.00066,      545,       14,      531
GSK, 0.00601, 0.00004,      499,        3,      496
GSL, 0.01646, 0.00027,     1033,       17,     1016
GSM, 0.03252, 0.00106,      246,        8,      238
GSN, 0.01176, 0.00014,      340,        4,      336
GSP, 0.00958, 0.00009,      522,        5,      517
GSQ, 0.00313, 0.00001,      319,        1,      318
GSR, 0.01165, 0.00014,      515,        6,      509
GSS, 0.02317, 0.00054,      777,       18,      759
GST, 0      , 0      ,      597,        0,      597
GSV, 0.00806, 0.00006,      869,        7,      862
GSW, 0      , 0      ,      175,        0,      175
GSY, 0.00325, 0.00001,      308,        1,      307
GS_, 0.05   , 0.0025 ,       40,        2,       38
GTG, 0.01176, 0.00014,      425,        5,      420
GTH, 0.00806, 0.00007,      248,        2,      246
GTI, 0.01254, 0.00016,      638,        8,      630
GTK, 0.00213, 0      ,      469,        1,      468
GTL, 0.0086 , 0.00007,     1046,        9,     1037
GTM, 0      , 0      ,      168,        0,      168
GTN, 0.01303, 0.00017,      307,        4,      303
GTP, 0.01257, 0.00016,      557,        7,      550
GTQ, 0.00326, 0.00001,      307,        1,      306
GTR, 0.00243, 0.00001,      411,        1,      410
GTS, 0.00312, 0.00001,      642,        2,      640
GTT, 0.01073, 0.00012,      559,        6,      553
GTV, 0.0063 , 0.00004,      794,        5,      789
GTW, 0      , 0      ,      118,        0,      118
GTY, 0.02041, 0.00042,      343,        7,      336
GT_, 0      , 0      ,       22,        0,       22
GVG, 0.01109, 0.00012,      451,        5,      446
GVH, 0.00495, 0.00002,      202,        1,      201
GVI, 0.00531, 0.00003,      565,        3,      562
GVK, 0.00154, 0      ,      649,        1,      648
GVL, 0.00466, 0.00002,      858,        4,      854
GVM, 0      , 0      ,      181,        0,      181
GVN, 0.00535, 0.00003,      374,        2,      372
GVP, 0      , 0      ,      645,        0,      645
GVQ, 0.00331, 0.00001,      302,        1,      301
GVR, 0      , 0      ,      462,        0,      462
GVS, 0.00514, 0.00003,      584,        3,      581
GVT, 0.01031, 0.00011,      582,        6,      576
GVV, 0.00129, 0      ,      773,        1,      772
GVW, 0      , 0      ,      148,        0,      148
GVY, 0.00599, 0.00004,      334,        2,      332
GV_, 0      , 0      ,       22,        0,       22
GWG, 0.01449, 0.00021,      138,        2,      136
GWH, 0.04478, 0.002  ,       67,        3,       64
GWI, 0.01176, 0.00014,       85,        1,       84
GWK, 0      , 0      ,       99,        0,       99
GWL, 0.0082 , 0.00007,      244,        2,      242
GWM, 0      , 0      ,       38,        0,       38
GWN, 0.03077, 0.00095,      130,        4,      126
GWP, 0      , 0      ,       98,        0,       98
GWQ, 0.03659, 0.00134,       82,        3,       79
GWR, 0      , 0      ,      133,        0,      133
GWS, 0      , 0      ,      135,        0,      135
GWT, 0      , 0      ,      121,        0,      121
GWV, 0.00971, 0.00009,      103,        1,      102
GWW, 0      , 0      ,       33,        0,       33
GWY, 0.01149, 0.00013,       87,        1,       86
GW_, 0.22222, 0.04938,        9,        2,        7
GYG, 0.00587, 0.00003,      341,        2,      339
GYH, 0      , 0      ,      126,        0,      126
GYI, 0.0094 , 0.00009,      319,        3,      316
GYK, 0      , 0      ,      411,        0,      411
GYL, 0.00422, 0.00002,      474,        2,      472
GYM, 0      , 0      ,      147,        0,      147
GYN, 0.00331, 0.00001,      302,        1,      301
GYP, 0.01935, 0.00037,      310,        6,      304
GYQ, 0.00823, 0.00007,      243,        2,      241
GYR, 0      , 0      ,      421,        0,      421
GYS, 0.00307, 0.00001,      326,        1,      325
GYT, 0      , 0      ,      453,        0,      453
GYV, 0.00621, 0.00004,      483,        3,      480
GYW, 0      , 0      ,       65,        0,       65
GYY, 0.0122 , 0.00015,      246,        3,      243
GY_, 0      , 0      ,       10,        0,       10
HAH, 0      , 0      ,       80,        0,       80
HAI, 0      , 0      ,      195,        0,      195
HAK, 0      , 0      ,      182,        0,      182
HAL, 0      , 0      ,      404,        0,      404
HAM, 0      , 0      ,       61,        0,       61
HAN, 0.08125, 0.0066 ,      160,       13,      147
HAP, 0      , 0      ,      188,        0,      188
HAQ, 0      , 0      ,      152,        0,      152
HAR, 0.00498, 0.00002,      201,        1,      200
HAS, 0.01342, 0.00018,      149,        2,      147
HAT, 0.01744, 0.0003 ,      172,        3,      169
HAV, 0      , 0      ,      210,        0,      210
HAW, 0      , 0      ,       59,        0,       59
HAY, 0      , 0      ,      114,        0,      114
HA_, 0      , 0      ,       20,        0,       20
HCH, 0      , 0      ,       16,        0,       16
HCI, 0      , 0      ,       30,        0,       30
HCK, 0      , 0      ,       12,        0,       12
HCL, 0.01333, 0.00018,       75,        1,       74
HCM, 0      , 0      ,       16,        0,       16
HCN, 0      , 0      ,       16,        0,       16
HCP, 0      , 0      ,       39,        0,       39
HCQ, 0      , 0      ,       36,        0,       36
HCR, 0      , 0      ,       20,        0,       20
HCS, 0      , 0      ,       34,        0,       34
HCT, 0      , 0      ,       29,        0,       29
HCV, 0      , 0      ,       33,        0,       33
HCW, 0      , 0      ,        2,        0,        2
HCY, 0      , 0      ,       20,        0,       20
HDH, 0.0625 , 0.00391,       32,        2,       30
HDI, 0.00427, 0.00002,      234,        1,      233
HDK, 0.00649, 0.00004,      154,        1,      153
HDL, 0.04748, 0.00225,      337,       16,      321
HDM, 0.06818, 0.00465,       88,        6,       82
HDN, 0.01493, 0.00022,      134,        2,      132
HDP, 0      , 0      ,      177,        0,      177
HDQ, 0.05747, 0.0033 ,       87,        5,       82
HDR, 0.06154, 0.00379,      130,        8,      122
HDS, 0.04233, 0.00179,      189,        8,      181
HDT, 0.04615, 0.00213,      130,        6,      124
HDV, 0.06803, 0.00463,      294,       20,      274
HDW, 0.03704, 0.00137,       54,        2,       52
HDY, 0.03311, 0.0011 ,      151,        5,      146
HD_, 0      , 0      ,        8,        0,        8
HEH, 0.1875 , 0.03516,       32,        6,       26
HEI, 0.01747, 0.00031,      229,        4,      225
HEK, 0      , 0      ,      194,        0,      194
HEL, 0.02304, 0.00053,      434,       10,      424
HEM, 0      , 0      ,       88,        0,       88
HEN, 0      , 0      ,      120,        0,      120
HEP, 0      , 0      ,      182,        0,      182
HEQ, 0.01481, 0.00022,      135,        2,      133
HER, 0.01075, 0.00012,      186,        2,      184
HES, 0.01075, 0.00012,      186,        2,      184
HET, 0.0184 , 0.00034,      163,        3,      160
HEV, 0.03438, 0.00118,      320,       11,      309
HEW, 0.03125, 0.00098,       64,        2,       62
HEY, 0.00813, 0.00007,      123,        1,      122
HE_, 0.7037 , 0.4952 ,       27,       19,        8
HFH, 0      , 0      ,       29,        0,       29
HFI, 0      , 0      ,      105,        0,      105
HFK, 0      , 0      ,      110,        0,      110
HFL, 0      , 0      ,      204,        0,      204
HFM, 0      , 0      ,       34,        0,       34
HFN, 0      , 0      ,       67,        0,       67
HFP, 0      , 0      ,      143,        0,      143
HFQ, 0      , 0      ,       62,        0,       62
HFR, 0      , 0      ,      107,        0,      107
HFS, 0      , 0      ,      106,        0,      106
HFT, 0.00806, 0.00007,      124,        1,      123
HFV, 0      , 0      ,      126,        0,      126
HFW, 0      , 0      ,       28,        0,       28
HFY, 0      , 0      ,       75,        0,       75
HF_, 0      , 0      ,        8,        0,        8
HGH, 0      , 0      ,       70,        0,       70
HGI, 0.00394, 0.00002,      254,        1,      253
HGK, 0.03097, 0.00096,      226,        7,      219
HGL, 0      , 0      ,      356,        0,      356
HGM, 0      , 0      ,       91,        0,       91
HGN, 0      , 0      ,      147,        0,      147
HGP, 0.00562, 0.00003,      178,        1,      177
HGQ, 0      , 0      ,      119,        0,      119
HGR, 0      , 0      ,      208,        0,      208
HGS, 0.0181 , 0.00033,      221,        4,      217
HGT, 0      , 0      ,      187,        0,      187
HGV, 0.00407, 0.00002,      246,        1,      245
HGW, 0      , 0      ,       28,        0,       28
HGY, 0.00613, 0.00004,      163,        1,      162
HG_, 0      , 0      ,       29,        0,       29
HHH, 0.02024, 0.00041,      247,        5,      242
HHI, 0.12658, 0.01602,       79,       10,       69
HHK, 0.01124, 0.00013,       89,        1,       88
HHL, 0.03488, 0.00122,      172,        6,      166
HHM, 0.01235, 0.00015,       81,        1,       80
HHN, 0      , 0      ,       49,        0,       49
HHP, 0.00794, 0.00006,      126,        1,      125
HHQ, 0      , 0      ,       63,        0,       63
HHR, 0.03297, 0.00109,       91,        3,       88
HHS, 0      , 0      ,      109,        0,      109
HHT, 0.04651, 0.00216,      129,        6,      123
HHV, 0      , 0      ,      127,        0,      127
HHW, 0      , 0      ,       16,        0,       16
HHY, 0      , 0      ,       93,        0,       93
HH_, 0.04098, 0.00168,      122,        5,      117
HIH, 0.11667, 0.01361,       60,        7,       53
HII, 0      , 0      ,       88,        0,       88
HIK, 0.01538, 0.00024,      130,        2,      128
HIL, 0.01124, 0.00013,      178,        2,      176
HIM, 0      , 0      ,       55,        0,       55
HIN, 0      , 0      ,      141,        0,      141
HIP, 0      , 0      ,      197,        0,      197
HIQ, 0.01111, 0.00012,       90,        1,       89
HIR, 0.00629, 0.00004,      159,        1,      158
HIS, 0      , 0      ,      145,        0,      145
HIT, 0      , 0      ,      117,        0,      117
HIV, 0      , 0      ,      146,        0,      146
HIW, 0      , 0      ,       18,        0,       18
HIY, 0      , 0      ,       86,        0,       86
HI_, 0      , 0      ,        4,        0,        4
HKH, 0      , 0      ,       41,        0,       41
HKI, 0      , 0      ,      174,        0,      174
HKK, 0      , 0      ,      230,        0,      230
HKL, 0      , 0      ,      293,        0,      293
HKM, 0      , 0      ,       76,        0,       76
HKN, 0.00893, 0.00008,      112,        1,      111
HKP, 0      , 0      ,      112,        0,      112
HKQ, 0      , 0      ,       92,        0,       92
HKR, 0.01333, 0.00018,      150,        2,      148
HKS, 0      , 0      ,      152,        0,      152
HKT, 0      , 0      ,      166,        0,      166
HKV, 0      , 0      ,      169,        0,      169
HKW, 0.04167, 0.00174,       48,        2,       46
HKY, 0      , 0      ,      141,        0,      141
HK_, 0      , 0      ,       14,        0,       14
HLH, 0      , 0      ,       56,        0,       56
HLI, 0      , 0      ,      203,        0,      203
HLK, 0.00472, 0.00002,      212,        1,      211
HLL, 0      , 0      ,      445,        0,      445
HLM, 0      , 0      ,       92,        0,       92
HLN, 0      , 0      ,      166,        0,      166
HLP, 0.0031 , 0.00001,      323,        1,      322
HLQ, 0      , 0      ,      149,        0,      149
HLR, 0      , 0      ,      233,        0,      233
HLS, 0      , 0      ,      271,        0,      271
HLT, 0      , 0      ,      274,        0,      274
HLV, 0      , 0      ,      321,        0,      321
HLW, 0      , 0      ,       54,        0,       54
HLY, 0      , 0      ,      154,        0,      154
HL_, 0      , 0      ,       25,        0,       25
HMH, 0.05556, 0.00309,       18,        1,       17
HMI, 0.01471, 0.00022,       68,        1,       67
HMK, 0.02299, 0.00053,       87,        2,       85
HML, 0      , 0      ,       82,        0,       82
HMM, 0      , 0      ,       18,        0,       18
HMN, 0      , 0      ,       38,        0,       38
HMP, 0      , 0      ,       60,        0,       60
HMQ, 0      , 0      ,       34,        0,       34
HMR, 0.01667, 0.00028,       60,        1,       59
HMS, 0      , 0      ,       53,        0,       53
HMT, 0      , 0      ,       75,        0,       75
HMV, 0.01695, 0.00029,       59,        1,       58
HMW, 0      , 0      ,        9,        0,        9
HMY, 0      , 0      ,       26,        0,       26
HM_, 0      , 0      ,       10,        0,       10
HNH, 0      , 0      ,       22,        0,       22
HNI, 0.02113, 0.00045,      142,        3,      139
HNK, 0      , 0      ,      139,        0,      139
HNL, 0      , 0      ,      252,        0,      252
HNM, 0      , 0      ,       40,        0,       40
HNN, 0.03191, 0.00102,       94,        3,       91
HNP, 0      , 0      ,       87,        0,       87
HNQ, 0      , 0      ,       72,        0,       72
HNR, 0      , 0      ,      126,        0,      126
HNS, 0.00926, 0.00009,      108,        1,      107
HNT, 0      , 0      ,       92,        0,       92
HNV, 0.01685, 0.00028,      178,        3,      175
HNW, 0.08696, 0.00756,       23,        2,       21
HNY, 0.00952, 0.00009,      105,        1,      104
HN_, 0      , 0      ,        3,        0,        3
HPH, 0      , 0      ,       38,        0,       38
HPI, 0      , 0      ,      166,        0,      166
HPK, 0      , 0      ,      128,        0,      128
HPL, 0      , 0      ,      281,        0,      281
HPM, 0      , 0      ,       73,        0,       73
HPN, 0      , 0      ,      142,        0,      142
HPP, 0      , 0      ,      124,        0,      124
HPQ, 0.01562, 0.00024,      128,        2,      126
HPR, 0      , 0      ,      113,        0,      113
HPS, 0.00526, 0.00003,      190,        1,      189
HPT, 0      , 0      ,      164,        0,      164
HPV, 0      , 0      ,      143,        0,      143
HPW, 0      , 0      ,       59,        0,       59
HPY, 0.01887, 0.00036,      106,        2,      104
HP_, 0      , 0      ,        7,        0,        7
HQH, 0      , 0      ,       33,        0,       33
HQI, 0.01626, 0.00026,      123,        2,      121
HQK, 0      , 0      ,      139,        0,      139
HQL, 0.01099, 0.00012,      273,        3,      270
HQM, 0      , 0      ,       55,        0,       55
HQN, 0      , 0      ,       77,        0,       77
HQP, 0      , 0      ,       88,        0,       88
HQQ, 0      , 0      ,      101,        0,      101
HQR, 0      , 0      ,      105,        0,      105
HQS, 0.00893, 0.00008,      112,        1,      111
HQT, 0.01333, 0.00018,       75,        1,       74
HQV, 0.008  , 0.00006,      125,        1,      124
HQW, 0      , 0      ,       56,        0,       56
HQY, 0      , 0      ,       80,        0,       80
HQ_, 0      , 0      ,       12,        0,       12
HRH, 0      , 0      ,       27,        0,       27
HRI, 0      , 0      ,      278,        0,      278
HRK, 0      , 0      ,      103,        0,      103
HRL, 0.01114, 0.00012,      449,        5,      444
HRM, 0      , 0      ,       72,        0,       72
HRN, 0.00769, 0.00006,      130,        1,      129
HRP, 0.0073 , 0.00005,      137,        1,      136
HRQ, 0.01163, 0.00014,       86,        1,       85
HRR, 0.00429, 0.00002,      233,        1,      232
HRS, 0.0049 , 0.00002,      204,        1,      203
HRT, 0.02439, 0.00059,      164,        4,      160
HRV, 0.00362, 0.00001,      276,        1,      275
HRW, 0.05128, 0.00263,       39,        2,       37
HRY, 0.0146 , 0.00021,      137,        2,      135
HR_, 0      , 0      ,       11,        0,       11
HSH, 0      , 0      ,       18,        0,       18
HSI, 0.01646, 0.00027,      243,        4,      239
HSK, 0.00633, 0.00004,      158,        1,      157
HSL, 0.00955, 0.00009,      314,        3,      311
HSM, 0      , 0      ,       75,        0,       75
HSN, 0      , 0      ,      130,        0,      130
HSP, 0.01093, 0.00012,      183,        2,      181
HSQ, 0.00926, 0.00009,      108,        1,      107
HSR, 0.01093, 0.00012,      183,        2,      181
HSS, 0.03125, 0.00098,      192,        6,      186
HST, 0      , 0      ,      145,        0,      145
HSV, 0.07339, 0.00539,      218,       16,      202
HSW, 0      , 0      ,       45,        0,       45
HSY, 0      , 0      ,       92,        0,       92
HS_, 0      , 0      ,       37,        0,       37
HTH, 0      , 0      ,       34,        0,       34
HTI, 0      , 0      ,      212,        0,      212
HTK, 0.05932, 0.00352,      118,        7,      111
HTL, 0.00602, 0.00004,      332,        2,      330
HTM, 0      , 0      ,       63,        0,       63
HTN, 0.00962, 0.00009,      104,        1,      103
HTP, 0      , 0      ,      147,        0,      147
HTQ, 0.01235, 0.00015,       81,        1,       80
HTR, 0.01653, 0.00027,      121,        2,      119
HTS, 0      , 0      ,      147,        0,      147
HTT, 0      , 0      ,      126,        0,      126
HTV, 0      , 0      ,      203,        0,      203
HTW, 0      , 0      ,       44,        0,       44
HTY, 0      , 0      ,      129,        0,      129
HT_, 0      , 0      ,        6,        0,        6
HVH, 0      , 0      ,       45,        0,       45
HVI, 0      , 0      ,      155,        0,      155
HVK, 0      , 0      ,      154,        0,      154
HVL, 0.00373, 0.00001,      268,        1,      267
HVM, 0      , 0      ,       49,        0,       49
HVN, 0      , 0      ,       92,        0,       92
HVP, 0      , 0      ,      169,        0,      169
HVQ, 0      , 0      ,       83,        0,       83
HVR, 0      , 0      ,      179,        0,      179
HVS, 0.00549, 0.00003,      182,        1,      181
HVT, 0      , 0      ,      125,        0,      125
HVV, 0      , 0      ,      172,        0,      172
HVW, 0      , 0      ,       15,        0,       15
HVY, 0      , 0      ,       56,        0,       56
HV_, 0      , 0      ,       12,        0,       12
HWH, 0      , 0      ,       11,        0,       11
HWI, 0      , 0      ,       28,        0,       28
HWK, 0      , 0      ,       49,        0,       49
HWL, 0.0099 , 0.0001 ,      101,        1,      100
HWM, 0      , 0      ,       18,        0,       18
HWN, 0      , 0      ,       29,        0,       29
HWP, 0      , 0      ,       49,        0,       49
HWQ, 0      , 0      ,       34,        0,       34
HWR, 0      , 0      ,       33,        0,       33
HWS, 0      , 0      ,       35,        0,       35
HWT, 0      , 0      ,       43,        0,       43
HWV, 0      , 0      ,       59,        0,       59
HWW, 0      , 0      ,        6,        0,        6
HWY, 0      , 0      ,       57,        0,       57
HW_, 0      , 0      ,        1,        0,        1
HYH, 0.02857, 0.00082,       35,        1,       34
HYI, 0      , 0      ,      111,        0,      111
HYK, 0      , 0      ,      137,        0,      137
HYL, 0.01026, 0.00011,      195,        2,      193
HYM, 0      , 0      ,       40,        0,       40
HYN, 0      , 0      ,      117,        0,      117
HYP, 0      , 0      ,      136,        0,      136
HYQ, 0.03125, 0.00098,       96,        3,       93
HYR, 0.01   , 0.0001 ,      100,        1,       99
HYS, 0      , 0      ,      111,        0,      111
HYT, 0.04301, 0.00185,       93,        4,       89
HYV, 0.04167, 0.00174,       96,        4,       92
HYW, 0      , 0      ,       34,        0,       34
HYY, 0.01408, 0.0002 ,       71,        1,       70
HY_, 0      , 0      ,       10,        0,       10
IAI, 0.00585, 0.00003,      171,        1,      170
IAK, 0      , 0      ,      549,        0,      549
IAL, 0      , 0      ,      510,        0,      510
IAM, 0.00806, 0.00007,      124,        1,      123
IAN, 0.00244, 0.00001,      409,        1,      408
IAP, 0.00312, 0.00001,      321,        1,      320
IAQ, 0.00262, 0.00001,      381,        1,      380
IAR, 0.00678, 0.00005,      590,        4,      586
IAS, 0.00233, 0.00001,      429,        1,      428
IAT, 0.00191, 0      ,      524,        1,      523
IAV, 0      , 0      ,      445,        0,      445
IAW, 0      , 0      ,       59,        0,       59
IAY, 0.00524, 0.00003,      191,        1,      190
IA_, 0      , 0      ,       32,        0,       32
ICI, 0      , 0      ,       23,        0,       23
ICK, 0      , 0      ,       69,        0,       69
ICL, 0.01351, 0.00018,       74,        1,       73
ICM, 0      , 0      ,        8,        0,        8
ICN, 0      , 0      ,       55,        0,       55
ICP, 0      , 0      ,       58,        0,       58
ICQ, 0      , 0      ,       50,        0,       50
ICR, 0      , 0      ,       55,        0,       55
ICS, 0      , 0      ,       67,        0,       67
ICT, 0      , 0      ,       44,        0,       44
ICV, 0      , 0      ,       57,        0,       57
ICW, 0.2    , 0.04   ,        5,        1,        4
ICY, 0      , 0      ,       45,        0,       45
IC_, 0      , 0      ,        1,        0,        1
IDI, 0.11285, 0.01274,      319,       36,      283
IDK, 0.0169 , 0.00029,      651,       11,      640
IDL, 0.0558 , 0.00311,      896,       50,      846
IDM, 0.05727, 0.00328,      227,       13,      214
IDN, 0.06311, 0.00398,      412,       26,      386
IDP, 0.02924, 0.00085,      513,       15,      498
IDQ, 0.03979, 0.00158,      377,       15,      362
IDR, 0.02355, 0.00055,      637,       15,      622
IDS, 0.05393, 0.00291,      649,       35,      614
IDT, 0.05186, 0.00269,      617,       32,      585
IDV, 0.05655, 0.0032 ,      725,       41,      684
IDW, 0.05674, 0.00322,      141,        8,      133
IDY, 0.01749, 0.00031,      343,        6,      337
ID_, 0.07692, 0.00592,       39,        3,       36
IEI, 0.05147, 0.00265,      272,       14,      258
IEK, 0.01075, 0.00012,      930,       10,      920
IEL, 0.03222, 0.00104,      931,       30,      901
IEM, 0.03057, 0.00093,      229,        7,      222
IEN, 0.01378, 0.00019,      508,        7,      501
IEP, 0.02847, 0.00081,      562,       16,      546
IEQ, 0.02381, 0.00057,      462,       11,      451
IER, 0.00531, 0.00003,      754,        4,      750
IES, 0.04676, 0.00219,      663,       31,      632
IET, 0.02047, 0.00042,      635,       13,      622
IEV, 0.04133, 0.00171,      750,       31,      719
IEW, 0.02439, 0.00059,      164,        4,      160
IEY, 0.02062, 0.00043,      291,        6,      285
IE_, 0      , 0      ,       20,        0,       20
IFI, 0      , 0      ,       80,        0,       80
IFK, 0.00439, 0.00002,      228,        1,      227
IFL, 0.00893, 0.00008,      224,        2,      222
IFM, 0      , 0      ,       83,        0,       83
IFN, 0      , 0      ,      206,        0,      206
IFP, 0.00538, 0.00003,      186,        1,      185
IFQ, 0      , 0      ,      121,        0,      121
IFR, 0      , 0      ,      195,        0,      195
IFS, 0.00651, 0.00004,      307,        2,      305
IFT, 0.00498, 0.00002,      201,        1,      200
IFV, 0      , 0      ,      185,        0,      185
IFW, 0      , 0      ,       25,        0,       25
IFY, 0      , 0      ,      118,        0,      118
IF_, 0      , 0      ,        8,        0,        8
IGI, 0      , 0      ,      152,        0,      152
IGK, 0.00396, 0.00002,      505,        2,      503
IGL, 0.00133, 0      ,      751,        1,      750
IGM, 0.01667, 0.00028,      120,        2,      118
IGN, 0.01644, 0.00027,      365,        6,      359
IGP, 0      , 0      ,      384,        0,      384
IGQ, 0.01701, 0.00029,      294,        5,      289
IGR, 0.00206, 0      ,      485,        1,      484
IGS, 0.00366, 0.00001,      546,        2,      544
IGT, 0.01855, 0.00034,      539,       10,      529
IGV, 0      , 0      ,      400,        0,      400
IGW, 0.02985, 0.00089,       67,        2,       65
IGY, 0.0087 , 0.00008,      230,        2,      228
IG_, 0      , 0      ,       27,        0,       27
IHI, 0      , 0      ,      101,        0,      101
IHK, 0.01384, 0.00019,      289,        4,      285
IHL, 0.01119, 0.00013,      268,        3,      265
IHM, 0      , 0      ,       72,        0,       72
IHN, 0.00588, 0.00003,      170,        1,      169
IHP, 0      , 0      ,      186,        0,      186
IHQ, 0.02256, 0.00051,      133,        3,      130
IHR, 0.04211, 0.00177,      190,        8,      182
IHS, 0.06512, 0.00424,      215,       14,      201
IHT, 0.00966, 0.00009,      207,        2,      205
IHV, 0.03153, 0.00099,      222,        7,      215
IHW, 0.0303 , 0.00092,       33,        1,       32
IHY, 0      , 0      ,      100,        0,      100
IH_, 0      , 0      ,       12,        0,       12
III, 0      , 0      ,       93,        0,       93
IIK, 0      , 0      ,      439,        0,      439
IIL, 0      , 0      ,      249,        0,      249
IIM, 0      , 0      ,       86,        0,       86
IIN, 0      , 0      ,      304,        0,      304
IIP, 0      , 0      ,      288,        0,      288
IIQ, 0      , 0      ,      189,        0,      189
IIR, 0      , 0      ,      290,        0,      290
IIS, 0.00275, 0.00001,      363,        1,      362
IIT, 0      , 0      ,      292,        0,      292
IIV, 0      , 0      ,      221,        0,      221
IIW, 0      , 0      ,       41,        0,       41
IIY, 0      , 0      ,      117,        0,      117
II_, 0      , 0      ,       12,        0,       12
IKI, 0.01587, 0.00025,      252,        4,      248
IKK, 0.00466, 0.00002,      859,        4,      855
IKL, 0.01791, 0.00032,      726,       13,      713
IKM, 0.00901, 0.00008,      222,        2,      220
IKN, 0.00923, 0.00009,      542,        5,      537
IKP, 0.04156, 0.00173,      385,       16,      369
IKQ, 0      , 0      ,      388,        0,      388
IKR, 0.00583, 0.00003,      515,        3,      512
IKS, 0.00497, 0.00002,      604,        3,      601
IKT, 0.00824, 0.00007,      364,        3,      361
IKV, 0.02131, 0.00045,      610,       13,      597
IKW, 0.04211, 0.00177,       95,        4,       91
IKY, 0.00417, 0.00002,      240,        1,      239
IK_, 0.02174, 0.00047,       46,        1,       45
ILI, 0      , 0      ,      155,        0,      155
ILK, 0.00958, 0.00009,      626,        6,      620
ILL, 0      , 0      ,      419,        0,      419
ILM, 0      , 0      ,       84,        0,       84
ILN, 0.00203, 0      ,      492,        1,      491
ILP, 0.00232, 0.00001,      431,        1,      430
ILQ, 0      , 0      ,      340,        0,      340
ILR, 0.00201, 0      ,      498,        1,      497
ILS, 0.01125, 0.00013,      622,        7,      615
ILT, 0.00483, 0.00002,      414,        2,      412
ILV, 0.00725, 0.00005,      414,        3,      411
ILW, 0      , 0      ,       68,        0,       68
ILY, 0      , 0      ,      157,        0,      157
IL_, 0      , 0      ,       19,        0,       19
IMI, 0      , 0      ,       43,        0,       43
IMK, 0.00714, 0.00005,      140,        1,      139
IML, 0      , 0      ,      102,        0,      102
IMM, 0.03125, 0.00098,       32,        1,       31
IMN, 0      , 0      ,      111,        0,      111
IMP, 0      , 0      ,      109,        0,      109
IMQ, 0      , 0      ,      108,        0,      108
IMR, 0.00806, 0.00007,      124,        1,      123
IMS, 0      , 0      ,      101,        0,      101
IMT, 0      , 0      ,      125,        0,      125
IMV, 0.00909, 0.00008,      110,        1,      109
IMW, 0      , 0      ,       16,        0,       16
IMY, 0      , 0      ,       42,        0,       42
IM_, 0      , 0      ,       84,        0,       84
INI, 0.00571, 0.00003,      175,        1,      174
INK, 0.00436, 0.00002,      459,        2,      457
INL, 0.00825, 0.00007,      485,        4,      481
INM, 0.01176, 0.00014,      170,        2,      168
INN, 0.00541, 0.00003,      370,        2,      368
INP, 0.00585, 0.00003,      342,        2,      340
INQ, 0.00583, 0.00003,      343,        2,      341
INR, 0.01194, 0.00014,      335,        4,      331
INS, 0.02244, 0.0005 ,      401,        9,      392
INT, 0.03419, 0.00117,      351,       12,      339
INV, 0.01008, 0.0001 ,      397,        4,      393
INW, 0.03659, 0.00134,       82,        3,       79
INY, 0.01969, 0.00039,      254,        5,      249
IN_, 0      , 0      ,       12,        0,       12
IPI, 0      , 0      ,      212,        0,      212
IPK, 0.00522, 0.00003,      383,        2,      381
IPL, 0      , 0      ,      626,        0,      626
IPM, 0      , 0      ,      104,        0,      104
IPN, 0      , 0      ,      235,        0,      235
IPP, 0      , 0      ,      250,        0,      250
IPQ, 0      , 0      ,      240,        0,      240
IPR, 0      , 0      ,      293,        0,      293
IPS, 0      , 0      ,      378,        0,      378
IPT, 0      , 0      ,      400,        0,      400
IPV, 0.00186, 0      ,      538,        1,      537
IPW, 0      , 0      ,       88,        0,       88
IPY, 0      , 0      ,      240,        0,      240
IP_, 0      , 0      ,       22,        0,       22
IQI, 0.00685, 0.00005,      146,        1,      145
IQK, 0.00748, 0.00006,      401,        3,      398
IQL, 0.00519, 0.00003,      385,        2,      383
IQM, 0      , 0      ,      104,        0,      104
IQN, 0.0293 , 0.00086,      273,        8,      265
IQP, 0.00939, 0.00009,      213,        2,      211
IQQ, 0      , 0      ,      266,        0,      266
IQR, 0      , 0      ,      284,        0,      284
IQS, 0.00273, 0.00001,      366,        1,      365
IQT, 0      , 0      ,      292,        0,      292
IQV, 0.01064, 0.00011,      282,        3,      279
IQW, 0      , 0      ,       45,        0,       45
IQY, 0      , 0      ,      159,        0,      159
IQ_, 0      , 0      ,       29,        0,       29
IRI, 0.00595, 0.00004,      168,        1,      167
IRK, 0.00678, 0.00005,      590,        4,      586
IRL, 0.01802, 0.00032,      666,       12,      654
IRM, 0.03049, 0.00093,      164,        5,      159
IRN, 0.00293, 0.00001,      341,        1,      340
IRP, 0.00955, 0.00009,      314,        3,      311
IRQ, 0      , 0      ,      359,        0,      359
IRR, 0.00357, 0.00001,      561,        2,      559
IRS, 0.01215, 0.00015,      494,        6,      488
IRT, 0.0024 , 0.00001,      416,        1,      415
IRV, 0.01884, 0.00035,      584,       11,      573
IRW, 0.04673, 0.00218,      107,        5,      102
IRY, 0.03213, 0.00103,      249,        8,      241
IR_, 0      , 0      ,       21,        0,       21
ISI, 0      , 0      ,      199,        0,      199
ISK, 0.00216, 0      ,      464,        1,      463
ISL, 0.00311, 0.00001,      644,        2,      642
ISM, 0.01429, 0.0002 ,      140,        2,      138
ISN, 0.01907, 0.00036,      367,        7,      360
ISP, 0.00285, 0.00001,      351,        1,      350
ISQ, 0      , 0      ,      303,        0,      303
ISR, 0.0048 , 0.00002,      417,        2,      415
ISS, 0.00678, 0.00005,      590,        4,      586
IST, 0      , 0      ,      394,        0,      394
ISV, 0.00219, 0      ,      456,        1,      455
ISW, 0      , 0      ,       85,        0,       85
ISY, 0.00889, 0.00008,      225,        2,      223
IS_, 0      , 0      ,       47,        0,       47
ITI, 0      , 0      ,      154,        0,      154
ITK, 0.00425, 0.00002,      471,        2,      469
ITL, 0.00737, 0.00005,      543,        4,      539
ITM, 0.01408, 0.0002 ,      142,        2,      140
ITN, 0      , 0      ,      329,        0,      329
ITP, 0.01075, 0.00012,      372,        4,      368
ITQ, 0.00749, 0.00006,      267,        2,      265
ITR, 0.00906, 0.00008,      331,        3,      328
ITS, 0.01059, 0.00011,      472,        5,      467
ITT, 0.00261, 0.00001,      383,        1,      382
ITV, 0      , 0      ,      458,        0,      458
ITW, 0      , 0      ,       65,        0,       65
ITY, 0.00476, 0.00002,      210,        1,      209
IT_, 0      , 0      ,       22,        0,       22
IVI, 0      , 0      ,      112,        0,      112
IVK, 0      , 0      ,      439,        0,      439
IVL, 0.00682, 0.00005,      440,        3,      437
IVM, 0.0082 , 0.00007,      122,        1,      121
IVN, 0      , 0      ,      365,        0,      365
IVP, 0.00301, 0.00001,      332,        1,      331
IVQ, 0      , 0      ,      187,        0,      187
IVR, 0.01765, 0.00031,      340,        6,      334
IVS, 0      , 0      ,      394,        0,      394
IVT, 0.01153, 0.00013,      347,        4,      343
IVV, 0.00581, 0.00003,      344,        2,      342
IVW, 0      , 0      ,       39,        0,       39
IVY, 0      , 0      ,      161,        0,      161
IV_, 0      , 0      ,        9,        0,        9
IWI, 0      , 0      ,       23,        0,       23
IWK, 0      , 0      ,       93,        0,       93
IWL, 0.0274 , 0.00075,       73,        2,       71
IWM, 0      , 0      ,       27,        0,       27
IWN, 0      , 0      ,       61,        0,       61
IWP, 0      , 0      ,       88,        0,       88
IWQ, 0      , 0      ,       55,        0,       55
IWR, 0.00917, 0.00008,      109,        1,      108
IWS, 0      , 0      ,       72,        0,       72
IWT, 0      , 0      ,       66,        0,       66
IWV, 0      , 0      ,       79,        0,       79
IWW, 0      , 0      ,       11,        0,       11
IWY, 0      , 0      ,       46,        0,       46
IYI, 0      , 0      ,       78,        0,       78
IYK, 0.00301, 0.00001,      332,        1,      331
IYL, 0      , 0      ,      269,        0,      269
IYM, 0      , 0      ,       57,        0,       57
IYN, 0      , 0      ,      268,        0,      268
IYP, 0      , 0      ,      230,        0,      230
IYQ, 0      , 0      ,      183,        0,      183
IYR, 0.00909, 0.00008,      220,        2,      218
IYS, 0.0106 , 0.00011,      283,        3,      280
IYT, 0      , 0      ,      200,        0,      200
IYV, 0.01158, 0.00013,      259,        3,      256
IYW, 0.03922, 0.00154,       51,        2,       49
IYY, 0.00585, 0.00003,      171,        1,      170
IY_, 0      , 0      ,        9,        0,        9
KAK, 0.00389, 0.00002,      257,        1,      256
KAL, 0.00104, 0      ,      958,        1,      957
KAM, 0      , 0      ,      200,        0,      200
KAN, 0.00283, 0.00001,      353,        1,      352
KAP, 0.00635, 0.00004,      315,        2,      313
KAQ, 0.01107, 0.00012,      271,        3,      268
KAR, 0      , 0      ,      418,        0,      418
KAS, 0.00243, 0.00001,      412,        1,      411
KAT, 0.00272, 0.00001,      367,        1,      366
KAV, 0      , 0      ,      505,        0,      505
KAW, 0      , 0      ,      116,        0,      116
KAY, 0.00727, 0.00005,      275,        2,      273
KA_, 0      , 0      ,       86,        0,       86
KCK, 0      , 0      ,       36,        0,       36
KCL, 0.00877, 0.00008,      114,        1,      113
KCM, 0      , 0      ,       16,        0,       16
KCN, 0      , 0      ,       52,        0,       52
KCP, 0      , 0      ,       45,        0,       45
KCQ, 0      , 0      ,       21,        0,       21
KCR, 0      , 0      ,       65,        0,       65
KCS, 0.08163, 0.00666,       49,        4,       45
KCT, 0      , 0      ,       59,        0,       59
KCV, 0      , 0      ,       57,        0,       57
KCW, 0      , 0      ,       14,        0,       14
KCY, 0      , 0      ,       44,        0,       44
KC_, 0      , 0      ,        7,        0,        7
KDK, 0      , 0      ,      228,        0,      228
KDL, 0.01319, 0.00017,      910,       12,      898
KDM, 0      , 0      ,      208,        0,      208
KDN, 0.02215, 0.00049,      316,        7,      309
KDP, 0.00608, 0.00004,      329,        2,      327
KDQ, 0.01376, 0.00019,      218,        3,      215
KDR, 0.00522, 0.00003,      383,        2,      381
KDS, 0.0125 , 0.00016,      400,        5,      395
KDT, 0.00487, 0.00002,      411,        2,      409
KDV, 0.01266, 0.00016,      632,        8,      624
KDW, 0.01538, 0.00024,      130,        2,      128
KDY, 0.01709, 0.00029,      351,        6,      345
KD_, 0.06061, 0.00367,       66,        4,       62
KEK, 0.00701, 0.00005,      428,        3,      425
KEL, 0.00779, 0.00006,     1541,       12,     1529
KEM, 0.00281, 0.00001,      356,        1,      355
KEN, 0.01014, 0.0001 ,      493,        5,      488
KEP, 0.00896, 0.00008,      335,        3,      332
KEQ, 0.00571, 0.00003,      350,        2,      348
KER, 0.01828, 0.00033,      547,       10,      537
KES, 0.00723, 0.00005,      553,        4,      549
KET, 0.00195, 0      ,      514,        1,      513
KEV, 0.0104 , 0.00011,      962,       10,      952
KEW, 0      , 0      ,      199,        0,      199
KEY, 0      , 0      ,      441,        0,      441
KE_, 0      , 0      ,       44,        0,       44
KFK, 0      , 0      ,      140,        0,      140
KFL, 0.02586, 0.00067,      348,        9,      339
KFM, 0      , 0      ,       75,        0,       75
KFN, 0      , 0      ,      201,        0,      201
KFP, 0      , 0      ,      233,        0,      233
KFQ, 0      , 0      ,      130,        0,      130
KFR, 0      , 0      ,      171,        0,      171
KFS, 0      , 0      ,      329,        0,      329
KFT, 0      , 0      ,      211,        0,      211
KFV, 0      , 0      ,      307,        0,      307
KFW, 0      , 0      ,       34,        0,       34
KFY, 0      , 0      ,      147,        0,      147
KF_, 0      , 0      ,        6,        0,        6
KGK, 0      , 0      ,      282,        0,      282
KGL, 0.00127, 0      ,      787,        1,      786
KGM, 0      , 0      ,      186,        0,      186
KGN, 0.0019 , 0      ,      526,        1,      525
KGP, 0.01027, 0.00011,      292,        3,      289
KGQ, 0      , 0      ,      365,        0,      365
KGR, 0.00744, 0.00006,      403,        3,      400
KGS, 0.00294, 0.00001,      680,        2,      678
KGT, 0      , 0      ,      626,        0,      626
KGV, 0.0028 , 0.00001,      715,        2,      713
KGW, 0      , 0      ,      107,        0,      107
KGY, 0.0028 , 0.00001,      357,        1,      356
KG_, 0.02381, 0.00057,       42,        1,       41
KHK, 0      , 0      ,       65,        0,       65
KHL, 0.00943, 0.00009,      318,        3,      315
KHM, 0      , 0      ,       46,        0,       46
KHN, 0.0137 , 0.00019,      146,        2,      144
KHP, 0.02721, 0.00074,      147,        4,      143
KHQ, 0.01408, 0.0002 ,       71,        1,       70
KHR, 0      , 0      ,      123,        0,      123
KHS, 0      , 0      ,      141,        0,      141
KHT, 0.01493, 0.00022,      134,        2,      132
KHV, 0.00467, 0.00002,      214,        1,      213
KHW, 0.02857, 0.00082,       70,        2,       68
KHY, 0.01613, 0.00026,      124,        2,      122
KH_, 0      , 0      ,       13,        0,       13
KIK, 0      , 0      ,      245,        0,      245
KIL, 0.00179, 0      ,      559,        1,      558
KIM, 0      , 0      ,      146,        0,      146
KIN, 0      , 0      ,      300,        0,      300
KIP, 0      , 0      ,      299,        0,      299
KIQ, 0.00503, 0.00003,      199,        1,      198
KIR, 0.00296, 0.00001,      338,        1,      337
KIS, 0.01531, 0.00023,      392,        6,      386
KIT, 0      , 0      ,      358,        0,      358
KIV, 0      , 0      ,      379,        0,      379
KIW, 0      , 0      ,       81,        0,       81
KIY, 0      , 0      ,      236,        0,      236
KI_, 0      , 0      ,       28,        0,       28
KKK, 0      , 0      ,      213,        0,      213
KKL, 0.00091, 0      ,     1103,        1,     1102
KKM, 0.004  , 0.00002,      250,        1,      249
KKN, 0.00604, 0.00004,      331,        2,      329
KKP, 0.0035 , 0.00001,      286,        1,      285
KKQ, 0      , 0      ,      273,        0,      273
KKR, 0      , 0      ,      360,        0,      360
KKS, 0.00723, 0.00005,      415,        3,      412
KKT, 0.01242, 0.00015,      322,        4,      318
KKV, 0.00129, 0      ,      774,        1,      773
KKW, 0      , 0      ,      123,        0,      123
KKY, 0.00259, 0.00001,      386,        1,      385
KK_, 0      , 0      ,       60,        0,       60
KLK, 0.00623, 0.00004,      321,        2,      319
KLL, 0      , 0      ,      977,        0,      977
KLM, 0      , 0      ,      224,        0,      224
KLN, 0.00195, 0      ,      514,        1,      513
KLP, 0.00521, 0.00003,      576,        3,      573
KLQ, 0      , 0      ,      332,        0,      332
KLR, 0.01702, 0.00029,      470,        8,      462
KLS, 0      , 0      ,      676,        0,      676
KLT, 0      , 0      ,      519,        0,      519
KLV, 0      , 0      ,      676,        0,      676
KLW, 0      , 0      ,      168,        0,      168
KLY, 0      , 0      ,      316,        0,      316
KL_, 0      , 0      ,       57,        0,       57
KMK, 0      , 0      ,       96,        0,       96
KML, 0      , 0      ,      240,        0,      240
KMM, 0      , 0      ,       87,        0,       87
KMN, 0      , 0      ,      124,        0,      124
KMP, 0.01099, 0.00012,       91,        1,       90
KMQ, 0.0177 , 0.00031,      113,        2,      111
KMR, 0      , 0      ,      102,        0,      102
KMS, 0      , 0      ,      188,        0,      188
KMT, 0.00763, 0.00006,      131,        1,      130
KMV, 0      , 0      ,      151,        0,      151
KMW, 0      , 0      ,       31,        0,       31
KMY, 0      , 0      ,       90,        0,       90
KM_, 0      , 0      ,      196,        0,      196
KNK, 0.00535, 0.00003,      187,        1,      186
KNL, 0.0034 , 0.00001,      589,        2,      587
KNM, 0.00602, 0.00004,      166,        1,      165
KNN, 0.0038 , 0.00001,      263,        1,      262
KNP, 0.00627, 0.00004,      319,        2,      317
KNQ, 0      , 0      ,      164,        0,      164
KNR, 0.00787, 0.00006,      254,        2,      252
KNS, 0      , 0      ,      286,        0,      286
KNT, 0.00353, 0.00001,      283,        1,      282
KNV, 0.00481, 0.00002,      416,        2,      414
KNW, 0.03261, 0.00106,       92,        3,       89
KNY, 0.00467, 0.00002,      214,        1,      213
KN_, 0.04762, 0.00227,       21,        1,       20
KPK, 0      , 0      ,      111,        0,      111
KPL, 0      , 0      ,      702,        0,      702
KPM, 0.01307, 0.00017,      153,        2,      151
KPN, 0      , 0      ,      306,        0,      306
KPP, 0      , 0      ,      174,        0,      174
KPQ, 0      , 0      ,      117,        0,      117
KPR, 0      , 0      ,      215,        0,      215
KPS, 0.00375, 0.00001,      267,        1,      266
KPT, 0.00295, 0.00001,      339,        1,      338
KPV, 0      , 0      ,      438,        0,      438
KPW, 0      , 0      ,       66,        0,       66
KPY, 0      , 0      ,      245,        0,      245
KP_, 0      , 0      ,       35,        0,       35
KQK, 0      , 0      ,      124,        0,      124
KQL, 0.00795, 0.00006,      629,        5,      624
KQM, 0.00565, 0.00003,      177,        1,      176
KQN, 0      , 0      ,      199,        0,      199
KQP, 0.01136, 0.00013,      176,        2,      174
KQQ, 0.00538, 0.00003,      186,        1,      185
KQR, 0.01005, 0.0001 ,      199,        2,      197
KQS, 0.00483, 0.00002,      207,        1,      206
KQT, 0.01333, 0.00018,      225,        3,      222
KQV, 0.00309, 0.00001,      324,        1,      323
KQW, 0      , 0      ,       86,        0,       86
KQY, 0      , 0      ,      293,        0,      293
KQ_, 0      , 0      ,       27,        0,       27
KRK, 0      , 0      ,      159,        0,      159
KRL, 0.01337, 0.00018,      972,       13,      959
KRM, 0      , 0      ,      202,        0,      202
KRN, 0      , 0      ,      265,        0,      265
KRP, 0.00415, 0.00002,      241,        1,      240
KRQ, 0.00905, 0.00008,      221,        2,      219
KRR, 0.01572, 0.00025,      318,        5,      313
KRS, 0.01285, 0.00017,      389,        5,      384
KRT, 0.00351, 0.00001,      285,        1,      284
KRV, 0.00722, 0.00005,      554,        4,      550
KRW, 0      , 0      ,      104,        0,      104
KRY, 0.01325, 0.00018,      302,        4,      298
KR_, 0      , 0      ,       39,        0,       39
KSK, 0.00746, 0.00006,      134,        1,      133
KSL, 0.00436, 0.00002,      917,        4,      913
KSM, 0.04   , 0.0016 ,      200,        8,      192
KSN, 0.05677, 0.00322,      229,       13,      216
KSP, 0      , 0      ,      303,        0,      303
KSQ, 0.02094, 0.00044,      191,        4,      187
KSR, 0.0119 , 0.00014,      252,        3,      249
KSS, 0.06888, 0.00474,      392,       27,      365
KST, 0.13911, 0.01935,      381,       53,      328
KSV, 0.01656, 0.00027,      483,        8,      475
KSW, 0.01852, 0.00034,      108,        2,      106
KSY, 0.02473, 0.00061,      283,        7,      276
KS_, 0      , 0      ,       67,        0,       67
KTK, 0.04054, 0.00164,      148,        6,      142
KTL, 0.02017, 0.00041,      694,       14,      680
KTM, 0.03974, 0.00158,      151,        6,      145
KTN, 0.0035 , 0.00001,      286,        1,      285
KTP, 0.01825, 0.00033,      274,        5,      269
KTQ, 0.01026, 0.00011,      195,        2,      193
KTR, 0.00926, 0.00009,      216,        2,      214
KTS, 0.04482, 0.00201,      357,       16,      341
KTT, 0.19274, 0.03715,      358,       69,      289
KTV, 0.04583, 0.0021 ,      480,       22,      458
KTW, 0      , 0      ,       90,        0,       90
KTY, 0.01569, 0.00025,      255,        4,      251
KT_, 0      , 0      ,       24,        0,       24
KVK, 0      , 0      ,      219,        0,      219
KVL, 0      , 0      ,      706,        0,      706
KVM, 0      , 0      ,      164,        0,      164
KVN, 0      , 0      ,      291,        0,      291
KVP, 0      , 0      ,      352,        0,      352
KVQ, 0.01288, 0.00017,      233,        3,      230
KVR, 0      , 0      ,      328,        0,      328
KVS, 0.00271, 0.00001,      369,        1,      368
KVT, 0.00882, 0.00008,      340,        3,      337
KVV, 0.00194, 0      ,      515,        1,      514
KVW, 0      , 0      ,       62,        0,       62
KVY, 0      , 0      ,      230,        0,      230
KV_, 0      , 0      ,       35,        0,       35
KWK, 0      , 0      ,       22,        0,       22
KWL, 0      , 0      ,      163,        0,      163
KWM, 0      , 0      ,       25,        0,       25
KWN, 0      , 0      ,       97,        0,       97
KWP, 0      , 0      ,       46,        0,       46
KWQ, 0      , 0      ,       76,        0,       76
KWR, 0      , 0      ,       62,        0,       62
KWS, 0.01408, 0.0002 ,      142,        2,      140
KWT, 0      , 0      ,       84,        0,       84
KWV, 0.00893, 0.00008,      112,        1,      111
KWW, 0      , 0      ,       16,        0,       16
KWY, 0      , 0      ,       49,        0,       49
KW_, 0      , 0      ,       10,        0,       10
KYK, 0.00719, 0.00005,      139,        1,      138
KYL, 0      , 0      ,      472,        0,      472
KYM, 0      , 0      ,       98,        0,       98
KYN, 0.0117 , 0.00014,      171,        2,      169
KYP, 0.03196, 0.00102,      219,        7,      212
KYQ, 0.01734, 0.0003 ,      173,        3,      170
KYR, 0.01422, 0.0002 ,      211,        3,      208
KYS, 0.00392, 0.00002,      255,        1,      254
KYT, 0.01382, 0.00019,      217,        3,      214
KYV, 0.00604, 0.00004,      331,        2,      329
KYW, 0.06818, 0.00465,       44,        3,       41
KYY, 0      , 0      ,      198,        0,      198
KY_, 0      , 0      ,       11,        0,       11
LAL, 0.00209, 0      ,      478,        1,      477
LAM, 0      , 0      ,      270,        0,      270
LAN, 0      , 0      ,      648,        0,      648
LAP, 0.00146, 0      ,      684,        1,      683
LAQ, 0.00216, 0      ,      927,        2,      925
LAR, 0      , 0      ,     1030,        0,     1030
LAS, 0.00484, 0.00002,      826,        4,      822
LAT, 0.0052 , 0.00003,      769,        4,      765
LAV, 0.00301, 0.00001,      665,        2,      663
LAW, 0      , 0      ,      192,        0,      192
LAY, 0.00882, 0.00008,      340,        3,      337
LA_, 0      , 0      ,       95,        0,       95
LCL, 0      , 0      ,       54,        0,       54
LCM, 0      , 0      ,       21,        0,       21
LCN, 0.03636, 0.00132,       55,        2,       53
LCP, 0      , 0      ,       87,        0,       87
LCQ, 0.02778, 0.00077,       72,        2,       70
LCR, 0      , 0      ,       83,        0,       83
LCS, 0      , 0      ,       76,        0,       76
LCT, 0      , 0      ,       95,        0,       95
LCV, 0      , 0      ,       83,        0,       83
LCW, 0      , 0      ,       23,        0,       23
LCY, 0      , 0      ,       42,        0,       42
LC_, 0      , 0      ,        1,        0,        1
LDL, 0.03443, 0.00119,      697,       24,      673
LDM, 0.02712, 0.00074,      295,        8,      287
LDN, 0.0531 , 0.00282,      678,       36,      642
LDP, 0.02387, 0.00057,      796,       19,      777
LDQ, 0.03114, 0.00097,      578,       18,      560
LDR, 0.03365, 0.00113,      951,       32,      919
LDS, 0.03282, 0.00108,      914,       30,      884
LDT, 0.0404 , 0.00163,      693,       28,      665
LDV, 0.05097, 0.0026 ,     1138,       58,     1080
LDW, 0.05714, 0.00327,      210,       12,      198
LDY, 0.01815, 0.00033,      606,       11,      595
LD_, 0      , 0      ,       55,        0,       55
LEL, 0.01914, 0.00037,      627,       12,      615
LEM, 0.04012, 0.00161,      324,       13,      311
LEN, 0.02372, 0.00056,      801,       19,      782
LEP, 0.00378, 0.00001,      793,        3,      790
LEQ, 0.01324, 0.00018,      831,       11,      820
LER, 0.03866, 0.00149,     1345,       52,     1293
LES, 0.01766, 0.00031,     1019,       18,     1001
LET, 0.00916, 0.00008,      873,        8,      865
LEV, 0.02731, 0.00075,     1245,       34,     1211
LEW, 0.00641, 0.00004,      156,        1,      155
LEY, 0.02024, 0.00041,      494,       10,      484
LE_, 0      , 0      ,       90,        0,       90
LFL, 0.00538, 0.00003,      186,        1,      185
LFM, 0      , 0      ,       77,        0,       77
LFN, 0      , 0      ,      321,        0,      321
LFP, 0      , 0      ,      328,        0,      328
LFQ, 0.01878, 0.00035,      213,        4,      209
LFR, 0.0048 , 0.00002,      417,        2,      415
LFS, 0.00652, 0.00004,      460,        3,      457
LFT, 0      , 0      ,      333,        0,      333
LFV, 0.02007, 0.0004 ,      299,        6,      293
LFW, 0      , 0      ,       47,        0,       47
LFY, 0      , 0      ,      182,        0,      182
LF_, 0      , 0      ,       37,        0,       37
LGL, 0.00656, 0.00004,      762,        5,      757
LGM, 0.00353, 0.00001,      283,        1,      282
LGN, 0.00624, 0.00004,      481,        3,      478
LGP, 0.00374, 0.00001,      535,        2,      533
LGQ, 0      , 0      ,      473,        0,      473
LGR, 0      , 0      ,      765,        0,      765
LGS, 0.01736, 0.0003 ,      864,       15,      849
LGT, 0.00136, 0      ,      737,        1,      736
LGV, 0.00222, 0      ,      899,        2,      897
LGW, 0      , 0      ,      128,        0,      128
LGY, 0.00209, 0      ,      479,        1,      478
LG_, 0      , 0      ,       82,        0,       82
LHL, 0.00833, 0.00007,      240,        2,      238
LHM, 0      , 0      ,       82,        0,       82
LHN, 0.02459, 0.0006 ,      244,        6,      238
LHP, 0.00621, 0.00004,      322,        2,      320
LHQ, 0.00392, 0.00002,      255,        1,      254
LHR, 0.00271, 0.00001,      369,        1,      368
LHS, 0.05446, 0.00297,      404,       22,      382
LHT, 0.00872, 0.00008,      344,        3,      341
LHV, 0.02907, 0.00085,      344,       10,      334
LHW, 0.0099 , 0.0001 ,      101,        1,      100
LHY, 0.04867, 0.00237,      226,       11,      215
LH_, 0.0625 , 0.00391,       16,        1,       15
LIL, 0      , 0      ,      242,        0,      242
LIM, 0      , 0      ,      105,        0,      105
LIN, 0.00216, 0      ,      463,        1,      462
LIP, 0.01104, 0.00012,      453,        5,      448
LIQ, 0      , 0      ,      369,        0,      369
LIR, 0.00226, 0.00001,      443,        1,      442
LIS, 0      , 0      ,      477,        0,      477
LIT, 0.00248, 0.00001,      404,        1,      403
LIV, 0      , 0      ,      357,        0,      357
LIW, 0      , 0      ,       60,        0,       60
LIY, 0      , 0      ,      172,        0,      172
LI_, 0.025  , 0.00063,       40,        1,       39
LKL, 0.006  , 0.00004,      667,        4,      663
LKM, 0.02507, 0.00063,      359,        9,      350
LKN, 0.0015 , 0      ,      667,        1,      666
LKP, 0.0184 , 0.00034,      652,       12,      640
LKQ, 0      , 0      ,      631,        0,      631
LKR, 0.00586, 0.00003,      853,        5,      848
LKS, 0.00298, 0.00001,      672,        2,      670
LKT, 0.00299, 0.00001,      669,        2,      667
LKV, 0.01531, 0.00023,      849,       13,      836
LKW, 0      , 0      ,      132,        0,      132
LKY, 0.00531, 0.00003,      377,        2,      375
LK_, 0      , 0      ,       82,        0,       82
LLL, 0.00256, 0.00001,      390,        1,      389
LLM, 0      , 0      ,      269,        0,      269
LLN, 0.00144, 0      ,      696,        1,      695
LLP, 0.00415, 0.00002,      965,        4,      961
LLQ, 0      , 0      ,      774,        0,      774
LLR, 0      , 0      ,     1068,        0,     1068
LLS, 0.00192, 0      ,     1040,        2,     1038
LLT, 0.00399, 0.00002,      752,        3,      749
LLV, 0.00462, 0.00002,      649,        3,      646
LLW, 0      , 0      ,      120,        0,      120
LLY, 0      , 0      ,      302,        0,      302
LL_, 0      , 0      ,       61,        0,       61
LML, 0      , 0      ,      125,        0,      125
LMM, 0      , 0      ,       56,        0,       56
LMN, 0.02367, 0.00056,      169,        4,      165
LMP, 0.01124, 0.00013,      178,        2,      176
LMQ, 0      , 0      ,      196,        0,      196
LMR, 0      , 0      ,      234,        0,      234
LMS, 0      , 0      ,      253,        0,      253
LMT, 0      , 0      ,      206,        0,      206
LMV, 0.02186, 0.00048,      183,        4,      179
LMW, 0.02941, 0.00087,       34,        1,       33
LMY, 0      , 0      ,       78,        0,       78
LM_, 0.03704, 0.00137,       54,        2,       52
LNL, 0.01556, 0.00024,      450,        7,      443
LNM, 0      , 0      ,      210,        0,      210
LNN, 0.01562, 0.00024,      512,        8,      504
LNP, 0.01142, 0.00013,      438,        5,      433
LNQ, 0.0084 , 0.00007,      357,        3,      354
LNR, 0.00982, 0.0001 ,      611,        6,      605
LNS, 0.01852, 0.00034,      594,       11,      583
LNT, 0.0062 , 0.00004,      484,        3,      481
LNV, 0.02849, 0.00081,      667,       19,      648
LNW, 0      , 0      ,      152,        0,      152
LNY, 0.00307, 0.00001,      326,        1,      325
LN_, 0.05405, 0.00292,       37,        2,       35
LPL, 0.00194, 0      ,      516,        1,      515
LPM, 0      , 0      ,      173,        0,      173
LPN, 0.01196, 0.00014,      418,        5,      413
LPP, 0      , 0      ,      572,        0,      572
LPQ, 0.00233, 0.00001,      429,        1,      428
LPR, 0.00588, 0.00003,      510,        3,      507
LPS, 0.01378, 0.00019,      653,        9,      644
LPT, 0.00158, 0      ,      633,        1,      632
LPV, 0.00333, 0.00001,      901,        3,      898
LPW, 0.00952, 0.00009,      105,        1,      104
LPY, 0.00273, 0.00001,      366,        1,      365
LP_, 0.04082, 0.00167,       49,        2,       47
LQL, 0      , 0      ,      390,        0,      390
LQM, 0.01657, 0.00027,      181,        3,      178
LQN, 0.00818, 0.00007,      489,        4,      485
LQP, 0.00225, 0.00001,      445,        1,      444
LQQ, 0.00175, 0      ,      572,        1,      571
LQR, 0.00963, 0.00009,      623,        6,      617
LQS, 0.01859, 0.00035,      538,       10,      528
LQT, 0      , 0      ,      536,        0,      536
LQV, 0.00229, 0.00001,      437,        1,      436
LQW, 0      , 0      ,      117,        0,      117
LQY, 0.00671, 0.00005,      298,        2,      296
LQ_, 0      , 0      ,       44,        0,       44
LRL, 0.02037, 0.00042,      589,       12,      577
LRM, 0.00929, 0.00009,      323,        3,      320
LRN, 0.0112 , 0.00013,      625,        7,      618
LRP, 0.00335, 0.00001,      597,        2,      595
LRQ, 0.00429, 0.00002,      699,        3,      696
LRR, 0.01036, 0.00011,     1062,       11,     1051
LRS, 0.0157 , 0.00025,      892,       14,      878
LRT, 0.00287, 0.00001,      696,        2,      694
LRV, 0.00111, 0      ,      897,        1,      896
LRW, 0      , 0      ,      134,        0,      134
LRY, 0.0146 , 0.00021,      411,        6,      405
LR_, 0      , 0      ,       57,        0,       57
LSL, 0.02222, 0.00049,      585,       13,      572
LSM, 0.01075, 0.00012,      279,        3,      276
LSN, 0      , 0      ,      659,        0,      659
LSP, 0.00451, 0.00002,      665,        3,      662
LSQ, 0.01627, 0.00026,      553,        9,      544
LSR, 0.00454, 0.00002,      881,        4,      877
LSS, 0.00588, 0.00003,      851,        5,      846
LST, 0.00455, 0.00002,      659,        3,      656
LSV, 0.00285, 0.00001,      701,        2,      699
LSW, 0      , 0      ,      165,        0,      165
LSY, 0.0089 , 0.00008,      337,        3,      334
LS_, 0      , 0      ,      124,        0,      124
LTL, 0.00839, 0.00007,      477,        4,      473
LTM, 0      , 0      ,      191,        0,      191
LTN, 0      , 0      ,      498,        0,      498
LTP, 0.00135, 0      ,      739,        1,      738
LTQ, 0      , 0      ,      432,        0,      432
LTR, 0.00302, 0.00001,      663,        2,      661
LTS, 0.00474, 0.00002,      633,        3,      630
LTT, 0.00299, 0.00001,      670,        2,      668
LTV, 0.01   , 0.0001 ,      700,        7,      693
LTW, 0.07895, 0.00623,      114,        9,      105
LTY, 0.01143, 0.00013,      350,        4,      346
LT_, 0.02778, 0.00077,       72,        2,       70
LVL, 0      , 0      ,      311,        0,      311
LVM, 0      , 0      ,      138,        0,      138
LVN, 0.00206, 0      ,      485,        1,      484
LVP, 0.00638, 0.00004,      627,        4,      623
LVQ, 0      , 0      ,      443,        0,      443
LVR, 0.00168, 0      ,      595,        1,      594
LVS, 0.02695, 0.00073,      668,       18,      650
LVT, 0      , 0      ,      526,        0,      526
LVV, 0      , 0      ,      548,        0,      548
LVW, 0.01053, 0.00011,       95,        1,       94
LVY, 0      , 0      ,      217,        0,      217
LV_, 0      , 0      ,       42,        0,       42
LWL, 0      , 0      ,       78,        0,       78
LWM, 0      , 0      ,       31,        0,       31
LWN, 0      , 0      ,      154,        0,      154
LWP, 0      , 0      ,      186,        0,      186
LWQ, 0      , 0      ,      140,        0,      140
LWR, 0      , 0      ,      180,        0,      180
LWS, 0      , 0      ,      168,        0,      168
LWT, 0      , 0      ,      138,        0,      138
LWV, 0      , 0      ,      148,        0,      148
LWW, 0      , 0      ,       25,        0,       25
LWY, 0      , 0      ,       77,        0,       77
LW_, 0      , 0      ,        5,        0,        5
LYL, 0      , 0      ,      281,        0,      281
LYM, 0      , 0      ,      102,        0,      102
LYN, 0      , 0      ,      319,        0,      319
LYP, 0.00253, 0.00001,      396,        1,      395
LYQ, 0.00322, 0.00001,      311,        1,      310
LYR, 0.00833, 0.00007,      480,        4,      476
LYS, 0.00403, 0.00002,      496,        2,      494
LYT, 0.01542, 0.00024,      389,        6,      383
LYV, 0.00305, 0.00001,      328,        1,      327
LYW, 0      , 0      ,       75,        0,       75
LYY, 0.00407, 0.00002,      246,        1,      245
LY_, 0.08333, 0.00694,       24,        2,       22
MAM, 0      , 0      ,       25,        0,       25
MAN, 0      , 0      ,      181,        0,      181
MAP, 0.0473 , 0.00224,      148,        7,      141
MAQ, 0      , 0      ,      136,        0,      136
MAR, 0      , 0      ,      242,        0,      242
MAS, 0      , 0      ,      174,        0,      174
MAT, 0      , 0      ,      205,        0,      205
MAV, 0      , 0      ,      163,        0,      163
MAW, 0      , 0      ,       19,        0,       19
MAY, 0      , 0      ,       76,        0,       76
MA_, 0      , 0      ,       67,        0,       67
MCM, 0      , 0      ,        6,        0,        6
MCN, 0      , 0      ,        7,        0,        7
MCP, 0      , 0      ,        8,        0,        8
MCQ, 0      , 0      ,       13,        0,       13
MCR, 0      , 0      ,       19,        0,       19
MCS, 0      , 0      ,       30,        0,       30
MCT, 0      , 0      ,       21,        0,       21
MCV, 0      , 0      ,       17,        0,       17
MCY, 0      , 0      ,       11,        0,       11
MC_, 0      , 0      ,        2,        0,        2
MDM, 0      , 0      ,       72,        0,       72
MDN, 0.06667, 0.00444,       90,        6,       84
MDP, 0.01227, 0.00015,      163,        2,      161
MDQ, 0.02632, 0.00069,      114,        3,      111
MDR, 0.01351, 0.00018,      148,        2,      146
MDS, 0.08791, 0.00773,      182,       16,      166
MDT, 0.03665, 0.00134,      191,        7,      184
MDV, 0.03285, 0.00108,      274,        9,      265
MDW, 0.03922, 0.00154,       51,        2,       49
MDY, 0.07059, 0.00498,      170,       12,      158
MD_, 0.14286, 0.02041,       14,        2,       12
MEM, 0.00935, 0.00009,      107,        1,      106
MEN, 0.02222, 0.00049,      180,        4,      176
MEP, 0.02139, 0.00046,      187,        4,      183
MEQ, 0.00552, 0.00003,      181,        1,      180
MER, 0.02143, 0.00046,      280,        6,      274
MES, 0.00518, 0.00003,      193,        1,      192
MET, 0.02874, 0.00083,      174,        5,      169
MEV, 0.04527, 0.00205,      243,       11,      232
MEW, 0.04255, 0.00181,       47,        2,       45
MEY, 0.0087 , 0.00008,      115,        1,      114
ME_, 0      , 0      ,       22,        0,       22
MFM, 0      , 0      ,       11,        0,       11
MFN, 0      , 0      ,       64,        0,       64
MFP, 0      , 0      ,       82,        0,       82
MFQ, 0      , 0      ,       34,        0,       34
MFR, 0      , 0      ,       98,        0,       98
MFS, 0      , 0      ,       69,        0,       69
MFT, 0      , 0      ,       87,        0,       87
MFV, 0      , 0      ,       43,        0,       43
MFW, 0      , 0      ,       10,        0,       10
MFY, 0.01786, 0.00032,       56,        1,       55
MGM, 0.02941, 0.00087,       34,        1,       33
MGN, 0      , 0      ,      108,        0,      108
MGP, 0      , 0      ,      158,        0,      158
MGQ, 0      , 0      ,      104,        0,      104
MGR, 0.00667, 0.00004,      150,        1,      149
MGS, 0.00483, 0.00002,      207,        1,      206
MGT, 0.01205, 0.00015,      166,        2,      164
MGV, 0      , 0      ,      219,        0,      219
MGW, 0      , 0      ,       34,        0,       34
MGY, 0      , 0      ,      111,        0,      111
MG_, 0.02222, 0.00049,       45,        1,       44
MHM, 0      , 0      ,       11,        0,       11
MHN, 0.04444, 0.00198,       45,        2,       43
MHP, 0      , 0      ,       45,        0,       45
MHQ, 0.07317, 0.00535,       41,        3,       38
MHR, 0      , 0      ,       95,        0,       95
MHS, 0.01389, 0.00019,      144,        2,      142
MHT, 0.02381, 0.00057,       42,        1,       41
MHV, 0.01493, 0.00022,       67,        1,       66
MHW, 0      , 0      ,       32,        0,       32
MHY, 0.02381, 0.00057,       42,        1,       41
MH_, 0.02083, 0.00043,       48,        1,       47
MIM, 0      , 0      ,        9,        0,        9
MIN, 0      , 0      ,       74,        0,       74
MIP, 0      , 0      ,       89,        0,       89
MIQ, 0      , 0      ,       67,        0,       67
MIR, 0      , 0      ,      128,        0,      128
MIS, 0.01923, 0.00037,      104,        2,      102
MIT, 0      , 0      ,       87,        0,       87
MIV, 0      , 0      ,      101,        0,      101
MIW, 0      , 0      ,        6,        0,        6
MIY, 0      , 0      ,       64,        0,       64
MI_, 0      , 0      ,        5,        0,        5
MKM, 0      , 0      ,       50,        0,       50
MKN, 0      , 0      ,      122,        0,      122
MKP, 0      , 0      ,      144,        0,      144
MKQ, 0      , 0      ,      161,        0,      161
MKR, 0.00581, 0.00003,      172,        1,      171
MKS, 0      , 0      ,      176,        0,      176
MKT, 0.00524, 0.00003,      191,        1,      190
MKV, 0.02128, 0.00045,      235,        5,      230
MKW, 0.02273, 0.00052,       44,        1,       43
MKY, 0      , 0      ,      136,        0,      136
MK_, 0      , 0      ,       15,        0,       15
MLM, 0      , 0      ,       24,        0,       24
MLN, 0      , 0      ,      177,        0,      177
MLP, 0      , 0      ,      176,        0,      176
MLQ, 0      , 0      ,      119,        0,      119
MLR, 0      , 0      ,      235,        0,      235
MLS, 0      , 0      ,      206,        0,      206
MLT, 0.02381, 0.00057,      168,        4,      164
MLV, 0      , 0      ,      183,        0,      183
MLW, 0      , 0      ,       31,        0,       31
MLY, 0      , 0      ,       94,        0,       94
ML_, 0      , 0      ,       15,        0,       15
MMM, 0      , 0      ,        8,        0,        8
MMN, 0      , 0      ,       59,        0,       59
MMP, 0      , 0      ,       54,        0,       54
MMQ, 0      , 0      ,       43,        0,       43
MMR, 0      , 0      ,       58,        0,       58
MMS, 0.06061, 0.00367,       66,        4,       62
MMT, 0      , 0      ,       51,        0,       51
MMV, 0      , 0      ,       56,        0,       56
MMW, 0      , 0      ,       12,        0,       12
MMY, 0      , 0      ,       30,        0,       30
MM_, 0      , 0      ,       26,        0,       26
MNM, 0.10345, 0.0107 ,       29,        3,       26
MNN, 0.01235, 0.00015,       81,        1,       80
MNP, 0      , 0      ,      130,        0,      130
MNQ, 0.02439, 0.00059,       82,        2,       80
MNR, 0      , 0      ,      122,        0,      122
MNS, 0.00971, 0.00009,      103,        1,      102
MNT, 0.02041, 0.00042,       98,        2,       96
MNV, 0.00645, 0.00004,      155,        1,      154
MNW, 0.02632, 0.00069,       38,        1,       37
MNY, 0      , 0      ,       69,        0,       69
MN_, 0      , 0      ,        4,        0,        4
MPM, 0      , 0      ,       39,        0,       39
MPN, 0      , 0      ,       97,        0,       97
MPP, 0.02362, 0.00056,      127,        3,      124
MPQ, 0      , 0      ,      107,        0,      107
MPR, 0      , 0      ,       96,        0,       96
MPS, 0      , 0      ,      104,        0,      104
MPT, 0      , 0      ,      145,        0,      145
MPV, 0      , 0      ,      145,        0,      145
MPW, 0      , 0      ,       21,        0,       21
MPY, 0      , 0      ,       72,        0,       72
MP_, 0      , 0      ,       17,        0,       17
MQM, 0      , 0      ,        8,        0,        8
MQN, 0      , 0      ,       65,        0,       65
MQP, 0      , 0      ,       77,        0,       77
MQQ, 0      , 0      ,       92,        0,       92
MQR, 0      , 0      ,      154,        0,      154
MQS, 0      , 0      ,      118,        0,      118
MQT, 0.00893, 0.00008,      112,        1,      111
MQV, 0.00775, 0.00006,      129,        1,      128
MQW, 0      , 0      ,       32,        0,       32
MQY, 0      , 0      ,       54,        0,       54
MQ_, 0      , 0      ,        6,        0,        6
MRM, 0.03125, 0.00098,       32,        1,       31
MRN, 0.02778, 0.00077,      144,        4,      140
MRP, 0      , 0      ,      130,        0,      130
MRQ, 0.01852, 0.00034,      162,        3,      159
MRR, 0.00461, 0.00002,      217,        1,      216
MRS, 0      , 0      ,      162,        0,      162
MRT, 0      , 0      ,      133,        0,      133
MRV, 0      , 0      ,      222,        0,      222
MRW, 0      , 0      ,       39,        0,       39
MRY, 0      , 0      ,      100,        0,      100
MR_, 0      , 0      ,       19,        0,       19
MSM, 0      , 0      ,       63,        0,       63
MSN, 0.03093, 0.00096,       97,        3,       94
MSP, 0      , 0      ,      137,        0,      137
MSQ, 0.02158, 0.00047,      139,        3,      136
MSR, 0      , 0      ,      121,        0,      121
MSS, 0.00599, 0.00004,      167,        1,      166
MST, 0      , 0      ,      128,        0,      128
MSV, 0.00637, 0.00004,      157,        1,      156
MSW, 0      , 0      ,       17,        0,       17
MSY, 0.01031, 0.00011,       97,        1,       96
MS_, 0      , 0      ,       39,        0,       39
MTM, 0      , 0      ,       43,        0,       43
MTN, 0      , 0      ,      107,        0,      107
MTP, 0      , 0      ,      157,        0,      157
MTQ, 0.02062, 0.00043,       97,        2,       95
MTR, 0.02899, 0.00084,      138,        4,      134
MTS, 0      , 0      ,      131,        0,      131
MTT, 0.00885, 0.00008,      113,        1,      112
MTV, 0.0045 , 0.00002,      222,        1,      221
MTW, 0      , 0      ,       36,        0,       36
MTY, 0      , 0      ,       64,        0,       64
MT_, 0      , 0      ,       20,        0,       20
MVM, 0.05263, 0.00277,       57,        3,       54
MVN, 0      , 0      ,      125,        0,      125
MVP, 0.00943, 0.00009,      106,        1,      105
MVQ, 0      , 0      ,      119,        0,      119
MVR, 0      , 0      ,      159,        0,      159
MVS, 0.0069 , 0.00005,      145,        1,      144
MVT, 0      , 0      ,      145,        0,      145
MVV, 0      , 0      ,      119,        0,      119
MVW, 0      , 0      ,       21,        0,       21
MVY, 0      , 0      ,       42,        0,       42
MV_, 0      , 0      ,       10,        0,       10
MWM, 0      , 0      ,        1,        0,        1
MWN, 0.03333, 0.00111,       30,        1,       29
MWP, 0      , 0      ,       36,        0,       36
MWQ, 0      , 0      ,       28,        0,       28
MWR, 0      , 0      ,       28,        0,       28
MWS, 0      , 0      ,       35,        0,       35
MWT, 0      , 0      ,       25,        0,       25
MWV, 0      , 0      ,       28,        0,       28
MWW, 0      , 0      ,        8,        0,        8
MWY, 0      , 0      ,        7,        0,        7
MYM, 0      , 0      ,       11,        0,       11
MYN, 0      , 0      ,       71,        0,       71
MYP, 0      , 0      ,       63,        0,       63
MYQ, 0.01389, 0.00019,       72,        1,       71
MYR, 0      , 0      ,       82,        0,       82
MYS, 0      , 0      ,       87,        0,       87
MYT, 0      , 0      ,       56,        0,       56
MYV, 0      , 0      ,       92,        0,       92
MYW, 0      , 0      ,       24,        0,       24
MYY, 0.04167, 0.00174,       48,        2,       46
NAN, 0      , 0      ,      122,        0,      122
NAP, 0.00865, 0.00007,      347,        3,      344
NAQ, 0      , 0      ,      278,        0,      278
NAR, 0      , 0      ,      276,        0,      276
NAS, 0      , 0      ,      391,        0,      391
NAT, 0.00882, 0.00008,      340,        3,      337
NAV, 0      , 0      ,      392,        0,      392
NAW, 0      , 0      ,       57,        0,       57
NAY, 0      , 0      ,      188,        0,      188
NA_, 0.01818, 0.00033,       55,        1,       54
NCN, 0      , 0      ,       74,        0,       74
NCP, 0      , 0      ,       45,        0,       45
NCQ, 0      , 0      ,       14,        0,       14
NCR, 0.02703, 0.00073,       37,        1,       36
NCS, 0      , 0      ,       60,        0,       60
NCT, 0      , 0      ,       57,        0,       57
NCV, 0      , 0      ,       63,        0,       63
NCW, 0      , 0      ,       13,        0,       13
NCY, 0      , 0      ,       41,        0,       41
NC_, 0      , 0      ,        4,        0,        4
NDN, 0.07547, 0.0057 ,      106,        8,       98
NDP, 0.01813, 0.00033,      331,        6,      325
NDQ, 0.01136, 0.00013,      176,        2,      174
NDR, 0.02   , 0.0004 ,      250,        5,      245
NDS, 0.00946, 0.00009,      317,        3,      314
NDT, 0.06803, 0.00463,      294,       20,      274
NDV, 0.04516, 0.00204,      465,       21,      444
NDW, 0.09278, 0.00861,       97,        9,       88
NDY, 0.0237 , 0.00056,      211,        5,      206
ND_, 0      , 0      ,       12,        0,       12
NEN, 0.00694, 0.00005,      144,        1,      143
NEP, 0.00777, 0.00006,      386,        3,      383
NEQ, 0.01786, 0.00032,      224,        4,      220
NER, 0.01299, 0.00017,      308,        4,      304
NES, 0.03459, 0.0012 ,      318,       11,      307
NET, 0.00571, 0.00003,      350,        2,      348
NEV, 0.00909, 0.00008,      550,        5,      545
NEW, 0.03597, 0.00129,      139,        5,      134
NEY, 0.01504, 0.00023,      266,        4,      262
NE_, 0      , 0      ,       36,        0,       36
NFN, 0.01042, 0.00011,       96,        1,       95
NFP, 0      , 0      ,      225,        0,      225
NFQ, 0      , 0      ,      124,        0,      124
NFR, 0.0099 , 0.0001 ,      202,        2,      200
NFS, 0      , 0      ,      261,        0,      261
NFT, 0      , 0      ,      207,        0,      207
NFV, 0.01053, 0.00011,      190,        2,      188
NFW, 0      , 0      ,       50,        0,       50
NFY, 0      , 0      ,      102,        0,      102
NF_, 0.04545, 0.00207,       22,        1,       21
NGN, 0      , 0      ,      176,        0,      176
NGP, 0.00429, 0.00002,      233,        1,      232
NGQ, 0.00379, 0.00001,      264,        1,      263
NGR, 0.00585, 0.00003,      342,        2,      340
NGS, 0.00554, 0.00003,      542,        3,      539
NGT, 0.00243, 0.00001,      412,        1,      411
NGV, 0      , 0      ,      451,        0,      451
NGW, 0.0102 , 0.0001 ,       98,        1,       97
NGY, 0.00775, 0.00006,      258,        2,      256
NG_, 0      , 0      ,       16,        0,       16
NHN, 0.04348, 0.00189,       46,        2,       44
NHP, 0.02985, 0.00089,      134,        4,      130
NHQ, 0.04286, 0.00184,       70,        3,       67
NHR, 0.03191, 0.00102,       94,        3,       91
NHS, 0.01961, 0.00038,      102,        2,      100
NHT, 0.02326, 0.00054,      129,        3,      126
NHV, 0.0073 , 0.00005,      137,        1,      136
NHW, 0      , 0      ,       46,        0,       46
NHY, 0.03571, 0.00128,       84,        3,       81
NH_, 0      , 0      ,        5,        0,        5
NIN, 0      , 0      ,      179,        0,      179
NIP, 0      , 0      ,      270,        0,      270
NIQ, 0.01205, 0.00015,      166,        2,      164
NIR, 0      , 0      ,      271,        0,      271
NIS, 0.00316, 0.00001,      316,        1,      315
NIT, 0.00345, 0.00001,      290,        1,      289
NIV, 0.00506, 0.00003,      395,        2,      393
NIW, 0      , 0      ,       48,        0,       48
NIY, 0      , 0      ,      180,        0,      180
NI_, 0      , 0      ,       13,        0,       13
NKN, 0.02837, 0.0008 ,      141,        4,      137
NKP, 0.00448, 0.00002,      223,        1,      222
NKQ, 0      , 0      ,      185,        0,      185
NKR, 0.01014, 0.0001 ,      296,        3,      293
NKS, 0.00327, 0.00001,      306,        1,      305
NKT, 0      , 0      ,      244,        0,      244
NKV, 0.00201, 0      ,      497,        1,      496
NKW, 0      , 0      ,       90,        0,       90
NKY, 0.00725, 0.00005,      276,        2,      274
NK_, 0      , 0      ,       22,        0,       22
NLN, 0      , 0      ,      177,        0,      177
NLP, 0.01253, 0.00016,      479,        6,      473
NLQ, 0      , 0      ,      259,        0,      259
NLR, 0      , 0      ,      375,        0,      375
NLS, 0.00592, 0.00004,      507,        3,      504
NLT, 0.00238, 0.00001,      420,        1,      419
NLV, 0      , 0      ,      467,        0,      467
NLW, 0      , 0      ,       96,        0,       96
NLY, 0.00369, 0.00001,      271,        1,      270
NL_, 0      , 0      ,       41,        0,       41
NMN, 0      , 0      ,       57,        0,       57
NMP, 0      , 0      ,      124,        0,      124
NMQ, 0      , 0      ,       63,        0,       63
NMR, 0      , 0      ,       69,        0,       69
NMS, 0      , 0      ,       99,        0,       99
NMT, 0.01163, 0.00014,       86,        1,       85
NMV, 0      , 0      ,      162,        0,      162
NMW, 0      , 0      ,       16,        0,       16
NMY, 0      , 0      ,       61,        0,       61
NM_, 0      , 0      ,       83,        0,       83
NNN, 0.0625 , 0.00391,      128,        8,      120
NNP, 0.00823, 0.00007,      243,        2,      241
NNQ, 0.04301, 0.00185,      186,        8,      178
NNR, 0.01026, 0.00011,      195,        2,      193
NNS, 0.05735, 0.00329,      279,       16,      263
NNT, 0.00847, 0.00007,      236,        2,      234
NNV, 0.0102 , 0.0001 ,      294,        3,      291
NNW, 0      , 0      ,       85,        0,       85
NNY, 0.01351, 0.00018,      222,        3,      219
NN_, 0      , 0      ,       19,        0,       19
NPN, 0.01235, 0.00015,      162,        2,      160
NPP, 0      , 0      ,      186,        0,      186
NPQ, 0      , 0      ,      178,        0,      178
NPR, 0.00712, 0.00005,      281,        2,      279
NPS, 0.01572, 0.00025,      318,        5,      313
NPT, 0.02344, 0.00055,      256,        6,      250
NPV, 0.00673, 0.00005,      297,        2,      295
NPW, 0      , 0      ,       54,        0,       54
NPY, 0      , 0      ,      251,        0,      251
NP_, 0      , 0      ,       11,        0,       11
NQN, 0      , 0      ,       70,        0,       70
NQP, 0.01258, 0.00016,      159,        2,      157
NQQ, 0      , 0      ,      151,        0,      151
NQR, 0.00444, 0.00002,      225,        1,      224
NQS, 0      , 0      ,      220,        0,      220
NQT, 0.0099 , 0.0001 ,      202,        2,      200
NQV, 0      , 0      ,      226,        0,      226
NQW, 0      , 0      ,       55,        0,       55
NQY, 0.00546, 0.00003,      183,        1,      182
NQ_, 0      , 0      ,       10,        0,       10
NRN, 0.00901, 0.00008,      111,        1,      110
NRP, 0.00962, 0.00009,      208,        2,      206
NRQ, 0.00671, 0.00005,      149,        1,      148
NRR, 0.00412, 0.00002,      243,        1,      242
NRS, 0.00575, 0.00003,      348,        2,      346
NRT, 0.01195, 0.00014,      251,        3,      248
NRV, 0      , 0      ,      344,        0,      344
NRW, 0      , 0      ,       88,        0,       88
NRY, 0.00889, 0.00008,      225,        2,      223
NR_, 0.21053, 0.04432,       19,        4,       15
NSN, 0.01739, 0.0003 ,      115,        2,      113
NSP, 0.00862, 0.00007,      232,        2,      230
NSQ, 0      , 0      ,      193,        0,      193
NSR, 0      , 0      ,      248,        0,      248
NSS, 0.00896, 0.00008,      335,        3,      332
NST, 0      , 0      ,      279,        0,      279
NSV, 0.00581, 0.00003,      344,        2,      342
NSW, 0      , 0      ,       73,        0,       73
NSY, 0.01935, 0.00037,      155,        3,      152
NS_, 0      , 0      ,       61,        0,       61
NTN, 0      , 0      ,       89,        0,       89
NTP, 0.00372, 0.00001,      269,        1,      268
NTQ, 0      , 0      ,      137,        0,      137
NTR, 0.00546, 0.00003,      183,        1,      182
NTS, 0.01176, 0.00014,      255,        3,      252
NTT, 0      , 0      ,      201,        0,      201
NTV, 0      , 0      ,      378,        0,      378
NTW, 0      , 0      ,       75,        0,       75
NTY, 0.01036, 0.00011,      193,        2,      191
NT_, 0      , 0      ,       10,        0,       10
NVN, 0.00833, 0.00007,      120,        1,      119
NVP, 0.00283, 0.00001,      353,        1,      352
NVQ, 0      , 0      ,      170,        0,      170
NVR, 0      , 0      ,      245,        0,      245
NVS, 0.01639, 0.00027,      244,        4,      240
NVT, 0.00932, 0.00009,      429,        4,      425
NVV, 0      , 0      ,      433,        0,      433
NVW, 0      , 0      ,       70,        0,       70
NVY, 0.00526, 0.00003,      190,        1,      189
NV_, 0      , 0      ,        9,        0,        9
NWN, 0      , 0      ,       38,        0,       38
NWP, 0      , 0      ,       86,        0,       86
NWQ, 0      , 0      ,       70,        0,       70
NWR, 0      , 0      ,       94,        0,       94
NWS, 0      , 0      ,       82,        0,       82
NWT, 0      , 0      ,       72,        0,       72
NWV, 0.00909, 0.00008,      110,        1,      109
NWW, 0      , 0      ,       39,        0,       39
NWY, 0.01754, 0.00031,       57,        1,       56
NW_, 0      , 0      ,        2,        0,        2
NYN, 0      , 0      ,       66,        0,       66
NYP, 0      , 0      ,      183,        0,      183
NYQ, 0      , 0      ,      109,        0,      109
NYR, 0.01389, 0.00019,      144,        2,      142
NYS, 0.015  , 0.00022,      200,        3,      197
NYT, 0.00508, 0.00003,      197,        1,      196
NYV, 0.01402, 0.0002 ,      214,        3,      211
NYW, 0      , 0      ,       46,        0,       46
NYY, 0      , 0      ,      134,        0,      134
NY_, 0      , 0      ,        9,        0,        9
PAP, 0      , 0      ,      227,        0,      227
PAQ, 0      , 0      ,      254,        0,      254
PAR, 0.01475, 0.00022,      339,        5,      334
PAS, 0.0058 , 0.00003,      517,        3,      514
PAT, 0      , 0      ,      463,        0,      463
PAV, 0.00198, 0      ,      506,        1,      505
PAW, 0      , 0      ,       84,        0,       84
PAY, 0      , 0      ,      252,        0,      252
PA_, 0      , 0      ,       42,        0,       42
PCP, 0      , 0      ,       51,        0,       51
PCQ, 0      , 0      ,       34,        0,       34
PCR, 0      , 0      ,       55,        0,       55
PCS, 0      , 0      ,       70,        0,       70
PCT, 0      , 0      ,      124,        0,      124
PCV, 0      , 0      ,       48,        0,       48
PCW, 0      , 0      ,       21,        0,       21
PCY, 0      , 0      ,       42,        0,       42
PC_, 0      , 0      ,        7,        0,        7
PDP, 0.01695, 0.00029,      177,        3,      174
PDQ, 0.03077, 0.00095,      260,        8,      252
PDR, 0.00554, 0.00003,      361,        2,      359
PDS, 0.02268, 0.00051,      441,       10,      431
PDT, 0.02778, 0.00077,      468,       13,      455
PDV, 0.02048, 0.00042,      586,       12,      574
PDW, 0      , 0      ,      142,        0,      142
PDY, 0.05919, 0.0035 ,      321,       19,      302
PD_, 0      , 0      ,       21,        0,       21
PEP, 0.02564, 0.00066,      234,        6,      228
PEQ, 0.00255, 0.00001,      392,        1,      391
PER, 0.0133 , 0.00018,      451,        6,      445
PES, 0.01124, 0.00013,      445,        5,      440
PET, 0.01181, 0.00014,      508,        6,      502
PEV, 0.01109, 0.00012,      631,        7,      624
PEW, 0      , 0      ,      108,        0,      108
PEY, 0.04219, 0.00178,      237,       10,      227
PE_, 0      , 0      ,       36,        0,       36
PFP, 0      , 0      ,      122,        0,      122
PFQ, 0      , 0      ,      190,        0,      190
PFR, 0      , 0      ,      267,        0,      267
PFS, 0      , 0      ,      255,        0,      255
PFT, 0      , 0      ,      310,        0,      310
PFV, 0      , 0      ,      311,        0,      311
PFW, 0      , 0      ,       78,        0,       78
PFY, 0.0122 , 0.00015,      164,        2,      162
PF_, 0.05   , 0.0025 ,       20,        1,       19
PGP, 0      , 0      ,      188,        0,      188
PGQ, 0.01402, 0.0002 ,      214,        3,      211
PGR, 0      , 0      ,      337,        0,      337
PGS, 0      , 0      ,      484,        0,      484
PGT, 0.005  , 0.00003,      400,        2,      398
PGV, 0.0075 , 0.00006,      533,        4,      529
PGW, 0      , 0      ,      115,        0,      115
PGY, 0.00712, 0.00005,      281,        2,      279
PG_, 0      , 0      ,       42,        0,       42
PHP, 0      , 0      ,      112,        0,      112
PHQ, 0.02326, 0.00054,      129,        3,      126
PHR, 0.00654, 0.00004,      153,        1,      152
PHS, 0.01299, 0.00017,      154,        2,      152
PHT, 0.02381, 0.00057,      168,        4,      164
PHV, 0.00806, 0.00007,      248,        2,      246
PHW, 0.04   , 0.0016 ,       50,        2,       48
PHY, 0.04444, 0.00198,       90,        4,       86
PH_, 0      , 0      ,        4,        0,        4
PIP, 0      , 0      ,      173,        0,      173
PIQ, 0      , 0      ,      223,        0,      223
PIR, 0      , 0      ,      268,        0,      268
PIS, 0      , 0      ,      451,        0,      451
PIT, 0.00313, 0.00001,      319,        1,      318
PIV, 0.00323, 0.00001,      310,        1,      309
PIW, 0      , 0      ,       65,        0,       65
PIY, 0      , 0      ,      211,        0,      211
PI_, 0      , 0      ,       17,        0,       17
PKP, 0.01282, 0.00016,      156,        2,      154
PKQ, 0      , 0      ,      145,        0,      145
PKR, 0.00627, 0.00004,      319,        2,      317
PKS, 0      , 0      ,      265,        0,      265
PKT, 0.00702, 0.00005,      285,        2,      283
PKV, 0.00932, 0.00009,      429,        4,      425
PKW, 0      , 0      ,       82,        0,       82
PKY, 0.00952, 0.00009,      210,        2,      208
PK_, 0      , 0      ,       28,        0,       28
PLP, 0      , 0      ,      315,        0,      315
PLQ, 0      , 0      ,      349,        0,      349
PLR, 0.00345, 0.00001,      579,        2,      577
PLS, 0.00459, 0.00002,      654,        3,      651
PLT, 0.00723, 0.00005,      553,        4,      549
PLV, 0      , 0      ,      615,        0,      615
PLW, 0      , 0      ,      114,        0,      114
PLY, 0      , 0      ,      316,        0,      316
PL_, 0.02128, 0.00045,       47,        1,       46
PMP, 0.02381, 0.00057,       42,        1,       41
PMQ, 0      , 0      ,       62,        0,       62
PMR, 0      , 0      ,       95,        0,       95
PMS, 0      , 0      ,      115,        0,      115
PMT, 0      , 0      ,      121,        0,      121
PMV, 0      , 0      ,      164,        0,      164
PMW, 0      , 0      ,       29,        0,       29
PMY, 0      , 0      ,       70,        0,       70
PM_, 0      , 0      ,       26,        0,       26
PNP, 0.00855, 0.00007,      117,        1,      116
PNQ, 0.01075, 0.00012,      186,        2,      184
PNR, 0      , 0      ,      210,        0,      210
PNS, 0.00676, 0.00005,      296,        2,      294
PNT, 0.00658, 0.00004,      304,        2,      302
PNV, 0.0229 , 0.00052,      393,        9,      384
PNW, 0      , 0      ,      114,        0,      114
PNY, 0.00617, 0.00004,      162,        1,      161
PN_, 0      , 0      ,       23,        0,       23
PPP, 0      , 0      ,      163,        0,      163
PPQ, 0      , 0      ,      146,        0,      146
PPR, 0      , 0      ,      203,        0,      203
PPS, 0.004  , 0.00002,      250,        1,      249
PPT, 0      , 0      ,      309,        0,      309
PPV, 0.01604, 0.00026,      374,        6,      368
PPW, 0      , 0      ,       48,        0,       48
PPY, 0      , 0      ,      128,        0,      128
PP_, 0      , 0      ,       32,        0,       32
PQP, 0.00971, 0.00009,      103,        1,      102
PQQ, 0.01198, 0.00014,      167,        2,      165
PQR, 0.00552, 0.00003,      181,        1,      180
PQS, 0.00441, 0.00002,      227,        1,      226
PQT, 0      , 0      ,      188,        0,      188
PQV, 0.00331, 0.00001,      302,        1,      301
PQW, 0.03614, 0.00131,       83,        3,       80
PQY, 0.0125 , 0.00016,      160,        2,      158
PQ_, 0      , 0      ,       20,        0,       20
PRP, 0.02326, 0.00054,      172,        4,      168
PRQ, 0.00995, 0.0001 ,      201,        2,      199
PRR, 0.02024, 0.00041,      247,        5,      242
PRS, 0.01329, 0.00018,      301,        4,      297
PRT, 0.00714, 0.00005,      280,        2,      278
PRV, 0.00478, 0.00002,      418,        2,      416
PRW, 0      , 0      ,       81,        0,       81
PRY, 0.00365, 0.00001,      274,        1,      273
PR_, 0      , 0      ,       34,        0,       34
PSP, 0.01111, 0.00012,      180,        2,      178
PSQ, 0      , 0      ,      212,        0,      212
PSR, 0      , 0      ,      287,        0,      287
PSS, 0.0155 , 0.00024,      387,        6,      381
PST, 0.00306, 0.00001,      327,        1,      326
PSV, 0.00219, 0      ,      457,        1,      456
PSW, 0.04505, 0.00203,      111,        5,      106
PSY, 0.00784, 0.00006,      255,        2,      253
PS_, 0      , 0      ,       47,        0,       47
PTP, 0      , 0      ,      184,        0,      184
PTQ, 0.00415, 0.00002,      241,        1,      240
PTR, 0.00345, 0.00001,      290,        1,      289
PTS, 0      , 0      ,      328,        0,      328
PTT, 0.00543, 0.00003,      368,        2,      366
PTV, 0.00901, 0.00008,      555,        5,      550
PTW, 0      , 0      ,      129,        0,      129
PTY, 0.00803, 0.00006,      249,        2,      247
PT_, 0      , 0      ,       25,        0,       25
PVP, 0      , 0      ,      236,        0,      236
PVQ, 0.0125 , 0.00016,      240,        3,      237
PVR, 0.00246, 0.00001,      407,        1,      406
PVS, 0.00417, 0.00002,      480,        2,      478
PVT, 0.00474, 0.00002,      422,        2,      420
PVV, 0      , 0      ,      520,        0,      520
PVW, 0      , 0      ,       78,        0,       78
PVY, 0.00803, 0.00006,      249,        2,      247
PV_, 0      , 0      ,       41,        0,       41
PWP, 0      , 0      ,       27,        0,       27
PWQ, 0      , 0      ,       43,        0,       43
PWR, 0      , 0      ,       70,        0,       70
PWS, 0.01031, 0.00011,       97,        1,       96
PWT, 0      , 0      ,       69,        0,       69
PWV, 0      , 0      ,       76,        0,       76
PWW, 0      , 0      ,       20,        0,       20
PWY, 0      , 0      ,       50,        0,       50
PW_, 0      , 0      ,        9,        0,        9
PYP, 0.02041, 0.00042,       98,        2,       96
PYQ, 0      , 0      ,      114,        0,      114
PYR, 0.01163, 0.00014,      258,        3,      255
PYS, 0.00712, 0.00005,      281,        2,      279
PYT, 0.00472, 0.00002,      212,        1,      211
PYV, 0.0083 , 0.00007,      241,        2,      239
PYW, 0      , 0      ,       61,        0,       61
PYY, 0.00649, 0.00004,      154,        1,      153
PY_, 0      , 0      ,        5,        0,        5
QAQ, 0.00735, 0.00005,      136,        1,      135
QAR, 0.0031 , 0.00001,      323,        1,      322
QAS, 0.00631, 0.00004,      317,        2,      315
QAT, 0.00312, 0.00001,      321,        1,      320
QAV, 0.00204, 0      ,      490,        1,      489
QAW, 0      , 0      ,       98,        0,       98
QAY, 0      , 0      ,      212,        0,      212
QA_, 0      , 0      ,       35,        0,       35
QCQ, 0      , 0      ,       16,        0,       16
QCR, 0      , 0      ,       50,        0,       50
QCS, 0      , 0      ,       47,        0,       47
QCT, 0.06897, 0.00476,       29,        2,       27
QCV, 0      , 0      ,       48,        0,       48
QCW, 0      , 0      ,       22,        0,       22
QCY, 0      , 0      ,       15,        0,       15
QC_, 0      , 0      ,        5,        0,        5
QDQ, 0.03704, 0.00137,       81,        3,       78
QDR, 0.00985, 0.0001 ,      203,        2,      201
QDS, 0.05856, 0.00343,      222,       13,      209
QDT, 0.03646, 0.00133,      192,        7,      185
QDV, 0.00263, 0.00001,      380,        1,      379
QDW, 0.02469, 0.00061,       81,        2,       79
QDY, 0.00943, 0.00009,      212,        2,      210
QD_, 0      , 0      ,        6,        0,        6
QEQ, 0      , 0      ,      140,        0,      140
QER, 0.00229, 0.00001,      437,        1,      436
QES, 0.01027, 0.00011,      292,        3,      289
QET, 0.00692, 0.00005,      289,        2,      287
QEV, 0.04031, 0.00162,      521,       21,      500
QEW, 0      , 0      ,      118,        0,      118
QEY, 0.01435, 0.00021,      209,        3,      206
QE_, 0      , 0      ,       19,        0,       19
QFQ, 0      , 0      ,       38,        0,       38
QFR, 0.00741, 0.00005,      135,        1,      134
QFS, 0.01478, 0.00022,      203,        3,      200
QFT, 0      , 0      ,      142,        0,      142
QFV, 0      , 0      ,      168,        0,      168
QFW, 0      , 0      ,       34,        0,       34
QFY, 0      , 0      ,      111,        0,      111
QF_, 0      , 0      ,       17,        0,       17
QGQ, 0.00752, 0.00006,      133,        1,      132
QGR, 0      , 0      ,      362,        0,      362
QGS, 0.00631, 0.00004,      317,        2,      315
QGT, 0      , 0      ,      292,        0,      292
QGV, 0.00296, 0.00001,      338,        1,      337
QGW, 0.01163, 0.00014,       86,        1,       85
QGY, 0.01579, 0.00025,      190,        3,      187
QG_, 0      , 0      ,       29,        0,       29
QHQ, 0      , 0      ,       34,        0,       34
QHR, 0.0087 , 0.00008,      115,        1,      114
QHS, 0.00935, 0.00009,      107,        1,      106
QHT, 0      , 0      ,      101,        0,      101
QHV, 0.01299, 0.00017,      154,        2,      152
QHW, 0      , 0      ,       47,        0,       47
QHY, 0.02632, 0.00069,       76,        2,       74
QH_, 0.11111, 0.01235,        9,        1,        8
QIQ, 0      , 0      ,       84,        0,       84
QIR, 0.0198 , 0.00039,      202,        4,      198
QIS, 0      , 0      ,      222,        0,      222
QIT, 0      , 0      ,      190,        0,      190
QIV, 0      , 0      ,      234,        0,      234
QIW, 0      , 0      ,       34,        0,       34
QIY, 0      , 0      ,      119,        0,      119
QI_, 0      , 0      ,       10,        0,       10
QKQ, 0      , 0      ,      100,        0,      100
QKR, 0      , 0      ,      280,        0,      280
QKS, 0.01905, 0.00036,      210,        4,      206
QKT, 0.00893, 0.00008,      224,        2,      222
QKV, 0.00252, 0.00001,      397,        1,      396
QKW, 0      , 0      ,      110,        0,      110
QKY, 0.00459, 0.00002,      218,        1,      217
QK_, 0      , 0      ,       26,        0,       26
QLQ, 0      , 0      ,      136,        0,      136
QLR, 0.00278, 0.00001,      360,        1,      359
QLS, 0.00226, 0.00001,      443,        1,      442
QLT, 0.00667, 0.00004,      450,        3,      447
QLV, 0.00248, 0.00001,      404,        1,      403
QLW, 0      , 0      ,       95,        0,       95
QLY, 0.00405, 0.00002,      247,        1,      246
QL_, 0      , 0      ,       27,        0,       27
QMQ, 0      , 0      ,       34,        0,       34
QMR, 0      , 0      ,      108,        0,      108
QMS, 0.00943, 0.00009,      106,        1,      105
QMT, 0.0814 , 0.00663,       86,        7,       79
QMV, 0      , 0      ,       94,        0,       94
QMW, 0      , 0      ,       26,        0,       26
QMY, 0      , 0      ,       56,        0,       56
QM_, 0      , 0      ,       44,        0,       44
QNQ, 0.04   , 0.0016 ,       50,        2,       48
QNR, 0      , 0      ,      187,        0,      187
QNS, 0.02151, 0.00046,      186,        4,      182
QNT, 0      , 0      ,      181,        0,      181
QNV, 0.00949, 0.00009,      316,        3,      313
QNW, 0.01408, 0.0002 ,       71,        1,       70
QNY, 0.04636, 0.00215,      151,        7,      144
QN_, 0.04545, 0.00207,       22,        1,       21
QPQ, 0      , 0      ,       72,        0,       72
QPR, 0      , 0      ,      164,        0,      164
QPS, 0      , 0      ,      225,        0,      225
QPT, 0.00375, 0.00001,      267,        1,      266
QPV, 0.00323, 0.00001,      310,        1,      309
QPW, 0      , 0      ,       55,        0,       55
QPY, 0      , 0      ,      125,        0,      125
QP_, 0      , 0      ,       19,        0,       19
QQQ, 0      , 0      ,       86,        0,       86
QQR, 0.01299, 0.00017,      231,        3,      228
QQS, 0.015  , 0.00022,      200,        3,      197
QQT, 0.01124, 0.00013,      178,        2,      176
QQV, 0.00342, 0.00001,      292,        1,      291
QQW, 0      , 0      ,       83,        0,       83
QQY, 0.02667, 0.00071,      150,        4,      146
QQ_, 0      , 0      ,       21,        0,       21
QRQ, 0.01266, 0.00016,       79,        1,       78
QRR, 0.00485, 0.00002,      206,        1,      205
QRS, 0.01571, 0.00025,      191,        3,      188
QRT, 0.00837, 0.00007,      239,        2,      237
QRV, 0.00993, 0.0001 ,      403,        4,      399
QRW, 0      , 0      ,       70,        0,       70
QRY, 0.01075, 0.00012,      186,        2,      184
QR_, 0.06667, 0.00444,       15,        1,       14
QSQ, 0      , 0      ,       89,        0,       89
QSR, 0      , 0      ,      200,        0,      200
QSS, 0.01075, 0.00012,      279,        3,      276
QST, 0      , 0      ,      212,        0,      212
QSV, 0.00518, 0.00003,      386,        2,      384
QSW, 0.11765, 0.01384,       51,        6,       45
QSY, 0      , 0      ,      181,        0,      181
QS_, 0      , 0      ,       28,        0,       28
QTQ, 0.01075, 0.00012,       93,        1,       92
QTR, 0      , 0      ,      169,        0,      169
QTS, 0.00568, 0.00003,      176,        1,      175
QTT, 0.00943, 0.00009,      212,        2,      210
QTV, 0.01028, 0.00011,      389,        4,      385
QTW, 0      , 0      ,       65,        0,       65
QTY, 0      , 0      ,      179,        0,      179
QT_, 0      , 0      ,       16,        0,       16
QVQ, 0      , 0      ,       86,        0,       86
QVR, 0      , 0      ,      224,        0,      224
QVS, 0      , 0      ,      265,        0,      265
QVT, 0      , 0      ,      253,        0,      253
QVV, 0      , 0      ,      320,        0,      320
QVW, 0      , 0      ,       46,        0,       46
QVY, 0      , 0      ,      127,        0,      127
QV_, 0      , 0      ,       13,        0,       13
QWQ, 0      , 0      ,       53,        0,       53
QWR, 0      , 0      ,      114,        0,      114
QWS, 0      , 0      ,       66,        0,       66
QWT, 0      , 0      ,       79,        0,       79
QWV, 0      , 0      ,      129,        0,      129
QWW, 0      , 0      ,       33,        0,       33
QWY, 0      , 0      ,       32,        0,       32
QW_, 0      , 0      ,        5,        0,        5
QYQ, 0      , 0      ,       75,        0,       75
QYR, 0      , 0      ,      171,        0,      171
QYS, 0.01105, 0.00012,      181,        2,      179
QYT, 0      , 0      ,      159,        0,      159
QYV, 0      , 0      ,      224,        0,      224
QYW, 0.02439, 0.00059,       41,        1,       40
QYY, 0      , 0      ,      137,        0,      137
QY_, 0      , 0      ,       10,        0,       10
RAR, 0      , 0      ,      252,        0,      252
RAS, 0.00207, 0      ,      482,        1,      481
RAT, 0      , 0      ,      333,        0,      333
RAV, 0.00583, 0.00003,      686,        4,      682
RAW, 0      , 0      ,       80,        0,       80
RAY, 0      , 0      ,      214,        0,      214
RA_, 0      , 0      ,       26,        0,       26
RCR, 0      , 0      ,       18,        0,       18
RCS, 0      , 0      ,       41,        0,       41
RCT, 0      , 0      ,       62,        0,       62
RCV, 0      , 0      ,       72,        0,       72
RCW, 0      , 0      ,       14,        0,       14
RCY, 0      , 0      ,       47,        0,       47
RC_, 0      , 0      ,        1,        0,        1
RDR, 0.02632, 0.00069,      228,        6,      222
RDS, 0.01453, 0.00021,      344,        5,      339
RDT, 0.00822, 0.00007,      365,        3,      362
RDV, 0.02385, 0.00057,      587,       14,      573
RDW, 0.03597, 0.00129,      139,        5,      134
RDY, 0.03537, 0.00125,      311,       11,      300
RD_, 0      , 0      ,       32,        0,       32
RER, 0.00617, 0.00004,      324,        2,      322
RES, 0.01522, 0.00023,      460,        7,      453
RET, 0.02655, 0.0007 ,      452,       12,      440
REV, 0.02399, 0.00058,      917,       22,      895
REW, 0      , 0      ,      155,        0,      155
REY, 0.00656, 0.00004,      305,        2,      303
RE_, 0      , 0      ,       44,        0,       44
RFR, 0      , 0      ,      115,        0,      115
RFS, 0.00977, 0.0001 ,      307,        3,      304
RFT, 0      , 0      ,      180,        0,      180
RFV, 0      , 0      ,      290,        0,      290
RFW, 0      , 0      ,       42,        0,       42
RFY, 0      , 0      ,      161,        0,      161
RF_, 0      , 0      ,       15,        0,       15
RGR, 0      , 0      ,      249,        0,      249
RGS, 0.00636, 0.00004,      472,        3,      469
RGT, 0      , 0      ,      420,        0,      420
RGV, 0.00394, 0.00002,      507,        2,      505
RGW, 0.00909, 0.00008,      110,        1,      109
RGY, 0      , 0      ,      304,        0,      304
RG_, 0      , 0      ,       38,        0,       38
RHR, 0      , 0      ,       82,        0,       82
RHS, 0.01478, 0.00022,      203,        3,      200
RHT, 0.00649, 0.00004,      154,        1,      153
RHV, 0.02372, 0.00056,      253,        6,      247
RHW, 0      , 0      ,       60,        0,       60
RHY, 0.04762, 0.00227,      126,        6,      120
RH_, 0      , 0      ,       14,        0,       14
RIR, 0.00629, 0.00004,      159,        1,      158
RIS, 0.00308, 0.00001,      325,        1,      324
RIT, 0      , 0      ,      225,        0,      225
RIV, 0      , 0      ,      318,        0,      318
RIW, 0      , 0      ,       53,        0,       53
RIY, 0      , 0      ,      149,        0,      149
RI_, 0      , 0      ,       14,        0,       14
RKR, 0      , 0      ,      169,        0,      169
RKS, 0.01399, 0.0002 ,      286,        4,      282
RKT, 0      , 0      ,      275,        0,      275
RKV, 0.00361, 0.00001,      554,        2,      552
RKW, 0      , 0      ,       93,        0,       93
RKY, 0.00699, 0.00005,      286,        2,      284
RK_, 0      , 0      ,       56,        0,       56
RLR, 0.01031, 0.00011,      291,        3,      288
RLS, 0.00483, 0.00002,      621,        3,      618
RLT, 0.00208, 0      ,      481,        1,      480
RLV, 0      , 0      ,      561,        0,      561
RLW, 0.01987, 0.00039,      151,        3,      148
RLY, 0.00339, 0.00001,      295,        1,      294
RL_, 0      , 0      ,       32,        0,       32
RMR, 0      , 0      ,       70,        0,       70
RMS, 0.01449, 0.00021,      138,        2,      136
RMT, 0.0084 , 0.00007,      119,        1,      118
RMV, 0      , 0      ,      167,        0,      167
RMW, 0      , 0      ,       35,        0,       35
RMY, 0      , 0      ,       68,        0,       68
RM_, 0      , 0      ,      101,        0,      101
RNR, 0      , 0      ,      160,        0,      160
RNS, 0.00375, 0.00001,      267,        1,      266
RNT, 0      , 0      ,      266,        0,      266
RNV, 0.01099, 0.00012,      364,        4,      360
RNW, 0      , 0      ,       84,        0,       84
RNY, 0.01471, 0.00022,      204,        3,      201
RN_, 0      , 0      ,       33,        0,       33
RPR, 0      , 0      ,      129,        0,      129
RPS, 0      , 0      ,      246,        0,      246
RPT, 0      , 0      ,      252,        0,      252
RPV, 0.0044 , 0.00002,      455,        2,      453
RPW, 0      , 0      ,       81,        0,       81
RPY, 0      , 0      ,      142,        0,      142
RP_, 0.08108, 0.00657,       37,        3,       34
RQR, 0      , 0      ,      118,        0,      118
RQS, 0.00382, 0.00001,      262,        1,      261
RQT, 0      , 0      ,      236,        0,      236
RQV, 0.00484, 0.00002,      413,        2,      411
RQW, 0      , 0      ,       76,        0,       76
RQY, 0.01932, 0.00037,      207,        4,      203
RQ_, 0.04348, 0.00189,       23,        1,       22
RRR, 0.00697, 0.00005,      287,        2,      285
RRS, 0.00272, 0.00001,      367,        1,      366
RRT, 0.00926, 0.00009,      324,        3,      321
RRV, 0.00389, 0.00002,      772,        3,      769
RRW, 0      , 0      ,      126,        0,      126
RRY, 0      , 0      ,      338,        0,      338
RR_, 0      , 0      ,       45,        0,       45
RSR, 0.01081, 0.00012,      185,        2,      183
RSS, 0.00716, 0.00005,      419,        3,      416
RST, 0.00912, 0.00008,      329,        3,      326
RSV, 0.00805, 0.00006,      497,        4,      493
RSW, 0      , 0      ,      109,        0,      109
RSY, 0.00415, 0.00002,      241,        1,      240
RS_, 0      , 0      ,       53,        0,       53
RTR, 0      , 0      ,      147,        0,      147
RTS, 0.00356, 0.00001,      281,        1,      280
RTT, 0.02556, 0.00065,      313,        8,      305
RTV, 0.00758, 0.00006,      396,        3,      393
RTW, 0      , 0      ,       70,        0,       70
RTY, 0.0049 , 0.00002,      204,        1,      203
RT_, 0      , 0      ,       30,        0,       30
RVR, 0      , 0      ,      226,        0,      226
RVS, 0.01329, 0.00018,      301,        4,      297
RVT, 0      , 0      ,      426,        0,      426
RVV, 0      , 0      ,      509,        0,      509
RVW, 0      , 0      ,       88,        0,       88
RVY, 0      , 0      ,      141,        0,      141
RV_, 0      , 0      ,       40,        0,       40
RWR, 0      , 0      ,       48,        0,       48
RWS, 0      , 0      ,       70,        0,       70
RWT, 0      , 0      ,       84,        0,       84
RWV, 0      , 0      ,      125,        0,      125
RWW, 0      , 0      ,       29,        0,       29
RWY, 0.01852, 0.00034,       54,        1,       53
RW_, 0      , 0      ,        1,        0,        1
RYR, 0.00775, 0.00006,      129,        1,      128
RYS, 0.01145, 0.00013,      262,        3,      259
RYT, 0      , 0      ,      210,        0,      210
RYV, 0.00365, 0.00001,      274,        1,      273
RYW, 0      , 0      ,       84,        0,       84
RYY, 0.02094, 0.00044,      191,        4,      187
RY_, 0      , 0      ,        8,        0,        8
SAS, 0.01444, 0.00021,      277,        4,      273
SAT, 0.00188, 0      ,      531,        1,      530
SAV, 0.00321, 0.00001,      623,        2,      621
SAW, 0      , 0      ,      103,        0,      103
SAY, 0      , 0      ,      295,        0,      295
SA_, 0      , 0      ,       35,        0,       35
SCS, 0      , 0      ,       44,        0,       44
SCT, 0.01587, 0.00025,       63,        1,       62
SCV, 0      , 0      ,      104,        0,      104
SCW, 0      , 0      ,       18,        0,       18
SCY, 0      , 0      ,       51,        0,       51
SC_, 0      , 0      ,        8,        0,        8
SDS, 0.05091, 0.00259,      275,       14,      261
SDT, 0.02857, 0.00082,      385,       11,      374
SDV, 0.05255, 0.00276,      666,       35,      631
SDW, 0.01515, 0.00023,      132,        2,      130
SDY, 0.02071, 0.00043,      338,        7,      331
SD_, 0      , 0      ,       21,        0,       21
SES, 0.01124, 0.00013,      267,        3,      264
SET, 0.00993, 0.0001 ,      403,        4,      399
SEV, 0.01882, 0.00035,      797,       15,      782
SEW, 0.0119 , 0.00014,      168,        2,      166
SEY, 0.03763, 0.00142,      372,       14,      358
SE_, 0      , 0      ,       20,        0,       20
SFS, 0      , 0      ,      172,        0,      172
SFT, 0.01013, 0.0001 ,      395,        4,      391
SFV, 0      , 0      ,      321,        0,      321
SFW, 0      , 0      ,       56,        0,       56
SFY, 0.00474, 0.00002,      211,        1,      210
SF_, 0      , 0      ,       20,        0,       20
SGS, 0.00301, 0.00001,      332,        1,      331
SGT, 0.00309, 0.00001,      648,        2,      646
SGV, 0.00922, 0.00008,      651,        6,      645
SGW, 0.02857, 0.00082,      105,        3,      102
SGY, 0      , 0      ,      356,        0,      356
SG_, 0.02128, 0.00045,       94,        2,       92
SHS, 0.04167, 0.00174,       96,        4,       92
SHT, 0.03804, 0.00145,      184,        7,      177
SHV, 0.0177 , 0.00031,      226,        4,      222
SHW, 0.04478, 0.002  ,       67,        3,       64
SHY, 0.00794, 0.00006,      126,        1,      125
SH_, 0      , 0      ,       19,        0,       19
SIS, 0.00407, 0.00002,      246,        1,      245
SIT, 0      , 0      ,      390,        0,      390
SIV, 0      , 0      ,      387,        0,      387
SIW, 0      , 0      ,       83,        0,       83
SIY, 0      , 0      ,      190,        0,      190
SI_, 0      , 0      ,       16,        0,       16
SKS, 0      , 0      ,      209,        0,      209
SKT, 0.00273, 0.00001,      366,        1,      365
SKV, 0.00383, 0.00001,      522,        2,      520
SKW, 0      , 0      ,      118,        0,      118
SKY, 0.0098 , 0.0001 ,      306,        3,      303
SK_, 0      , 0      ,       37,        0,       37
SLS, 0.00344, 0.00001,      291,        1,      290
SLT, 0.0017 , 0      ,      589,        1,      588
SLV, 0      , 0      ,      742,        0,      742
SLW, 0      , 0      ,      109,        0,      109
SLY, 0.00279, 0.00001,      358,        1,      357
SL_, 0      , 0      ,       66,        0,       66
SMS, 0.08   , 0.0064 ,       75,        6,       69
SMT, 0.01709, 0.00029,      117,        2,      115
SMV, 0.0113 , 0.00013,      177,        2,      175
SMW, 0      , 0      ,       39,        0,       39
SMY, 0      , 0      ,       93,        0,       93
SM_, 0      , 0      ,       70,        0,       70
SNS, 0.00889, 0.00008,      225,        2,      223
SNT, 0.00385, 0.00001,      260,        1,      259
SNV, 0.01229, 0.00015,      407,        5,      402
SNW, 0      , 0      ,      106,        0,      106
SNY, 0      , 0      ,      205,        0,      205
SN_, 0      , 0      ,       43,        0,       43
SPS, 0.02252, 0.00051,      222,        5,      217
SPT, 0.0027 , 0.00001,      370,        1,      369
SPV, 0.00215, 0      ,      465,        1,      464
SPW, 0      , 0      ,      105,        0,      105
SPY, 0      , 0      ,      280,        0,      280
SP_, 0      , 0      ,       30,        0,       30
SQS, 0.03165, 0.001  ,      158,        5,      153
SQT, 0.00422, 0.00002,      237,        1,      236
SQV, 0.01136, 0.00013,      352,        4,      348
SQW, 0.01149, 0.00013,       87,        1,       86
SQY, 0.00439, 0.00002,      228,        1,      227
SQ_, 0      , 0      ,       26,        0,       26
SRS, 0.0119 , 0.00014,      252,        3,      249
SRT, 0.01258, 0.00016,      318,        4,      314
SRV, 0.02586, 0.00067,      580,       15,      565
SRW, 0      , 0      ,      107,        0,      107
SRY, 0.00654, 0.00004,      306,        2,      304
SR_, 0      , 0      ,       13,        0,       13
SSS, 0.01527, 0.00023,      262,        4,      258
SST, 0.00947, 0.00009,      528,        5,      523
SSV, 0.00768, 0.00006,      651,        5,      646
SSW, 0      , 0      ,      129,        0,      129
SSY, 0.00517, 0.00003,      387,        2,      385
SS_, 0      , 0      ,       31,        0,       31
STS, 0.01087, 0.00012,      184,        2,      182
STT, 0.00911, 0.00008,      439,        4,      435
STV, 0.0039 , 0.00002,      513,        2,      511
STW, 0.00917, 0.00008,      109,        1,      108
STY, 0.00885, 0.00008,      226,        2,      224
ST_, 0      , 0      ,       17,        0,       17
SVS, 0.01091, 0.00012,      275,        3,      272
SVT, 0.00414, 0.00002,      483,        2,      481
SVV, 0.00372, 0.00001,      538,        2,      536
SVW, 0      , 0      ,       95,        0,       95
SVY, 0.00881, 0.00008,      227,        2,      225
SV_, 0      , 0      ,       44,        0,       44
SWS, 0      , 0      ,      101,        0,      101
SWT, 0.0101 , 0.0001 ,       99,        1,       98
SWV, 0.03077, 0.00095,      130,        4,      126
SWW, 0      , 0      ,       29,        0,       29
SWY, 0.01667, 0.00028,       60,        1,       59
SYS, 0.01596, 0.00025,      188,        3,      185
SYT, 0.02183, 0.00048,      229,        5,      224
SYV, 0.00977, 0.0001 ,      307,        3,      304
SYW, 0      , 0      ,       77,        0,       77
SYY, 0.00549, 0.00003,      182,        1,      181
SY_, 0      , 0      ,        8,        0,        8
TAT, 0.0098 , 0.0001 ,      204,        2,      202
TAV, 0      , 0      ,      517,        0,      517
TAW, 0      , 0      ,      114,        0,      114
TAY, 0.00543, 0.00003,      184,        1,      183
TA_, 0.01515, 0.00023,       66,        1,       65
TCT, 0.02326, 0.00054,       43,        1,       42
TCV, 0      , 0      ,       78,        0,       78
TCW, 0      , 0      ,        9,        0,        9
TCY, 0      , 0      ,       41,        0,       41
TC_, 0      , 0      ,        5,        0,        5
TDT, 0.04605, 0.00212,      152,        7,      145
TDV, 0.03978, 0.00158,      553,       22,      531
TDW, 0.03509, 0.00123,      114,        4,      110
TDY, 0.04437, 0.00197,      293,       13,      280
TD_, 0.07143, 0.0051 ,       28,        2,       26
TET, 0.01093, 0.00012,      183,        2,      181
TEV, 0.03327, 0.00111,      571,       19,      552
TEW, 0.01333, 0.00018,      150,        2,      148
TEY, 0.02222, 0.00049,      270,        6,      264
TE_, 0      , 0      ,       27,        0,       27
TFT, 0.00617, 0.00004,      162,        1,      161
TFV, 0      , 0      ,      332,        0,      332
TFW, 0      , 0      ,       40,        0,       40
TFY, 0      , 0      ,      156,        0,      156
TF_, 0      , 0      ,       10,        0,       10
TGT, 0.0076 , 0.00006,      263,        2,      261
TGV, 0.00997, 0.0001 ,      602,        6,      596
TGW, 0      , 0      ,      106,        0,      106
TGY, 0      , 0      ,      285,        0,      285
TG_, 0      , 0      ,       18,        0,       18
THT, 0      , 0      ,       82,        0,       82
THV, 0.03608, 0.0013 ,      194,        7,      187
THW, 0.05634, 0.00317,       71,        4,       67
THY, 0.02609, 0.00068,      115,        3,      112
TH_, 0.15385, 0.02367,       13,        2,       11
TIT, 0.01923, 0.00037,      156,        3,      153
TIV, 0.01156, 0.00013,      346,        4,      342
TIW, 0      , 0      ,       58,        0,       58
TIY, 0.0087 , 0.00008,      115,        1,      114
TI_, 0      , 0      ,       18,        0,       18
TKT, 0.00503, 0.00003,      199,        1,      198
TKV, 0.00425, 0.00002,      471,        2,      469
TKW, 0      , 0      ,       93,        0,       93
TKY, 0      , 0      ,      280,        0,      280
TK_, 0      , 0      ,       57,        0,       57
TLT, 0      , 0      ,      283,        0,      283
TLV, 0      , 0      ,      554,        0,      554
TLW, 0      , 0      ,       84,        0,       84
TLY, 0      , 0      ,      252,        0,      252
TL_, 0      , 0      ,       37,        0,       37
TMT, 0.01923, 0.00037,       52,        1,       51
TMV, 0      , 0      ,      110,        0,      110
TMW, 0      , 0      ,       28,        0,       28
TMY, 0      , 0      ,       58,        0,       58
TM_, 0      , 0      ,       43,        0,       43
TNT, 0.00714, 0.00005,      140,        1,      139
TNV, 0.01055, 0.00011,      379,        4,      375
TNW, 0.02564, 0.00066,       78,        2,       76
TNY, 0      , 0      ,      206,        0,      206
TN_, 0      , 0      ,       15,        0,       15
TPT, 0.00917, 0.00008,      218,        2,      216
TPV, 0      , 0      ,      489,        0,      489
TPW, 0      , 0      ,       93,        0,       93
TPY, 0.00461, 0.00002,      217,        1,      216
TP_, 0.06061, 0.00367,       33,        2,       31
TQT, 0.00971, 0.00009,      103,        1,      102
TQV, 0.01807, 0.00033,      332,        6,      326
TQW, 0      , 0      ,       72,        0,       72
TQY, 0      , 0      ,      167,        0,      167
TQ_, 0      , 0      ,       16,        0,       16
TRT, 0.01493, 0.00022,      134,        2,      132
TRV, 0.01684, 0.00028,      475,        8,      467
TRW, 0      , 0      ,      103,        0,      103
TRY, 0.00365, 0.00001,      274,        1,      273
TR_, 0      , 0      ,       23,        0,       23
TST, 0.00699, 0.00005,      143,        1,      142
TSV, 0.00893, 0.00008,      448,        4,      444
TSW, 0.01639, 0.00027,       61,        1,       60
TSY, 0      , 0      ,      260,        0,      260
TS_, 0      , 0      ,       44,        0,       44
TTT, 0.01339, 0.00018,      224,        3,      221
TTV, 0.00794, 0.00006,      378,        3,      375
TTW, 0      , 0      ,       77,        0,       77
TTY, 0      , 0      ,      163,        0,      163
TT_, 0      , 0      ,       65,        0,       65
TVT, 0      , 0      ,      188,        0,      188
TVV, 0      , 0      ,      410,        0,      410
TVW, 0.01149, 0.00013,       87,        1,       86
TVY, 0.01143, 0.00013,      175,        2,      173
TV_, 0      , 0      ,       19,        0,       19
TWT, 0      , 0      ,       33,        0,       33
TWV, 0      , 0      ,      124,        0,      124
TWW, 0      , 0      ,       22,        0,       22
TWY, 0      , 0      ,       49,        0,       49
TW_, 0      , 0      ,        4,        0,        4
TYT, 0      , 0      ,      105,        0,      105
TYV, 0.01742, 0.0003 ,      287,        5,      282
TYW, 0      , 0      ,       54,        0,       54
TYY, 0      , 0      ,      146,        0,      146
TY_, 0      , 0      ,        6,        0,        6
VAV, 0      , 0      ,      283,        0,      283
VAW, 0      , 0      ,       77,        0,       77
VAY, 0      , 0      ,      256,        0,      256
VA_, 0      , 0      ,       38,        0,       38
VCV, 0      , 0      ,       34,        0,       34
VCW, 0      , 0      ,       17,        0,       17
VCY, 0      , 0      ,       49,        0,       49
VDV, 0.03695, 0.00136,      406,       15,      391
VDW, 0.04712, 0.00222,      191,        9,      182
VDY, 0.07423, 0.00551,      485,       36,      449
VD_, 0      , 0      ,       24,        0,       24
VEV, 0.01765, 0.00031,      510,        9,      501
VEW, 0.01471, 0.00022,      136,        2,      134
VEY, 0.02186, 0.00048,      366,        8,      358
VE_, 0.02439, 0.00059,       41,        1,       40
VFV, 0.00649, 0.00004,      154,        1,      153
VFW, 0      , 0      ,       40,        0,       40
VFY, 0      , 0      ,      136,        0,      136
VF_, 0      , 0      ,       14,        0,       14
VGV, 0      , 0      ,      243,        0,      243
VGW, 0      , 0      ,       67,        0,       67
VGY, 0      , 0      ,      286,        0,      286
VG_, 0      , 0      ,       38,        0,       38
VHV, 0.00763, 0.00006,      131,        1,      130
VHW, 0.02273, 0.00052,       44,        1,       43
VHY, 0.01613, 0.00026,      124,        2,      122
VH_, 0.125  , 0.01562,        8,        1,        7
VIV, 0.0061 , 0.00004,      164,        1,      163
VIW, 0      , 0      ,       34,        0,       34
VIY, 0      , 0      ,      161,        0,      161
VI_, 0      , 0      ,       15,        0,       15
VKV, 0.00474, 0.00002,      422,        2,      420
VKW, 0.03061, 0.00094,       98,        3,       95
VKY, 0.00955, 0.00009,      314,        3,      311
VK_, 0      , 0      ,       74,        0,       74
VLV, 0      , 0      ,      330,        0,      330
VLW, 0      , 0      ,      117,        0,      117
VLY, 0      , 0      ,      296,        0,      296
VL_, 0      , 0      ,       47,        0,       47
VMV, 0      , 0      ,       62,        0,       62
VMW, 0      , 0      ,       26,        0,       26
VMY, 0      , 0      ,       59,        0,       59
VM_, 0      , 0      ,       75,        0,       75
VNV, 0.00412, 0.00002,      243,        1,      242
VNW, 0.0101 , 0.0001 ,       99,        1,       98
VNY, 0.0082 , 0.00007,      244,        2,      242
VN_, 0      , 0      ,       14,        0,       14
VPV, 0.00216, 0      ,      462,        1,      461
VPW, 0      , 0      ,       79,        0,       79
VPY, 0      , 0      ,      252,        0,      252
VP_, 0      , 0      ,       41,        0,       41
VQV, 0.01299, 0.00017,      231,        3,      228
VQW, 0.01053, 0.00011,       95,        1,       94
VQY, 0.00481, 0.00002,      208,        1,      207
VQ_, 0      , 0      ,       12,        0,       12
VRV, 0.00305, 0.00001,      328,        1,      327
VRW, 0.01739, 0.0003 ,      115,        2,      113
VRY, 0.01299, 0.00017,      308,        4,      304
VR_, 0      , 0      ,       36,        0,       36
VSV, 0.00369, 0.00001,      271,        1,      270
VSW, 0.00813, 0.00007,      123,        1,      122
VSY, 0      , 0      ,      296,        0,      296
VS_, 0      , 0      ,       35,        0,       35
VTV, 0.00693, 0.00005,      433,        3,      430
VTW, 0      , 0      ,       82,        0,       82
VTY, 0.00365, 0.00001,      274,        1,      273
VT_, 0      , 0      ,       32,        0,       32
VVV, 0      , 0      ,      219,        0,      219
VVW, 0      , 0      ,       41,        0,       41
VVY, 0.00461, 0.00002,      217,        1,      216
VV_, 0      , 0      ,       49,        0,       49
VWV, 0      , 0      ,       58,        0,       58
VWW, 0      , 0      ,       20,        0,       20
VWY, 0.02703, 0.00073,       37,        1,       36
VW_, 0      , 0      ,        6,        0,        6
VYV, 0.01948, 0.00038,      154,        3,      151
VYW, 0      , 0      ,       40,        0,       40
VYY, 0.00649, 0.00004,      154,        1,      153
VY_, 0      , 0      ,        7,        0,        7
WAW, 0      , 0      ,       14,        0,       14
WAY, 0      , 0      ,       58,        0,       58
WA_, 0      , 0      ,        9,        0,        9
WCW, 0      , 0      ,        4,        0,        4
WCY, 0      , 0      ,        5,        0,        5
WDW, 0      , 0      ,       10,        0,       10
WDY, 0.04598, 0.00211,       87,        4,       83
WD_, 0      , 0      ,        4,        0,        4
WEW, 0      , 0      ,       18,        0,       18
WEY, 0      , 0      ,       86,        0,       86
WE_, 0      , 0      ,       18,        0,       18
WFW, 0      , 0      ,       13,        0,       13
WFY, 0      , 0      ,       23,        0,       23
WGW, 0      , 0      ,       10,        0,       10
WGY, 0.01515, 0.00023,       66,        1,       65
WG_, 0      , 0      ,        4,        0,        4
WHW, 0      , 0      ,        4,        0,        4
WHY, 0      , 0      ,       36,        0,       36
WIW, 0      , 0      ,        1,        0,        1
WIY, 0      , 0      ,       24,        0,       24
WI_, 0      , 0      ,        2,        0,        2
WKW, 0      , 0      ,       17,        0,       17
WKY, 0      , 0      ,       58,        0,       58
WK_, 0      , 0      ,        9,        0,        9
WLW, 0      , 0      ,        4,        0,        4
WLY, 0      , 0      ,       71,        0,       71
WL_, 0      , 0      ,       22,        0,       22
WMY, 0      , 0      ,        7,        0,        7
WM_, 0      , 0      ,       10,        0,       10
WNW, 0      , 0      ,        7,        0,        7
WNY, 0      , 0      ,       42,        0,       42
WPW, 0      , 0      ,        2,        0,        2
WPY, 0      , 0      ,       33,        0,       33
WP_, 0      , 0      ,        6,        0,        6
WQW, 0      , 0      ,        9,        0,        9
WQY, 0.02174, 0.00047,       46,        1,       45
WQ_, 0      , 0      ,        5,        0,        5
WRW, 0      , 0      ,       12,        0,       12
WRY, 0      , 0      ,       75,        0,       75
WR_, 0      , 0      ,       14,        0,       14
WSW, 0.16667, 0.02778,       12,        2,       10
WSY, 0      , 0      ,       35,        0,       35
WS_, 0      , 0      ,        7,        0,        7
WTW, 0      , 0      ,        7,        0,        7
WTY, 0      , 0      ,       53,        0,       53
WT_, 0      , 0      ,        3,        0,        3
WVW, 0      , 0      ,        1,        0,        1
WVY, 0.04762, 0.00227,       42,        2,       40
WV_, 0      , 0      ,       13,        0,       13
WWW, 0      , 0      ,        2,        0,        2
WWY, 0      , 0      ,        8,        0,        8
WW_, 0      , 0      ,        3,        0,        3
WYW, 0      , 0      ,        4,        0,        4
WYY, 0      , 0      ,       30,        0,       30
YAY, 0      , 0      ,       58,        0,       58
YA_, 0      , 0      ,       17,        0,       17
YCY, 0      , 0      ,       12,        0,       12
YDY, 0.02041, 0.00042,      147,        3,      144
YD_, 0      , 0      ,       17,        0,       17
YEY, 0.02857, 0.00082,      105,        3,      102
YE_, 0      , 0      ,       31,        0,       31
YFY, 0      , 0      ,       46,        0,       46
YF_, 0      , 0      ,        5,        0,        5
YGY, 0.01961, 0.00038,      102,        2,      100
YG_, 0      , 0      ,       17,        0,       17
YHY, 0      , 0      ,       48,        0,       48
YH_, 0.36364, 0.13223,       11,        4,        7
YIY, 0      , 0      ,       37,        0,       37
YI_, 0      , 0      ,        4,        0,        4
YKY, 0      , 0      ,      100,        0,      100
YK_, 0.06667, 0.00444,       15,        1,       14
YLY, 0      , 0      ,       90,        0,       90
YL_, 0      , 0      ,       31,        0,       31
YMY, 0      , 0      ,       26,        0,       26
YM_, 0      , 0      ,       19,        0,       19
YNY, 0      , 0      ,       59,        0,       59
YN_, 0      , 0      ,       18,        0,       18
YPY, 0      , 0      ,       52,        0,       52
YP_, 0      , 0      ,       13,        0,       13
YQY, 0      , 0      ,       53,        0,       53
YQ_, 0      , 0      ,       10,        0,       10
YRY, 0      , 0      ,      114,        0,      114
YR_, 0      , 0      ,        5,        0,        5
YSY, 0.03448, 0.00119,       87,        3,       84
YS_, 0      , 0      ,       15,        0,       15
YTY, 0      , 0      ,       54,        0,       54
YT_, 0      , 0      ,       20,        0,       20
YVY, 0      , 0      ,       58,        0,       58
YV_, 0      , 0      ,       10,        0,       10
YWY, 0      , 0      ,        8,        0,        8
YW_, 0      , 0      ,        2,        0,        2
YYY, 0      , 0      ,       48,        0,       48
YY_, 0      , 0      ,        8,        0,        8
_F_, 0      , 0      ,        2,        0,        2
