key, pos_ratio, pos_ratio^2, count, pos, neg
AAA, 0.06306, 0.00398,      111,        7,      104
AAC, 0.03571, 0.00128,       28,        1,       27
AAD, 0.01481, 0.00022,      135,        2,      133
AAE, 0.00571, 0.00003,      175,        1,      174
AAF, 0.09211, 0.00848,       76,        7,       69
AAG, 0.05036, 0.00254,      139,        7,      132
AAH, 0.08511, 0.00724,       47,        4,       43
AAI, 0.01562, 0.00024,      128,        2,      126
AAK, 0.06154, 0.00379,      130,        8,      122
AAL, 0.02538, 0.00064,      197,        5,      192
AAM, 0.06667, 0.00444,       45,        3,       42
AAN, 0.02632, 0.00069,       76,        2,       74
AAP, 0.02469, 0.00061,       81,        2,       79
AAQ, 0.05714, 0.00327,      105,        6,       99
AAR, 0.03509, 0.00123,      114,        4,      110
AAS, 0.04965, 0.00246,      141,        7,      134
AAT, 0.0708 , 0.00501,      113,        8,      105
AAV, 0.07362, 0.00542,      163,       12,      151
AAW, 0.03704, 0.00137,       27,        1,       26
AAY, 0.04412, 0.00195,       68,        3,       65
AA_, 0      , 0      ,       13,        0,       13
ACA, 0      , 0      ,       12,        0,       12
ACC, 0      , 0      ,        4,        0,        4
ACD, 0.04167, 0.00174,       24,        1,       23
ACE, 0.10345, 0.0107 ,       29,        3,       26
ACF, 0.05882, 0.00346,       17,        1,       16
ACG, 0.13636, 0.0186 ,       22,        3,       19
ACH, 0.0625 , 0.00391,       16,        1,       15
ACI, 0.08333, 0.00694,       24,        2,       22
ACK, 0      , 0      ,       22,        0,       22
ACL, 0.025  , 0.00063,       40,        1,       39
ACM, 0.2    , 0.04   ,       10,        2,        8
ACN, 0      , 0      ,       17,        0,       17
ACP, 0.07143, 0.0051 ,       14,        1,       13
ACQ, 0.09524, 0.00907,       21,        2,       19
ACR, 0.17647, 0.03114,       17,        3,       14
ACS, 0.09375, 0.00879,       32,        3,       29
ACT, 0.04545, 0.00207,       22,        1,       21
ACV, 0.16   , 0.0256 ,       25,        4,       21
ACW, 0      , 0      ,       10,        0,       10
ACY, 0      , 0      ,       16,        0,       16
AC_, 0      , 0      ,        1,        0,        1
ADA, 0      , 0      ,       54,        0,       54
ADC, 0.06667, 0.00444,       30,        2,       28
ADD, 0.06742, 0.00454,       89,        6,       83
ADE, 0.01653, 0.00027,      121,        2,      119
ADF, 0.04598, 0.00211,       87,        4,       83
ADG, 0.06107, 0.00373,      131,        8,      123
ADH, 0.07692, 0.00592,       26,        2,       24
ADI, 0.02703, 0.00073,      148,        4,      144
ADK, 0.06087, 0.00371,      115,        7,      108
ADL, 0.05263, 0.00277,      190,       10,      180
ADM, 0.04444, 0.00198,       45,        2,       43
ADN, 0.1129 , 0.01275,       62,        7,       55
ADP, 0.03488, 0.00122,       86,        3,       83
ADQ, 0.04412, 0.00195,       68,        3,       65
ADR, 0.01   , 0.0001 ,      100,        1,       99
ADS, 0.04673, 0.00218,      107,        5,      102
ADT, 0.07527, 0.00567,       93,        7,       86
ADV, 0.06832, 0.00467,      161,       11,      150
ADW, 0      , 0      ,       22,        0,       22
ADY, 0.03659, 0.00134,       82,        3,       79
AD_, 0      , 0      ,        5,        0,        5
AEA, 0.04237, 0.0018 ,      118,        5,      113
AEC, 0.03846, 0.00148,       26,        1,       25
AED, 0.08029, 0.00645,      137,       11,      126
AEE, 0.06061, 0.00367,      198,       12,      186
AEF, 0.14433, 0.02083,       97,       14,       83
AEG, 0.04444, 0.00198,      135,        6,      129
AEH, 0.22222, 0.04938,       36,        8,       28
AEI, 0.07143, 0.0051 ,      140,       10,      130
AEK, 0.02646, 0.0007 ,      189,        5,      184
AEL, 0.03876, 0.0015 ,      258,       10,      248
AEM, 0.06667, 0.00444,       45,        3,       42
AEN, 0.03604, 0.0013 ,      111,        4,      107
AEP, 0.04124, 0.0017 ,       97,        4,       93
AEQ, 0.02703, 0.00073,      111,        3,      108
AER, 0.024  , 0.00058,      125,        3,      122
AES, 0.04124, 0.0017 ,       97,        4,       93
AET, 0.01923, 0.00037,      104,        2,      102
AEV, 0.02326, 0.00054,      172,        4,      168
AEW, 0.02703, 0.00073,       37,        1,       36
AEY, 0.03614, 0.00131,       83,        3,       80
AE_, 0.1    , 0.01   ,       10,        1,        9
AFA, 0.11765, 0.01384,       34,        4,       30
AFC, 0.15   , 0.0225 ,       20,        3,       17
AFD, 0.1375 , 0.01891,       80,       11,       69
AFE, 0.19298, 0.03724,       57,       11,       46
AFF, 0.05714, 0.00327,       35,        2,       33
AFG, 0.06667, 0.00444,       75,        5,       70
AFH, 0.10526, 0.01108,       19,        2,       17
AFI, 0.14583, 0.02127,       48,        7,       41
AFK, 0.18919, 0.03579,       74,       14,       60
AFL, 0.14118, 0.01993,       85,       12,       73
AFM, 0.11111, 0.01235,       18,        2,       16
AFN, 0.04   , 0.0016 ,       50,        2,       48
AFP, 0.15909, 0.02531,       44,        7,       37
AFQ, 0.14286, 0.02041,       42,        6,       36
AFR, 0.04348, 0.00189,       46,        2,       44
AFS, 0.09412, 0.00886,       85,        8,       77
AFT, 0.16667, 0.02778,       48,        8,       40
AFV, 0.07576, 0.00574,       66,        5,       61
AFW, 0      , 0      ,       11,        0,       11
AFY, 0.07143, 0.0051 ,       28,        2,       26
AF_, 0      , 0      ,        4,        0,        4
AGA, 0.1    , 0.01   ,       60,        6,       54
AGC, 0.05882, 0.00346,       34,        2,       32
AGD, 0.01802, 0.00032,      111,        2,      109
AGE, 0.03306, 0.00109,      121,        4,      117
AGF, 0.05172, 0.00268,       58,        3,       55
AGG, 0.0604 , 0.00365,      149,        9,      140
AGH, 0.11364, 0.01291,       44,        5,       39
AGI, 0.08333, 0.00694,       96,        8,       88
AGK, 0.0339 , 0.00115,      118,        4,      114
AGL, 0.03546, 0.00126,      141,        5,      136
AGM, 0      , 0      ,       28,        0,       28
AGN, 0.04615, 0.00213,       65,        3,       62
AGP, 0.01493, 0.00022,       67,        1,       66
AGQ, 0.07595, 0.00577,       79,        6,       73
AGR, 0.06329, 0.00401,       79,        5,       74
AGS, 0.05385, 0.0029 ,      130,        7,      123
AGT, 0.09278, 0.00861,       97,        9,       88
AGV, 0.02609, 0.00068,      115,        3,      112
AGW, 0.09677, 0.00937,       31,        3,       28
AGY, 0.06757, 0.00457,       74,        5,       69
AG_, 0      , 0      ,       18,        0,       18
AHA, 0.16667, 0.02778,       24,        4,       20
AHC, 0.25   , 0.0625 ,       20,        5,       15
AHD, 0.16667, 0.02778,       36,        6,       30
AHE, 0.18182, 0.03306,       44,        8,       36
AHF, 0.1    , 0.01   ,       30,        3,       27
AHG, 0.16   , 0.0256 ,       50,        8,       42
AHH, 0.14286, 0.02041,       14,        2,       12
AHI, 0.12195, 0.01487,       41,        5,       36
AHK, 0.15152, 0.02296,       33,        5,       28
AHL, 0.04839, 0.00234,       62,        3,       59
AHM, 0.21053, 0.04432,       19,        4,       15
AHN, 0.04545, 0.00207,       22,        1,       21
AHP, 0.10345, 0.0107 ,       29,        3,       26
AHQ, 0.10811, 0.01169,       37,        4,       33
AHR, 0.02632, 0.00069,       38,        1,       37
AHS, 0.09302, 0.00865,       43,        4,       39
AHT, 0.18421, 0.03393,       38,        7,       31
AHV, 0.13514, 0.01826,       37,        5,       32
AHW, 0.25   , 0.0625 ,        8,        2,        6
AHY, 0.10714, 0.01148,       28,        3,       25
AH_, 0      , 0      ,        2,        0,        2
AIA, 0.04054, 0.00164,       74,        3,       71
AIC, 0.09091, 0.00826,       22,        2,       20
AID, 0.07   , 0.0049 ,      100,        7,       93
AIE, 0.05357, 0.00287,      112,        6,      106
AIF, 0.04   , 0.0016 ,       50,        2,       48
AIG, 0.0411 , 0.00169,       73,        3,       70
AIH, 0.11765, 0.01384,       34,        4,       30
AII, 0.06452, 0.00416,       62,        4,       58
AIK, 0.06061, 0.00367,       99,        6,       93
AIL, 0.10714, 0.01148,      112,       12,      100
AIM, 0.13889, 0.01929,       36,        5,       31
AIN, 0.09677, 0.00937,       62,        6,       56
AIP, 0.05556, 0.00309,       54,        3,       51
AIQ, 0.04545, 0.00207,       44,        2,       42
AIR, 0.125  , 0.01562,       88,       11,       77
AIS, 0.07792, 0.00607,       77,        6,       71
AIT, 0.15054, 0.02266,       93,       14,       79
AIV, 0.07317, 0.00535,       82,        6,       76
AIW, 0      , 0      ,       14,        0,       14
AIY, 0.06818, 0.00465,       44,        3,       41
AI_, 0      , 0      ,        3,        0,        3
AKA, 0.05495, 0.00302,       91,        5,       86
AKC, 0.06061, 0.00367,       33,        2,       31
AKD, 0.01786, 0.00032,      112,        2,      110
AKE, 0.03774, 0.00142,      159,        6,      153
AKF, 0.08451, 0.00714,       71,        6,       65
AKG, 0.04724, 0.00223,      127,        6,      121
AKH, 0.09756, 0.00952,       41,        4,       37
AKI, 0.09167, 0.0084 ,      120,       11,      109
AKK, 0.07299, 0.00533,      137,       10,      127
AKL, 0.07328, 0.00537,      232,       17,      215
AKM, 0.01667, 0.00028,       60,        1,       59
AKN, 0.03297, 0.00109,       91,        3,       88
AKP, 0      , 0      ,       72,        0,       72
AKQ, 0.05376, 0.00289,       93,        5,       88
AKR, 0.05618, 0.00316,       89,        5,       84
AKS, 0.06481, 0.0042 ,      108,        7,      101
AKT, 0.0625 , 0.00391,      112,        7,      105
AKV, 0.07299, 0.00533,      137,       10,      127
AKW, 0.17391, 0.03025,       23,        4,       19
AKY, 0.08   , 0.0064 ,       75,        6,       69
AK_, 0.07692, 0.00592,       13,        1,       12
ALA, 0.06863, 0.00471,      102,        7,       95
ALC, 0.09524, 0.00907,       42,        4,       38
ALD, 0.08784, 0.00772,      148,       13,      135
ALE, 0.05479, 0.003  ,      219,       12,      207
ALF, 0.08333, 0.00694,       84,        7,       77
ALG, 0.05488, 0.00301,      164,        9,      155
ALH, 0.08621, 0.00743,       58,        5,       53
ALI, 0.05882, 0.00346,      119,        7,      112
ALK, 0.08743, 0.00764,      183,       16,      167
ALL, 0.0524 , 0.00275,      229,       12,      217
ALM, 0.03509, 0.00123,       57,        2,       55
ALN, 0.09091, 0.00826,       99,        9,       90
ALP, 0.03361, 0.00113,      119,        4,      115
ALQ, 0.06087, 0.00371,      115,        7,      108
ALR, 0.04242, 0.0018 ,      165,        7,      158
ALS, 0.07303, 0.00533,      178,       13,      165
ALT, 0.05   , 0.0025 ,      120,        6,      114
ALV, 0.09804, 0.00961,      153,       15,      138
ALW, 0.06452, 0.00416,       31,        2,       29
ALY, 0.05747, 0.0033 ,       87,        5,       82
AL_, 0      , 0      ,       12,        0,       12
AMA, 0.06897, 0.00476,       29,        2,       27
AMC, 0.18182, 0.03306,       11,        2,        9
AMD, 0.04444, 0.00198,       45,        2,       43
AME, 0.08333, 0.00694,       48,        4,       44
AMF, 0      , 0      ,       23,        0,       23
AMG, 0.18367, 0.03374,       49,        9,       40
AMH, 0.07143, 0.0051 ,       28,        2,       26
AMI, 0.16667, 0.02778,       30,        5,       25
AMK, 0      , 0      ,       47,        0,       47
AML, 0.11475, 0.01317,       61,        7,       54
AMM, 0.0625 , 0.00391,       16,        1,       15
AMN, 0      , 0      ,       23,        0,       23
AMP, 0.10526, 0.01108,       19,        2,       17
AMQ, 0.13793, 0.01902,       29,        4,       25
AMR, 0.06897, 0.00476,       29,        2,       27
AMS, 0.10526, 0.01108,       38,        4,       34
AMT, 0.03571, 0.00128,       28,        1,       27
AMV, 0.06977, 0.00487,       43,        3,       40
AMW, 0      , 0      ,        9,        0,        9
AMY, 0.125  , 0.01562,       16,        2,       14
AM_, 0      , 0      ,       12,        0,       12
ANA, 0.01923, 0.00037,       52,        1,       51
ANC, 0.11765, 0.01384,       17,        2,       15
AND, 0.08197, 0.00672,       61,        5,       56
ANE, 0.01449, 0.00021,       69,        1,       68
ANF, 0.05634, 0.00317,       71,        4,       67
ANG, 0.09434, 0.0089 ,      106,       10,       96
ANH, 0.06667, 0.00444,       30,        2,       28
ANI, 0.08511, 0.00724,       94,        8,       86
ANK, 0.06024, 0.00363,       83,        5,       78
ANL, 0.08594, 0.00739,      128,       11,      117
ANM, 0.08   , 0.0064 ,       25,        2,       23
ANN, 0.04688, 0.0022 ,       64,        3,       61
ANP, 0.04225, 0.00179,       71,        3,       68
ANQ, 0.03846, 0.00148,       52,        2,       50
ANR, 0.01493, 0.00022,       67,        1,       66
ANS, 0.11475, 0.01317,       61,        7,       54
ANT, 0.11321, 0.01282,       53,        6,       47
ANV, 0.0875 , 0.00766,       80,        7,       73
ANW, 0      , 0      ,       14,        0,       14
ANY, 0.16   , 0.0256 ,       50,        8,       42
AN_, 0      , 0      ,        8,        0,        8
APA, 0      , 0      ,       39,        0,       39
APC, 0      , 0      ,       20,        0,       20
APD, 0.04   , 0.0016 ,      100,        4,       96
APE, 0.01031, 0.00011,       97,        1,       96
APF, 0.14286, 0.02041,       28,        4,       24
APG, 0.05455, 0.00298,      110,        6,      104
APH, 0      , 0      ,       34,        0,       34
API, 0.06667, 0.00444,       90,        6,       84
APK, 0.04918, 0.00242,       61,        3,       58
APL, 0.0219 , 0.00048,      137,        3,      134
APM, 0.09091, 0.00826,       22,        2,       20
APN, 0.03571, 0.00128,       56,        2,       54
APP, 0.05634, 0.00317,       71,        4,       67
APQ, 0.02381, 0.00057,       42,        1,       41
APR, 0.10526, 0.01108,       57,        6,       51
APS, 0.03261, 0.00106,       92,        3,       89
APT, 0.01136, 0.00013,       88,        1,       87
APV, 0.04301, 0.00185,       93,        4,       89
APW, 0.05882, 0.00346,       17,        1,       16
APY, 0.05405, 0.00292,       37,        2,       35
AP_, 0      , 0      ,       10,        0,       10
AQA, 0.10448, 0.01092,       67,        7,       60
AQC, 0.19355, 0.03746,       31,        6,       25
AQD, 0.0625 , 0.00391,       64,        4,       60
AQE, 0.03158, 0.001  ,       95,        3,       92
AQF, 0.08929, 0.00797,       56,        5,       51
AQG, 0.03   , 0.0009 ,      100,        3,       97
AQH, 0.06383, 0.00407,       47,        3,       44
AQI, 0.14943, 0.02233,       87,       13,       74
AQK, 0.03529, 0.00125,       85,        3,       82
AQL, 0.02597, 0.00067,      154,        4,      150
AQM, 0.17073, 0.02915,       41,        7,       34
AQN, 0.03571, 0.00128,       56,        2,       54
AQP, 0.04255, 0.00181,       47,        2,       45
AQQ, 0.08   , 0.0064 ,      100,        8,       92
AQR, 0.05682, 0.00323,       88,        5,       83
AQS, 0.0597 , 0.00356,       67,        4,       63
AQT, 0.08861, 0.00785,       79,        7,       72
AQV, 0.11628, 0.01352,       86,       10,       76
AQW, 0.12   , 0.0144 ,       25,        3,       22
AQY, 0.01887, 0.00036,       53,        1,       52
AQ_, 0      , 0      ,        3,        0,        3
ARA, 0.02941, 0.00087,       68,        2,       66
ARC, 0.04167, 0.00174,       24,        1,       23
ARD, 0.1068 , 0.01141,      103,       11,       92
ARE, 0.0687 , 0.00472,      131,        9,      122
ARF, 0.06452, 0.00416,       62,        4,       58
ARG, 0.11224, 0.0126 ,       98,       11,       87
ARH, 0.06061, 0.00367,       33,        2,       31
ARI, 0.12871, 0.01657,      101,       13,       88
ARK, 0.08333, 0.00694,       84,        7,       77
ARL, 0.06936, 0.00481,      173,       12,      161
ARM, 0.13333, 0.01778,       30,        4,       26
ARN, 0.07042, 0.00496,       71,        5,       66
ARP, 0.10938, 0.01196,       64,        7,       57
ARQ, 0.07595, 0.00577,       79,        6,       73
ARR, 0.04808, 0.00231,      104,        5,       99
ARS, 0.04348, 0.00189,       92,        4,       88
ART, 0.06977, 0.00487,       86,        6,       80
ARV, 0.04225, 0.00179,      142,        6,      136
ARW, 0.13636, 0.0186 ,       22,        3,       19
ARY, 0.05   , 0.0025 ,       60,        3,       57
AR_, 0      , 0      ,        3,        0,        3
ASA, 0.08   , 0.0064 ,       75,        6,       69
ASC, 0.13333, 0.01778,       30,        4,       26
ASD, 0.01124, 0.00013,       89,        1,       88
ASE, 0.06316, 0.00399,       95,        6,       89
ASF, 0.03704, 0.00137,       81,        3,       78
ASG, 0.05263, 0.00277,      133,        7,      126
ASH, 0.1    , 0.01   ,       40,        4,       36
ASI, 0.04808, 0.00231,      104,        5,       99
ASK, 0.00901, 0.00008,      111,        1,      110
ASL, 0.07821, 0.00612,      179,       14,      165
ASM, 0.01923, 0.00037,       52,        1,       51
ASN, 0.04478, 0.002  ,       67,        3,       64
ASP, 0.01961, 0.00038,      102,        2,      100
ASQ, 0.07463, 0.00557,       67,        5,       62
ASR, 0.05682, 0.00323,       88,        5,       83
ASS, 0.0493 , 0.00243,      142,        7,      135
AST, 0.07609, 0.00579,       92,        7,       85
ASV, 0.06667, 0.00444,      150,       10,      140
ASW, 0.03704, 0.00137,       27,        1,       26
ASY, 0.06579, 0.00433,       76,        5,       71
AS_, 0      , 0      ,       15,        0,       15
ATA, 0.07895, 0.00623,       76,        6,       70
ATC, 0.02564, 0.00066,       39,        1,       38
ATD, 0.06522, 0.00425,       92,        6,       86
ATE, 0.0396 , 0.00157,      101,        4,       97
ATF, 0.07018, 0.00492,       57,        4,       53
ATG, 0.04237, 0.0018 ,      118,        5,      113
ATH, 0.0303 , 0.00092,       33,        1,       32
ATI, 0.01031, 0.00011,       97,        1,       96
ATK, 0.10938, 0.01196,       64,        7,       57
ATL, 0.06044, 0.00365,      182,       11,      171
ATM, 0.03448, 0.00119,       29,        1,       28
ATN, 0.08108, 0.00657,       74,        6,       68
ATP, 0.04839, 0.00234,       62,        3,       59
ATQ, 0.05634, 0.00317,       71,        4,       67
ATR, 0.03896, 0.00152,       77,        3,       74
ATS, 0.05263, 0.00277,       76,        4,       72
ATT, 0.06579, 0.00433,       76,        5,       71
ATV, 0.02542, 0.00065,      118,        3,      115
ATW, 0      , 0      ,       16,        0,       16
ATY, 0.04918, 0.00242,       61,        3,       58
AT_, 0      , 0      ,        4,        0,        4
AVA, 0.04054, 0.00164,       74,        3,       71
AVC, 0.02703, 0.00073,       37,        1,       36
AVD, 0.03738, 0.0014 ,      107,        4,      103
AVE, 0.10484, 0.01099,      124,       13,      111
AVF, 0.06349, 0.00403,       63,        4,       59
AVG, 0.05983, 0.00358,      117,        7,      110
AVH, 0.12821, 0.01644,       39,        5,       34
AVI, 0.07447, 0.00555,       94,        7,       87
AVK, 0.06542, 0.00428,      107,        7,      100
AVL, 0.08861, 0.00785,      158,       14,      144
AVM, 0.05263, 0.00277,       38,        2,       36
AVN, 0.04878, 0.00238,       82,        4,       78
AVP, 0.11392, 0.01298,       79,        9,       70
AVQ, 0.03797, 0.00144,       79,        3,       76
AVR, 0.07692, 0.00592,      104,        8,       96
AVS, 0.08411, 0.00707,      107,        9,       98
AVT, 0.11111, 0.01235,       99,       11,       88
AVV, 0.03774, 0.00142,      106,        4,      102
AVW, 0.125  , 0.01562,       24,        3,       21
AVY, 0.06667, 0.00444,       60,        4,       56
AV_, 0      , 0      ,        4,        0,        4
AWA, 0.14286, 0.02041,        7,        1,        6
AWC, 0.44444, 0.19753,        9,        4,        5
AWD, 0.04545, 0.00207,       22,        1,       21
AWE, 0.07143, 0.0051 ,       14,        1,       13
AWF, 0.13333, 0.01778,       15,        2,       13
AWG, 0.26667, 0.07111,       15,        4,       11
AWH, 0.2    , 0.04   ,       10,        2,        8
AWI, 0.06667, 0.00444,       15,        1,       14
AWK, 0.19231, 0.03698,       26,        5,       21
AWL, 0.06897, 0.00476,       29,        2,       27
AWM, 0.16667, 0.02778,       12,        2,       10
AWN, 0.15789, 0.02493,       19,        3,       16
AWP, 0.07143, 0.0051 ,       28,        2,       26
AWQ, 0      , 0      ,       14,        0,       14
AWR, 0.17391, 0.03025,       23,        4,       19
AWS, 0.07407, 0.00549,       27,        2,       25
AWT, 0.2    , 0.04   ,       20,        4,       16
AWV, 0.23077, 0.05325,       13,        3,       10
AWW, 0      , 0      ,        4,        0,        4
AWY, 0.07692, 0.00592,       13,        1,       12
AW_, 0      , 0      ,        2,        0,        2
AYA, 0.04762, 0.00227,       42,        2,       40
AYC, 0.12   , 0.0144 ,       25,        3,       22
AYD, 0.04762, 0.00227,       63,        3,       60
AYE, 0.13514, 0.01826,       74,       10,       64
AYF, 0.13333, 0.01778,       45,        6,       39
AYG, 0.08974, 0.00805,       78,        7,       71
AYH, 0.04762, 0.00227,       21,        1,       20
AYI, 0.06452, 0.00416,       62,        4,       58
AYK, 0.08   , 0.0064 ,       50,        4,       46
AYL, 0.1413 , 0.01997,       92,       13,       79
AYM, 0.07692, 0.00592,       13,        1,       12
AYN, 0.11429, 0.01306,       35,        4,       31
AYP, 0.10526, 0.01108,       38,        4,       34
AYQ, 0.13043, 0.01701,       46,        6,       40
AYR, 0.08163, 0.00666,       49,        4,       45
AYS, 0.09375, 0.00879,       64,        6,       58
AYT, 0.20896, 0.04366,       67,       14,       53
AYV, 0.09756, 0.00952,       82,        8,       74
AYW, 0.14286, 0.02041,       14,        2,       12
AYY, 0.19048, 0.03628,       42,        8,       34
AY_, 0      , 0      ,        5,        0,        5
CAC, 0      , 0      ,        4,        0,        4
CAD, 0.12903, 0.01665,       31,        4,       27
CAE, 0.1    , 0.01   ,       20,        2,       18
CAF, 0.1875 , 0.03516,       16,        3,       13
CAG, 0.10714, 0.01148,       28,        3,       25
CAH, 0      , 0      ,        9,        0,        9
CAI, 0.1    , 0.01   ,       20,        2,       18
CAK, 0      , 0      ,       19,        0,       19
CAL, 0      , 0      ,       29,        0,       29
CAM, 0.2    , 0.04   ,        5,        1,        4
CAN, 0.05   , 0.0025 ,       20,        1,       19
CAP, 0.04167, 0.00174,       24,        1,       23
CAQ, 0      , 0      ,       24,        0,       24
CAR, 0.05   , 0.0025 ,       20,        1,       19
CAS, 0.03226, 0.00104,       31,        1,       30
CAT, 0      , 0      ,       23,        0,       23
CAV, 0.05405, 0.00292,       37,        2,       35
CAW, 0      , 0      ,        6,        0,        6
CAY, 0.1875 , 0.03516,       16,        3,       13
CA_, 0      , 0      ,        1,        0,        1
CCC, 0      , 0      ,        1,        0,        1
CCD, 0.11765, 0.01384,       17,        2,       15
CCE, 0      , 0      ,        8,        0,        8
CCF, 0.2    , 0.04   ,       10,        2,        8
CCG, 0.09091, 0.00826,       11,        1,       10
CCH, 0.16667, 0.02778,        6,        1,        5
CCI, 0.75   , 0.5625 ,        8,        6,        2
CCK, 0      , 0      ,        7,        0,        7
CCL, 0.11111, 0.01235,       18,        2,       16
CCM, 0      , 0      ,        2,        0,        2
CCN, 0      , 0      ,        7,        0,        7
CCP, 0.16667, 0.02778,        6,        1,        5
CCQ, 0.5    , 0.25   ,        4,        2,        2
CCR, 0      , 0      ,        7,        0,        7
CCS, 0.125  , 0.01562,       16,        2,       14
CCT, 0      , 0      ,        5,        0,        5
CCV, 0      , 0      ,        4,        0,        4
CCY, 0      , 0      ,        7,        0,        7
CDC, 0.22222, 0.04938,        9,        2,        7
CDD, 0.0625 , 0.00391,       32,        2,       30
CDE, 0.15625, 0.02441,       32,        5,       27
CDF, 0.14286, 0.02041,       28,        4,       24
CDG, 0.16   , 0.0256 ,       25,        4,       21
CDH, 0.18182, 0.03306,       11,        2,        9
CDI, 0.04348, 0.00189,       23,        1,       22
CDK, 0.12121, 0.01469,       33,        4,       29
CDL, 0.1087 , 0.01181,       46,        5,       41
CDM, 0.18182, 0.03306,       11,        2,        9
CDN, 0.0625 , 0.00391,       16,        1,       15
CDP, 0      , 0      ,       23,        0,       23
CDQ, 0      , 0      ,       10,        0,       10
CDR, 0.19048, 0.03628,       21,        4,       17
CDS, 0.12121, 0.01469,       33,        4,       29
CDT, 0.04348, 0.00189,       23,        1,       22
CDV, 0      , 0      ,       28,        0,       28
CDW, 0      , 0      ,        7,        0,        7
CDY, 0.15789, 0.02493,       19,        3,       16
CD_, 0      , 0      ,        2,        0,        2
CEC, 0      , 0      ,       10,        0,       10
CED, 0.08571, 0.00735,       35,        3,       32
CEE, 0.07692, 0.00592,       52,        4,       48
CEF, 0.07692, 0.00592,       13,        1,       12
CEG, 0.04878, 0.00238,       41,        2,       39
CEH, 0.08333, 0.00694,       12,        1,       11
CEI, 0.17143, 0.02939,       35,        6,       29
CEK, 0.05263, 0.00277,       38,        2,       36
CEL, 0.10417, 0.01085,       48,        5,       43
CEM, 0.07692, 0.00592,       13,        1,       12
CEN, 0      , 0      ,       27,        0,       27
CEP, 0.03448, 0.00119,       29,        1,       28
CEQ, 0.05   , 0.0025 ,       20,        1,       19
CER, 0.11538, 0.01331,       26,        3,       23
CES, 0.13793, 0.01902,       29,        4,       25
CET, 0.04545, 0.00207,       22,        1,       21
CEV, 0.03333, 0.00111,       30,        1,       29
CEW, 0.2    , 0.04   ,        5,        1,        4
CEY, 0      , 0      ,       25,        0,       25
CFC, 0      , 0      ,        3,        0,        3
CFD, 0.2    , 0.04   ,       20,        4,       16
CFE, 0.08333, 0.00694,       12,        1,       11
CFF, 0.07143, 0.0051 ,       14,        1,       13
CFG, 0.17391, 0.03025,       23,        4,       19
CFH, 0.11111, 0.01235,        9,        1,        8
CFI, 0      , 0      ,        5,        0,        5
CFK, 0.14286, 0.02041,       14,        2,       12
CFL, 0.28   , 0.0784 ,       25,        7,       18
CFM, 0.1    , 0.01   ,       10,        1,        9
CFN, 0.23077, 0.05325,       13,        3,       10
CFP, 0      , 0      ,        8,        0,        8
CFQ, 0.23077, 0.05325,       13,        3,       10
CFR, 0.21429, 0.04592,       14,        3,       11
CFS, 0.125  , 0.01562,       24,        3,       21
CFT, 0.25   , 0.0625 ,       16,        4,       12
CFV, 0.04545, 0.00207,       22,        1,       21
CFW, 0      , 0      ,        8,        0,        8
CFY, 0.2    , 0.04   ,       20,        4,       16
CF_, 0      , 0      ,        1,        0,        1
CGC, 0      , 0      ,        6,        0,        6
CGD, 0.02857, 0.00082,       35,        1,       34
CGE, 0.125  , 0.01562,       40,        5,       35
CGF, 0.125  , 0.01562,        8,        1,        7
CGG, 0.08571, 0.00735,       35,        3,       32
CGH, 0.13333, 0.01778,       15,        2,       13
CGI, 0.3125 , 0.09766,       16,        5,       11
CGK, 0.04348, 0.00189,       23,        1,       22
CGL, 0.04   , 0.0016 ,       25,        1,       24
CGM, 0      , 0      ,        6,        0,        6
CGN, 0      , 0      ,       16,        0,       16
CGP, 0      , 0      ,       17,        0,       17
CGQ, 0      , 0      ,       28,        0,       28
CGR, 0.10345, 0.0107 ,       29,        3,       26
CGS, 0.09524, 0.00907,       42,        4,       38
CGT, 0.125  , 0.01562,       32,        4,       28
CGV, 0.18182, 0.03306,       22,        4,       18
CGW, 0.2    , 0.04   ,        5,        1,        4
CGY, 0      , 0      ,       12,        0,       12
CG_, 0.25   , 0.0625 ,        4,        1,        3
CHD, 0      , 0      ,       11,        0,       11
CHE, 0.25   , 0.0625 ,       12,        3,        9
CHF, 0      , 0      ,        8,        0,        8
CHG, 0.15789, 0.02493,       19,        3,       16
CHH, 0      , 0      ,        7,        0,        7
CHI, 0.07692, 0.00592,       13,        1,       12
CHK, 0.08333, 0.00694,       12,        1,       11
CHL, 0      , 0      ,       30,        0,       30
CHM, 0      , 0      ,        6,        0,        6
CHN, 0.1    , 0.01   ,       10,        1,        9
CHP, 0.0625 , 0.00391,       16,        1,       15
CHQ, 0.14286, 0.02041,        7,        1,        6
CHR, 0      , 0      ,       10,        0,       10
CHS, 0.10526, 0.01108,       19,        2,       17
CHT, 0      , 0      ,        9,        0,        9
CHV, 0.08333, 0.00694,       12,        1,       11
CHW, 0.33333, 0.11111,        3,        1,        2
CHY, 0      , 0      ,        8,        0,        8
CIC, 0      , 0      ,        4,        0,        4
CID, 0      , 0      ,       21,        0,       21
CIE, 0.2    , 0.04   ,       20,        4,       16
CIF, 0      , 0      ,        7,        0,        7
CIG, 0.17391, 0.03025,       23,        4,       19
CIH, 0      , 0      ,        8,        0,        8
CII, 0.125  , 0.01562,       16,        2,       14
CIK, 0.05882, 0.00346,       17,        1,       16
CIL, 0.18182, 0.03306,       33,        6,       27
CIM, 0.11111, 0.01235,        9,        1,        8
CIN, 0.04167, 0.00174,       24,        1,       23
CIP, 0      , 0      ,       20,        0,       20
CIQ, 0.05   , 0.0025 ,       20,        1,       19
CIR, 0.08333, 0.00694,       12,        1,       11
CIS, 0.04762, 0.00227,       21,        1,       20
CIT, 0.1    , 0.01   ,       10,        1,        9
CIV, 0.125  , 0.01562,       32,        4,       28
CIW, 0      , 0      ,        6,        0,        6
CIY, 0.11765, 0.01384,       17,        2,       15
CKC, 1      , 1      ,        1,        1,        0
CKD, 0.04878, 0.00238,       41,        2,       39
CKE, 0.06977, 0.00487,       43,        3,       40
CKF, 0.05   , 0.0025 ,       20,        1,       19
CKG, 0.02703, 0.00073,       37,        1,       36
CKH, 0      , 0      ,        8,        0,        8
CKI, 0.04762, 0.00227,       21,        1,       20
CKK, 0.04878, 0.00238,       41,        2,       39
CKL, 0.07692, 0.00592,       39,        3,       36
CKM, 0      , 0      ,       10,        0,       10
CKN, 0.11111, 0.01235,       27,        3,       24
CKP, 0      , 0      ,       23,        0,       23
CKQ, 0.05263, 0.00277,       19,        1,       18
CKR, 0.125  , 0.01562,       16,        2,       14
CKS, 0      , 0      ,       26,        0,       26
CKT, 0.04167, 0.00174,       24,        1,       23
CKV, 0.03704, 0.00137,       27,        1,       26
CKW, 0.11111, 0.01235,        9,        1,        8
CKY, 0      , 0      ,       18,        0,       18
CK_, 0      , 0      ,        4,        0,        4
CLC, 0      , 0      ,       11,        0,       11
CLD, 0.1875 , 0.03516,       32,        6,       26
CLE, 0.11765, 0.01384,       34,        4,       30
CLF, 0.04545, 0.00207,       22,        1,       21
CLG, 0.17073, 0.02915,       41,        7,       34
CLH, 0.14286, 0.02041,       14,        2,       12
CLI, 0.08696, 0.00756,       23,        2,       21
CLK, 0.08824, 0.00779,       34,        3,       31
CLL, 0.10714, 0.01148,       56,        6,       50
CLM, 0.1    , 0.01   ,       10,        1,        9
CLN, 0      , 0      ,       30,        0,       30
CLP, 0.03125, 0.00098,       32,        1,       31
CLQ, 0.06897, 0.00476,       29,        2,       27
CLR, 0.15789, 0.02493,       38,        6,       32
CLS, 0.12821, 0.01644,       39,        5,       34
CLT, 0.16129, 0.02601,       31,        5,       26
CLV, 0.09375, 0.00879,       32,        3,       29
CLW, 0      , 0      ,        5,        0,        5
CLY, 0.22222, 0.04938,       27,        6,       21
CL_, 0      , 0      ,        3,        0,        3
CMC, 0      , 0      ,        1,        0,        1
CMD, 0      , 0      ,       10,        0,       10
CME, 0      , 0      ,       14,        0,       14
CMF, 0      , 0      ,        3,        0,        3
CMG, 0.18182, 0.03306,       11,        2,        9
CMH, 0      , 0      ,        3,        0,        3
CMI, 0      , 0      ,        3,        0,        3
CMK, 0      , 0      ,       18,        0,       18
CML, 0.5    , 0.25   ,        8,        4,        4
CMM, 1      , 1      ,        1,        1,        0
CMN, 0      , 0      ,        9,        0,        9
CMP, 0      , 0      ,        9,        0,        9
CMQ, 0.16667, 0.02778,        6,        1,        5
CMR, 0      , 0      ,        1,        0,        1
CMS, 0      , 0      ,       15,        0,       15
CMT, 0.25   , 0.0625 ,        4,        1,        3
CMV, 0.15385, 0.02367,       13,        2,       11
CMW, 0      , 0      ,        1,        0,        1
CMY, 0      , 0      ,        2,        0,        2
CM_, 0.33333, 0.11111,        3,        1,        2
CNC, 0      , 0      ,       12,        0,       12
CND, 0.04348, 0.00189,       23,        1,       22
CNE, 0.06897, 0.00476,       29,        2,       27
CNF, 0.06667, 0.00444,       15,        1,       14
CNG, 0      , 0      ,       25,        0,       25
CNH, 0      , 0      ,        6,        0,        6
CNI, 0.06667, 0.00444,       15,        1,       14
CNK, 0.04348, 0.00189,       23,        1,       22
CNL, 0      , 0      ,       30,        0,       30
CNM, 0      , 0      ,        4,        0,        4
CNN, 0.11765, 0.01384,       17,        2,       15
CNP, 0.03846, 0.00148,       26,        1,       25
CNQ, 0      , 0      ,       17,        0,       17
CNR, 0.04762, 0.00227,       21,        1,       20
CNS, 0.03704, 0.00137,       27,        1,       26
CNT, 0      , 0      ,       23,        0,       23
CNV, 0.04545, 0.00207,       22,        1,       21
CNW, 0      , 0      ,        3,        0,        3
CNY, 0      , 0      ,        9,        0,        9
CN_, 0      , 0      ,        1,        0,        1
CPC, 0      , 0      ,        2,        0,        2
CPD, 0.07407, 0.00549,       27,        2,       25
CPE, 0.03571, 0.00128,       28,        1,       27
CPF, 0      , 0      ,       10,        0,       10
CPG, 0.04348, 0.00189,       23,        1,       22
CPH, 0      , 0      ,       12,        0,       12
CPI, 0      , 0      ,       21,        0,       21
CPK, 0      , 0      ,       29,        0,       29
CPL, 0.06452, 0.00416,       31,        2,       29
CPM, 0      , 0      ,        4,        0,        4
CPN, 0      , 0      ,       21,        0,       21
CPP, 0      , 0      ,       25,        0,       25
CPQ, 0      , 0      ,       20,        0,       20
CPR, 0.08333, 0.00694,       24,        2,       22
CPS, 0.16   , 0.0256 ,       25,        4,       21
CPT, 0      , 0      ,       22,        0,       22
CPV, 0.03448, 0.00119,       29,        1,       28
CPW, 0      , 0      ,        7,        0,        7
CPY, 0.25   , 0.0625 ,       16,        4,       12
CQC, 0.33333, 0.11111,        6,        2,        4
CQD, 0.09375, 0.00879,       32,        3,       29
CQE, 0.07692, 0.00592,       26,        2,       24
CQF, 0.09091, 0.00826,       11,        1,       10
CQG, 0.08571, 0.00735,       35,        3,       32
CQH, 0.08333, 0.00694,       12,        1,       11
CQI, 0      , 0      ,       17,        0,       17
CQK, 0      , 0      ,       30,        0,       30
CQL, 0.03448, 0.00119,       29,        1,       28
CQM, 0.22222, 0.04938,        9,        2,        7
CQN, 0.21429, 0.04592,       14,        3,       11
CQP, 0      , 0      ,       13,        0,       13
CQQ, 0      , 0      ,       19,        0,       19
CQR, 0.1    , 0.01   ,       20,        2,       18
CQS, 0.12   , 0.0144 ,       25,        3,       22
CQT, 0.11111, 0.01235,       27,        3,       24
CQV, 0.13636, 0.0186 ,       22,        3,       19
CQW, 0      , 0      ,        4,        0,        4
CQY, 0      , 0      ,       21,        0,       21
CQ_, 0      , 0      ,        1,        0,        1
CRC, 0      , 0      ,        3,        0,        3
CRD, 0.02778, 0.00077,       36,        1,       35
CRE, 0.02778, 0.00077,       36,        1,       35
CRF, 0.1875 , 0.03516,       16,        3,       13
CRG, 0.10256, 0.01052,       39,        4,       35
CRH, 0      , 0      ,       11,        0,       11
CRI, 0.04167, 0.00174,       24,        1,       23
CRK, 0.2    , 0.04   ,       25,        5,       20
CRL, 0.02564, 0.00066,       39,        1,       38
CRM, 0.08333, 0.00694,       12,        1,       11
CRN, 0.125  , 0.01562,       24,        3,       21
CRP, 0.03704, 0.00137,       27,        1,       26
CRQ, 0      , 0      ,       21,        0,       21
CRR, 0.11765, 0.01384,       34,        4,       30
CRS, 0.09524, 0.00907,       21,        2,       19
CRT, 0.05556, 0.00309,       18,        1,       17
CRV, 0.11905, 0.01417,       42,        5,       37
CRW, 0.06667, 0.00444,       15,        1,       14
CRY, 0.0625 , 0.00391,       16,        1,       15
CR_, 0      , 0      ,        5,        0,        5
CSC, 0      , 0      ,       11,        0,       11
CSD, 0.19231, 0.03698,       26,        5,       21
CSE, 0      , 0      ,       32,        0,       32
CSF, 0.12   , 0.0144 ,       25,        3,       22
CSG, 0.02564, 0.00066,       39,        1,       38
CSH, 0      , 0      ,       12,        0,       12
CSI, 0.12121, 0.01469,       33,        4,       29
CSK, 0.03448, 0.00119,       29,        1,       28
CSL, 0      , 0      ,       48,        0,       48
CSM, 0      , 0      ,        8,        0,        8
CSN, 0      , 0      ,       16,        0,       16
CSP, 0.03704, 0.00137,       27,        1,       26
CSQ, 0      , 0      ,       18,        0,       18
CSR, 0      , 0      ,       24,        0,       24
CSS, 0.01923, 0.00037,       52,        1,       51
CST, 0      , 0      ,       14,        0,       14
CSV, 0.02564, 0.00066,       39,        1,       38
CSW, 0.16667, 0.02778,        6,        1,        5
CSY, 0      , 0      ,       19,        0,       19
CS_, 0.4    , 0.16   ,        5,        2,        3
CTC, 0      , 0      ,        8,        0,        8
CTD, 0.09677, 0.00937,       31,        3,       28
CTE, 0.04545, 0.00207,       22,        1,       21
CTF, 0      , 0      ,       16,        0,       16
CTG, 0.09091, 0.00826,       22,        2,       20
CTH, 0      , 0      ,       11,        0,       11
CTI, 0.09091, 0.00826,       11,        1,       10
CTK, 0.07143, 0.0051 ,       28,        2,       26
CTL, 0.03571, 0.00128,       28,        1,       27
CTM, 0      , 0      ,        8,        0,        8
CTN, 0      , 0      ,       15,        0,       15
CTP, 0.08696, 0.00756,       23,        2,       21
CTQ, 0.07143, 0.0051 ,       14,        1,       13
CTR, 0.07143, 0.0051 ,       14,        1,       13
CTS, 0.08   , 0.0064 ,       25,        2,       23
CTT, 0.08   , 0.0064 ,       25,        2,       23
CTV, 0.02703, 0.00073,       37,        1,       36
CTW, 0      , 0      ,        3,        0,        3
CTY, 0      , 0      ,       20,        0,       20
CVC, 0      , 0      ,       12,        0,       12
CVD, 0.05   , 0.0025 ,       20,        1,       19
CVE, 0      , 0      ,       32,        0,       32
CVF, 0.2    , 0.04   ,       15,        3,       12
CVG, 0.10811, 0.01169,       37,        4,       33
CVH, 0.11111, 0.01235,        9,        1,        8
CVI, 0.05   , 0.0025 ,       20,        1,       19
CVK, 0.07143, 0.0051 ,       14,        1,       13
CVL, 0.13889, 0.01929,       36,        5,       31
CVM, 0.25   , 0.0625 ,        4,        1,        3
CVN, 0      , 0      ,       22,        0,       22
CVP, 0.04167, 0.00174,       24,        1,       23
CVQ, 0      , 0      ,       12,        0,       12
CVR, 0.04348, 0.00189,       23,        1,       22
CVS, 0.125  , 0.01562,       24,        3,       21
CVT, 0      , 0      ,       16,        0,       16
CVV, 0.03226, 0.00104,       31,        1,       30
CVW, 0      , 0      ,        3,        0,        3
CVY, 0.09091, 0.00826,       11,        1,       10
CV_, 0      , 0      ,        2,        0,        2
CWC, 0      , 0      ,        1,        0,        1
CWD, 0.4    , 0.16   ,        5,        2,        3
CWE, 0      , 0      ,        9,        0,        9
CWF, 0      , 0      ,        4,        0,        4
CWG, 0      , 0      ,        6,        0,        6
CWH, 0      , 0      ,        1,        0,        1
CWI, 0      , 0      ,        7,        0,        7
CWL, 0.25   , 0.0625 ,        8,        2,        6
CWM, 0      , 0      ,        2,        0,        2
CWN, 0      , 0      ,        5,        0,        5
CWP, 0.16667, 0.02778,       12,        2,       10
CWQ, 0.2    , 0.04   ,        5,        1,        4
CWR, 0.125  , 0.01562,        8,        1,        7
CWS, 0.3    , 0.09   ,       10,        3,        7
CWT, 0.5    , 0.25   ,        4,        2,        2
CWV, 0      , 0      ,        1,        0,        1
CWW, 0      , 0      ,        2,        0,        2
CWY, 0      , 0      ,        5,        0,        5
CYC, 0.5    , 0.25   ,        8,        4,        4
CYD, 0.2    , 0.04   ,       25,        5,       20
CYE, 0.15789, 0.02493,       19,        3,       16
CYF, 0      , 0      ,        6,        0,        6
CYG, 0.17241, 0.02973,       29,        5,       24
CYH, 0      , 0      ,        8,        0,        8
CYI, 0.18182, 0.03306,       11,        2,        9
CYK, 0.1    , 0.01   ,       20,        2,       18
CYL, 0.16667, 0.02778,       24,        4,       20
CYM, 0.14286, 0.02041,        7,        1,        6
CYN, 0.21053, 0.04432,       19,        4,       15
CYP, 0.2    , 0.04   ,       15,        3,       12
CYQ, 0.05556, 0.00309,       18,        1,       17
CYR, 0.13333, 0.01778,       15,        2,       13
CYS, 0.3913 , 0.15312,       23,        9,       14
CYT, 0.125  , 0.01562,       16,        2,       14
CYV, 0.18519, 0.03429,       27,        5,       22
CYW, 0      , 0      ,        9,        0,        9
CYY, 0.09524, 0.00907,       21,        2,       19
CY_, 0      , 0      ,        1,        0,        1
DAD, 0      , 0      ,       43,        0,       43
DAE, 0.0495 , 0.00245,      101,        5,       96
DAF, 0.05882, 0.00346,       68,        4,       64
DAG, 0.06931, 0.0048 ,      101,        7,       94
DAH, 0.05882, 0.00346,       34,        2,       32
DAI, 0.05941, 0.00353,      101,        6,       95
DAK, 0.03488, 0.00122,       86,        3,       83
DAL, 0.04545, 0.00207,      154,        7,      147
DAM, 0      , 0      ,       39,        0,       39
DAN, 0.04348, 0.00189,       69,        3,       66
DAP, 0.06579, 0.00433,       76,        5,       71
DAQ, 0.05455, 0.00298,       55,        3,       52
DAR, 0.0303 , 0.00092,       66,        2,       64
DAS, 0.03191, 0.00102,       94,        3,       91
DAT, 0.06977, 0.00487,       86,        6,       80
DAV, 0.01709, 0.00029,      117,        2,      115
DAW, 0.0625 , 0.00391,       16,        1,       15
DAY, 0.03509, 0.00123,       57,        2,       55
DA_, 0      , 0      ,        8,        0,        8
DCD, 0.16667, 0.02778,       12,        2,       10
DCE, 0      , 0      ,       24,        0,       24
DCF, 0.09524, 0.00907,       21,        2,       19
DCG, 0.125  , 0.01562,       40,        5,       35
DCH, 0      , 0      ,        4,        0,        4
DCI, 0.07692, 0.00592,       13,        1,       12
DCK, 0.09091, 0.00826,       22,        2,       20
DCL, 0.02439, 0.00059,       41,        1,       40
DCM, 0      , 0      ,       11,        0,       11
DCN, 0.11111, 0.01235,        9,        1,        8
DCP, 0.10526, 0.01108,       19,        2,       17
DCQ, 0.09091, 0.00826,       11,        1,       10
DCR, 0      , 0      ,       17,        0,       17
DCS, 0.03846, 0.00148,       26,        1,       25
DCT, 0.05882, 0.00346,       17,        1,       16
DCV, 0.09375, 0.00879,       32,        3,       29
DCW, 0.14286, 0.02041,        7,        1,        6
DCY, 0      , 0      ,       13,        0,       13
DC_, 0      , 0      ,        1,        0,        1
DDD, 0.15789, 0.02493,       57,        9,       48
DDE, 0.06522, 0.00425,       92,        6,       86
DDF, 0.08108, 0.00657,       74,        6,       68
DDG, 0.09434, 0.0089 ,      106,       10,       96
DDH, 0.13636, 0.0186 ,       22,        3,       19
DDI, 0.12371, 0.0153 ,       97,       12,       85
DDK, 0.03704, 0.00137,       81,        3,       78
DDL, 0.01807, 0.00033,      166,        3,      163
DDM, 0.12121, 0.01469,       33,        4,       29
DDN, 0.08   , 0.0064 ,       50,        4,       46
DDP, 0.03659, 0.00134,       82,        3,       79
DDQ, 0.07547, 0.0057 ,       53,        4,       49
DDR, 0.07018, 0.00492,       57,        4,       53
DDS, 0.07407, 0.00549,      108,        8,      100
DDT, 0.02632, 0.00069,       76,        2,       74
DDV, 0.05263, 0.00277,       95,        5,       90
DDW, 0.04348, 0.00189,       23,        1,       22
DDY, 0.16667, 0.02778,       66,       11,       55
DD_, 0      , 0      ,        4,        0,        4
DED, 0.02326, 0.00054,       43,        1,       42
DEE, 0.02878, 0.00083,      139,        4,      135
DEF, 0.11538, 0.01331,       78,        9,       69
DEG, 0.05714, 0.00327,      105,        6,       99
DEH, 0.15   , 0.0225 ,       40,        6,       34
DEI, 0.08411, 0.00707,      107,        9,       98
DEK, 0.03509, 0.00123,      114,        4,      110
DEL, 0.05556, 0.00309,      180,       10,      170
DEM, 0.02326, 0.00054,       43,        1,       42
DEN, 0.07292, 0.00532,       96,        7,       89
DEP, 0.04386, 0.00192,      114,        5,      109
DEQ, 0.07692, 0.00592,       65,        5,       60
DER, 0.0375 , 0.00141,       80,        3,       77
DES, 0.06481, 0.0042 ,      108,        7,      101
DET, 0.04808, 0.00231,      104,        5,       99
DEV, 0.06358, 0.00404,      173,       11,      162
DEW, 0.13793, 0.01902,       29,        4,       25
DEY, 0.08219, 0.00676,       73,        6,       67
DE_, 0.07143, 0.0051 ,       14,        1,       13
DFD, 0.02941, 0.00087,       34,        1,       33
DFE, 0.07018, 0.00492,       57,        4,       53
DFF, 0.03774, 0.00142,       53,        2,       51
DFG, 0.14474, 0.02095,       76,       11,       65
DFH, 0.125  , 0.01562,       24,        3,       21
DFI, 0.06667, 0.00444,       60,        4,       56
DFK, 0.06944, 0.00482,       72,        5,       67
DFL, 0.15686, 0.02461,      102,       16,       86
DFM, 0.125  , 0.01562,       32,        4,       28
DFN, 0.16949, 0.02873,       59,       10,       49
DFP, 0.01786, 0.00032,       56,        1,       55
DFQ, 0.11905, 0.01417,       42,        5,       37
DFR, 0.02273, 0.00052,       44,        1,       43
DFS, 0.09459, 0.00895,       74,        7,       67
DFT, 0.06349, 0.00403,       63,        4,       59
DFV, 0.10606, 0.01125,       66,        7,       59
DFW, 0.1    , 0.01   ,       20,        2,       18
DFY, 0.15152, 0.02296,       33,        5,       28
DF_, 0.25   , 0.0625 ,        4,        1,        3
DGD, 0.03448, 0.00119,       58,        2,       56
DGE, 0.03922, 0.00154,      102,        4,       98
DGF, 0.04651, 0.00216,       86,        4,       82
DGG, 0.10989, 0.01208,       91,       10,       81
DGH, 0.025  , 0.00063,       40,        1,       39
DGI, 0.01818, 0.00033,      110,        2,      108
DGK, 0.00641, 0.00004,      156,        1,      155
DGL, 0.08904, 0.00793,      146,       13,      133
DGM, 0.03226, 0.00104,       31,        1,       30
DGN, 0.03409, 0.00116,       88,        3,       85
DGP, 0.0297 , 0.00088,      101,        3,       98
DGQ, 0.03125, 0.00098,       96,        3,       93
DGR, 0.0339 , 0.00115,      118,        4,      114
DGS, 0.03947, 0.00156,      152,        6,      146
DGT, 0.01562, 0.00024,      128,        2,      126
DGV, 0.03604, 0.0013 ,      111,        4,      107
DGW, 0.2    , 0.04   ,       25,        5,       20
DGY, 0.07792, 0.00607,       77,        6,       71
DG_, 0      , 0      ,        1,        0,        1
DHD, 0.07692, 0.00592,       13,        1,       12
DHE, 0.05405, 0.00292,       37,        2,       35
DHF, 0.125  , 0.01562,       24,        3,       21
DHG, 0.1    , 0.01   ,       30,        3,       27
DHH, 0.09091, 0.00826,       11,        1,       10
DHI, 0.06667, 0.00444,       30,        2,       28
DHK, 0.08   , 0.0064 ,       25,        2,       23
DHL, 0.01538, 0.00024,       65,        1,       64
DHM, 0.09091, 0.00826,       11,        1,       10
DHN, 0.28571, 0.08163,       21,        6,       15
DHP, 0.09524, 0.00907,       21,        2,       19
DHQ, 0.11111, 0.01235,       18,        2,       16
DHR, 0.13043, 0.01701,       23,        3,       20
DHS, 0.03571, 0.00128,       28,        1,       27
DHT, 0.19231, 0.03698,       26,        5,       21
DHV, 0.21053, 0.04432,       38,        8,       30
DHW, 0      , 0      ,       10,        0,       10
DHY, 0      , 0      ,       27,        0,       27
DH_, 0      , 0      ,        1,        0,        1
DID, 0.08333, 0.00694,       48,        4,       44
DIE, 0.09091, 0.00826,       88,        8,       80
DIF, 0.08451, 0.00714,       71,        6,       65
DIG, 0.02273, 0.00052,       88,        2,       86
DIH, 0.05   , 0.0025 ,       40,        2,       38
DII, 0.06977, 0.00487,       86,        6,       80
DIK, 0.09231, 0.00852,       65,        6,       59
DIL, 0.06977, 0.00487,      172,       12,      160
DIM, 0.02564, 0.00066,       39,        1,       38
DIN, 0.02439, 0.00059,       82,        2,       80
DIP, 0.1129 , 0.01275,       62,        7,       55
DIQ, 0.03636, 0.00132,       55,        2,       53
DIR, 0.07812, 0.0061 ,       64,        5,       59
DIS, 0.06897, 0.00476,       87,        6,       81
DIT, 0.1125 , 0.01266,       80,        9,       71
DIV, 0.07843, 0.00615,      102,        8,       94
DIW, 0.17647, 0.03114,       17,        3,       14
DIY, 0.09615, 0.00925,       52,        5,       47
DI_, 0      , 0      ,        1,        0,        1
DKD, 0      , 0      ,       44,        0,       44
DKE, 0.02239, 0.0005 ,      134,        3,      131
DKF, 0.0396 , 0.00157,      101,        4,       97
DKG, 0.0531 , 0.00282,      113,        6,      107
DKH, 0      , 0      ,       30,        0,       30
DKI, 0.05344, 0.00286,      131,        7,      124
DKK, 0.0297 , 0.00088,      101,        3,       98
DKL, 0.05419, 0.00294,      203,       11,      192
DKM, 0.02703, 0.00073,       37,        1,       36
DKN, 0      , 0      ,       78,        0,       78
DKP, 0.02222, 0.00049,       90,        2,       88
DKQ, 0.03774, 0.00142,       53,        2,       51
DKR, 0.06579, 0.00433,       76,        5,       71
DKS, 0.03509, 0.00123,      114,        4,      110
DKT, 0.05495, 0.00302,       91,        5,       86
DKV, 0.05755, 0.00331,      139,        8,      131
DKW, 0.06061, 0.00367,       33,        2,       31
DKY, 0.025  , 0.00063,       80,        2,       78
DK_, 0      , 0      ,        9,        0,        9
DLD, 0.04762, 0.00227,       63,        3,       60
DLE, 0.05488, 0.00301,      164,        9,      155
DLF, 0.08861, 0.00785,       79,        7,       72
DLG, 0.08   , 0.0064 ,      125,       10,      115
DLH, 0.08889, 0.0079 ,       45,        4,       41
DLI, 0.07576, 0.00574,      132,       10,      122
DLK, 0.05369, 0.00288,      149,        8,      141
DLL, 0.06579, 0.00433,      228,       15,      213
DLM, 0.04255, 0.00181,       47,        2,       45
DLN, 0.09615, 0.00925,      104,       10,       94
DLP, 0.01835, 0.00034,      109,        2,      107
DLQ, 0.03659, 0.00134,       82,        3,       79
DLR, 0.03571, 0.00128,      112,        4,      108
DLS, 0.02632, 0.00069,      152,        4,      148
DLT, 0.10667, 0.01138,      150,       16,      134
DLV, 0.04969, 0.00247,      161,        8,      153
DLW, 0      , 0      ,       26,        0,       26
DLY, 0.11392, 0.01298,       79,        9,       70
DL_, 0      , 0      ,       15,        0,       15
DMD, 0.06667, 0.00444,       15,        1,       14
DME, 0      , 0      ,       27,        0,       27
DMF, 0.13889, 0.01929,       36,        5,       31
DMG, 0.06061, 0.00367,       33,        2,       31
DMH, 0.05882, 0.00346,       17,        1,       16
DMI, 0.08108, 0.00657,       37,        3,       34
DMK, 0.06897, 0.00476,       29,        2,       27
DML, 0.08889, 0.0079 ,       45,        4,       41
DMM, 0.06667, 0.00444,       15,        1,       14
DMN, 0.03448, 0.00119,       29,        1,       28
DMP, 0      , 0      ,       17,        0,       17
DMQ, 0.09524, 0.00907,       21,        2,       19
DMR, 0.14286, 0.02041,       21,        3,       18
DMS, 0.13158, 0.01731,       38,        5,       33
DMT, 0.09375, 0.00879,       32,        3,       29
DMV, 0.05263, 0.00277,       38,        2,       36
DMW, 0.08333, 0.00694,       12,        1,       11
DMY, 0.22222, 0.04938,       18,        4,       14
DM_, 0      , 0      ,       14,        0,       14
DND, 0.03226, 0.00104,       31,        1,       30
DNE, 0.08235, 0.00678,       85,        7,       78
DNF, 0.03279, 0.00107,       61,        2,       59
DNG, 0.06494, 0.00422,       77,        5,       72
DNH, 0.07692, 0.00592,       26,        2,       24
DNI, 0.05195, 0.0027 ,       77,        4,       73
DNK, 0.05   , 0.0025 ,       60,        3,       57
DNL, 0.05   , 0.0025 ,      120,        6,      114
DNM, 0.03571, 0.00128,       28,        1,       27
DNN, 0.02778, 0.00077,       36,        1,       35
DNP, 0.01695, 0.00029,       59,        1,       58
DNQ, 0      , 0      ,       32,        0,       32
DNR, 0.02083, 0.00043,       48,        1,       47
DNS, 0.06349, 0.00403,       63,        4,       59
DNT, 0.04167, 0.00174,       72,        3,       69
DNV, 0.04348, 0.00189,       92,        4,       88
DNW, 0.04545, 0.00207,       22,        1,       21
DNY, 0.04444, 0.00198,       45,        2,       43
DN_, 0      , 0      ,        5,        0,        5
DPD, 0.08696, 0.00756,       46,        4,       42
DPE, 0.01136, 0.00013,       88,        1,       87
DPF, 0.05882, 0.00346,       68,        4,       64
DPG, 0      , 0      ,       54,        0,       54
DPH, 0.02381, 0.00057,       42,        1,       41
DPI, 0.05405, 0.00292,       74,        4,       70
DPK, 0.02667, 0.00071,       75,        2,       73
DPL, 0.04167, 0.00174,      120,        5,      115
DPM, 0.08696, 0.00756,       23,        2,       21
DPN, 0.0463 , 0.00214,      108,        5,      103
DPP, 0.03125, 0.00098,       64,        2,       62
DPQ, 0.03636, 0.00132,       55,        2,       53
DPR, 0      , 0      ,       95,        0,       95
DPS, 0.01869, 0.00035,      107,        2,      105
DPT, 0.05333, 0.00284,       75,        4,       71
DPV, 0.05682, 0.00323,       88,        5,       83
DPW, 0      , 0      ,       22,        0,       22
DPY, 0.01538, 0.00024,       65,        1,       64
DP_, 0      , 0      ,        7,        0,        7
DQD, 0.21739, 0.04726,       23,        5,       18
DQE, 0.07463, 0.00557,       67,        5,       62
DQF, 0      , 0      ,       40,        0,       40
DQG, 0.04348, 0.00189,       69,        3,       66
DQH, 0      , 0      ,       16,        0,       16
DQI, 0.07407, 0.00549,       81,        6,       75
DQK, 0.04444, 0.00198,       45,        2,       43
DQL, 0.04478, 0.002  ,      134,        6,      128
DQM, 0.07692, 0.00592,       26,        2,       24
DQN, 0.08108, 0.00657,       37,        3,       34
DQP, 0.05172, 0.00268,       58,        3,       55
DQQ, 0.02222, 0.00049,       45,        1,       44
DQR, 0      , 0      ,       45,        0,       45
DQS, 0.01961, 0.00038,       51,        1,       50
DQT, 0.06522, 0.00425,       46,        3,       43
DQV, 0.07955, 0.00633,       88,        7,       81
DQW, 0.05263, 0.00277,       19,        1,       18
DQY, 0.02564, 0.00066,       39,        1,       38
DQ_, 0      , 0      ,        7,        0,        7
DRD, 0.02564, 0.00066,       39,        1,       38
DRE, 0.04211, 0.00177,       95,        4,       91
DRF, 0.03125, 0.00098,       64,        2,       62
DRG, 0.07609, 0.00579,       92,        7,       85
DRH, 0.09302, 0.00865,       43,        4,       39
DRI, 0.08571, 0.00735,      105,        9,       96
DRK, 0.12329, 0.0152 ,       73,        9,       64
DRL, 0.04225, 0.00179,      142,        6,      136
DRM, 0      , 0      ,       25,        0,       25
DRN, 0.125  , 0.01562,       56,        7,       49
DRP, 0.01562, 0.00024,       64,        1,       63
DRQ, 0.02439, 0.00059,       41,        1,       40
DRR, 0.07692, 0.00592,       39,        3,       36
DRS, 0.0875 , 0.00766,       80,        7,       73
DRT, 0.02985, 0.00089,       67,        2,       65
DRV, 0.09483, 0.00899,      116,       11,      105
DRW, 0.25   , 0.0625 ,       20,        5,       15
DRY, 0.11538, 0.01331,       52,        6,       46
DR_, 0      , 0      ,        4,        0,        4
DSD, 0.01961, 0.00038,       51,        1,       50
DSE, 0.03226, 0.00104,       93,        3,       90
DSF, 0.06579, 0.00433,       76,        5,       71
DSG, 0.04615, 0.00213,      130,        6,      124
DSH, 0      , 0      ,       23,        0,       23
DSI, 0.07273, 0.00529,      110,        8,      102
DSK, 0.03191, 0.00102,       94,        3,       91
DSL, 0.0297 , 0.00088,      202,        6,      196
DSM, 0.09677, 0.00937,       31,        3,       28
DSN, 0.01471, 0.00022,       68,        1,       67
DSP, 0.0375 , 0.00141,       80,        3,       77
DSQ, 0.06897, 0.00476,       58,        4,       54
DSR, 0.0411 , 0.00169,       73,        3,       70
DSS, 0.10656, 0.01135,      122,       13,      109
DST, 0.05208, 0.00271,       96,        5,       91
DSV, 0.09174, 0.00842,      109,       10,       99
DSW, 0.07407, 0.00549,       27,        2,       25
DSY, 0.01754, 0.00031,       57,        1,       56
DS_, 0.08333, 0.00694,       12,        1,       11
DTD, 0.0303 , 0.00092,       33,        1,       32
DTE, 0.03947, 0.00156,       76,        3,       73
DTF, 0.04   , 0.0016 ,       75,        3,       72
DTG, 0.05155, 0.00266,       97,        5,       92
DTH, 0.06897, 0.00476,       29,        2,       27
DTI, 0.0625 , 0.00391,       96,        6,       90
DTK, 0.01587, 0.00025,       63,        1,       62
DTL, 0.03593, 0.00129,      167,        6,      161
DTM, 0.05882, 0.00346,       34,        2,       32
DTN, 0.07018, 0.00492,       57,        4,       53
DTP, 0.02   , 0.0004 ,       50,        1,       49
DTQ, 0.05556, 0.00309,       36,        2,       34
DTR, 0      , 0      ,       48,        0,       48
DTS, 0.05941, 0.00353,      101,        6,       95
DTT, 0.02247, 0.0005 ,       89,        2,       87
DTV, 0.0297 , 0.00088,      101,        3,       98
DTW, 0.05556, 0.00309,       18,        1,       17
DTY, 0.10714, 0.01148,       56,        6,       50
DT_, 0      , 0      ,        1,        0,        1
DVD, 0.04651, 0.00216,       43,        2,       41
DVE, 0.08108, 0.00657,      111,        9,      102
DVF, 0.11111, 0.01235,       63,        7,       56
DVG, 0.06383, 0.00407,       94,        6,       88
DVH, 0.1    , 0.01   ,       40,        4,       36
DVI, 0.064  , 0.0041 ,      125,        8,      117
DVK, 0.08696, 0.00756,       92,        8,       84
DVL, 0.04348, 0.00189,      138,        6,      132
DVM, 0.13333, 0.01778,       30,        4,       26
DVN, 0.08   , 0.0064 ,       75,        6,       69
DVP, 0.05556, 0.00309,       90,        5,       85
DVQ, 0.07018, 0.00492,       57,        4,       53
DVR, 0.0339 , 0.00115,       59,        2,       57
DVS, 0.04082, 0.00167,       98,        4,       94
DVT, 0.06   , 0.0036 ,      100,        6,       94
DVV, 0.0458 , 0.0021 ,      131,        6,      125
DVW, 0.16667, 0.02778,       18,        3,       15
DVY, 0.0678 , 0.0046 ,       59,        4,       55
DV_, 0      , 0      ,        7,        0,        7
DWD, 0.05   , 0.0025 ,       20,        1,       19
DWE, 0.14815, 0.02195,       27,        4,       23
DWF, 0.18182, 0.03306,       11,        2,        9
DWG, 0.2    , 0.04   ,       20,        4,       16
DWH, 0.33333, 0.11111,        6,        2,        4
DWI, 0.12   , 0.0144 ,       25,        3,       22
DWK, 0.11765, 0.01384,       17,        2,       15
DWL, 0.17949, 0.03222,       39,        7,       32
DWM, 0      , 0      ,        8,        0,        8
DWN, 0.125  , 0.01562,       24,        3,       21
DWP, 0.18182, 0.03306,       11,        2,        9
DWQ, 0.0625 , 0.00391,       16,        1,       15
DWR, 0      , 0      ,       16,        0,       16
DWS, 0.1875 , 0.03516,       32,        6,       26
DWT, 0      , 0      ,       20,        0,       20
DWV, 0.125  , 0.01562,       32,        4,       28
DWW, 0.55556, 0.30864,        9,        5,        4
DWY, 0.18182, 0.03306,       11,        2,        9
DW_, 0.5    , 0.25   ,        2,        1,        1
DYD, 0.09677, 0.00937,       31,        3,       28
DYE, 0.12   , 0.0144 ,       75,        9,       66
DYF, 0.09756, 0.00952,       41,        4,       37
DYG, 0.26471, 0.07007,       68,       18,       50
DYH, 0.14706, 0.02163,       34,        5,       29
DYI, 0.12987, 0.01687,       77,       10,       67
DYK, 0.13208, 0.01744,       53,        7,       46
DYL, 0.16667, 0.02778,      126,       21,      105
DYM, 0.04762, 0.00227,       21,        1,       20
DYN, 0.14   , 0.0196 ,       50,        7,       43
DYP, 0.22917, 0.05252,       48,       11,       37
DYQ, 0.04444, 0.00198,       45,        2,       43
DYR, 0.04762, 0.00227,       42,        2,       40
DYS, 0.08571, 0.00735,       70,        6,       64
DYT, 0.13846, 0.01917,       65,        9,       56
DYV, 0.05714, 0.00327,       70,        4,       66
DYW, 0.09091, 0.00826,       22,        2,       20
DYY, 0.15789, 0.02493,       38,        6,       32
DY_, 0      , 0      ,        7,        0,        7
EAE, 0.05952, 0.00354,       84,        5,       79
EAF, 0.11111, 0.01235,       54,        6,       48
EAG, 0.06383, 0.00407,       94,        6,       88
EAH, 0.03704, 0.00137,       27,        1,       26
EAI, 0.04   , 0.0016 ,      100,        4,       96
EAK, 0.06061, 0.00367,       99,        6,       93
EAL, 0.02823, 0.0008 ,      248,        7,      241
EAM, 0.04545, 0.00207,       44,        2,       42
EAN, 0.02151, 0.00046,       93,        2,       91
EAP, 0.02439, 0.00059,       82,        2,       80
EAQ, 0.06024, 0.00363,       83,        5,       78
EAR, 0.05   , 0.0025 ,      100,        5,       95
EAS, 0.03261, 0.00106,       92,        3,       89
EAT, 0.04505, 0.00203,      111,        5,      106
EAV, 0.03289, 0.00108,      152,        5,      147
EAW, 0.11111, 0.01235,       18,        2,       16
EAY, 0.06154, 0.00379,       65,        4,       61
EA_, 0      , 0      ,       11,        0,       11
ECE, 0.11111, 0.01235,        9,        1,        8
ECF, 0      , 0      ,       18,        0,       18
ECG, 0.02857, 0.00082,       35,        1,       34
ECH, 0.13333, 0.01778,       15,        2,       13
ECI, 0.05263, 0.00277,       19,        1,       18
ECK, 0      , 0      ,       27,        0,       27
ECL, 0.06977, 0.00487,       43,        3,       40
ECM, 0      , 0      ,       10,        0,       10
ECN, 0.125  , 0.01562,       16,        2,       14
ECP, 0      , 0      ,       18,        0,       18
ECQ, 0.04762, 0.00227,       21,        1,       20
ECR, 0.04348, 0.00189,       23,        1,       22
ECS, 0      , 0      ,       30,        0,       30
ECT, 0.05556, 0.00309,       18,        1,       17
ECV, 0.08108, 0.00657,       37,        3,       34
ECW, 0      , 0      ,        5,        0,        5
ECY, 0.13333, 0.01778,       15,        2,       13
EC_, 0      , 0      ,        2,        0,        2
EDE, 0.16393, 0.02687,       61,       10,       51
EDF, 0.07407, 0.00549,       81,        6,       75
EDG, 0.05263, 0.00277,      152,        8,      144
EDH, 0.04348, 0.00189,       46,        2,       44
EDI, 0.10811, 0.01169,      148,       16,      132
EDK, 0.04124, 0.0017 ,       97,        4,       93
EDL, 0.04695, 0.0022 ,      213,       10,      203
EDM, 0.07407, 0.00549,       54,        4,       50
EDN, 0.14474, 0.02095,       76,       11,       65
EDP, 0.10345, 0.0107 ,       87,        9,       78
EDQ, 0.14815, 0.02195,       54,        8,       46
EDR, 0.01235, 0.00015,       81,        1,       80
EDS, 0.06   , 0.0036 ,      100,        6,       94
EDT, 0.05495, 0.00302,       91,        5,       86
EDV, 0.07801, 0.00609,      141,       11,      130
EDW, 0.04545, 0.00207,       22,        1,       21
EDY, 0.06977, 0.00487,       86,        6,       80
ED_, 0.14286, 0.02041,        7,        1,        6
EEE, 0.06731, 0.00453,      104,        7,       97
EEF, 0.04425, 0.00196,      113,        5,      108
EEG, 0.03727, 0.00139,      161,        6,      155
EEH, 0.04444, 0.00198,       45,        2,       43
EEI, 0.06358, 0.00404,      173,       11,      162
EEK, 0.03425, 0.00117,      146,        5,      141
EEL, 0.04114, 0.00169,      316,       13,      303
EEM, 0.01429, 0.0002 ,       70,        1,       69
EEN, 0.04124, 0.0017 ,       97,        4,       93
EEP, 0.03077, 0.00095,      130,        4,      126
EEQ, 0.04124, 0.0017 ,       97,        4,       93
EER, 0.03175, 0.00101,      126,        4,      122
EES, 0.02941, 0.00087,      136,        4,      132
EET, 0.02797, 0.00078,      143,        4,      139
EEV, 0.05233, 0.00274,      172,        9,      163
EEW, 0.12121, 0.01469,       33,        4,       29
EEY, 0.07527, 0.00567,       93,        7,       86
EE_, 0.07692, 0.00592,       13,        1,       12
EFE, 0.07895, 0.00623,       38,        3,       35
EFF, 0.08511, 0.00724,       47,        4,       43
EFG, 0.07273, 0.00529,       55,        4,       51
EFH, 0.13333, 0.01778,       15,        2,       13
EFI, 0.125  , 0.01562,       56,        7,       49
EFK, 0.14474, 0.02095,       76,       11,       65
EFL, 0.09434, 0.0089 ,      106,       10,       96
EFM, 0.1    , 0.01   ,       20,        2,       18
EFN, 0.14583, 0.02127,       48,        7,       41
EFP, 0.04545, 0.00207,       44,        2,       42
EFQ, 0.14634, 0.02142,       41,        6,       35
EFR, 0.08333, 0.00694,       60,        5,       55
EFS, 0.10112, 0.01023,       89,        9,       80
EFT, 0.05333, 0.00284,       75,        4,       71
EFV, 0.11765, 0.01384,       85,       10,       75
EFW, 0.10526, 0.01108,       19,        2,       17
EFY, 0.1    , 0.01   ,       30,        3,       27
EF_, 0      , 0      ,        1,        0,        1
EGE, 0      , 0      ,       67,        0,       67
EGF, 0.0274 , 0.00075,       73,        2,       71
EGG, 0.04878, 0.00238,      123,        6,      117
EGH, 0.05128, 0.00263,       39,        2,       37
EGI, 0.04494, 0.00202,       89,        4,       85
EGK, 0.0219 , 0.00048,      137,        3,      134
EGL, 0.03209, 0.00103,      187,        6,      181
EGM, 0.04444, 0.00198,       45,        2,       43
EGN, 0.03158, 0.001  ,       95,        3,       92
EGP, 0.04082, 0.00167,       98,        4,       94
EGQ, 0.04878, 0.00238,       82,        4,       78
EGR, 0      , 0      ,      102,        0,      102
EGS, 0.04032, 0.00163,      124,        5,      119
EGT, 0.02857, 0.00082,      105,        3,      102
EGV, 0.02679, 0.00072,      112,        3,      109
EGW, 0.07143, 0.0051 ,       28,        2,       26
EGY, 0.04286, 0.00184,       70,        3,       67
EG_, 0      , 0      ,        6,        0,        6
EHE, 0      , 0      ,       14,        0,       14
EHF, 0.08   , 0.0064 ,       25,        2,       23
EHG, 0.04762, 0.00227,       42,        2,       40
EHH, 0.08696, 0.00756,       23,        2,       21
EHI, 0.07692, 0.00592,       39,        3,       36
EHK, 0.12821, 0.01644,       39,        5,       34
EHL, 0.06667, 0.00444,       75,        5,       70
EHM, 0.15789, 0.02493,       19,        3,       16
EHN, 0.0303 , 0.00092,       33,        1,       32
EHP, 0.09524, 0.00907,       42,        4,       38
EHQ, 0.14286, 0.02041,       21,        3,       18
EHR, 0.10345, 0.0107 ,       29,        3,       26
EHS, 0.13333, 0.01778,       30,        4,       26
EHT, 0.25   , 0.0625 ,       28,        7,       21
EHV, 0.04444, 0.00198,       45,        2,       43
EHW, 0      , 0      ,        8,        0,        8
EHY, 0.05882, 0.00346,       34,        2,       32
EH_, 0      , 0      ,        4,        0,        4
EIE, 0.03846, 0.00148,       52,        2,       50
EIF, 0.125  , 0.01562,       40,        5,       35
EIG, 0.05405, 0.00292,      111,        6,      105
EIH, 0.03846, 0.00148,       26,        1,       25
EII, 0.06098, 0.00372,       82,        5,       77
EIK, 0.07865, 0.00619,       89,        7,       82
EIL, 0.0625 , 0.00391,      144,        9,      135
EIM, 0.14286, 0.02041,       28,        4,       24
EIN, 0.06944, 0.00482,       72,        5,       67
EIP, 0.07955, 0.00633,       88,        7,       81
EIQ, 0.11667, 0.01361,       60,        7,       53
EIR, 0.05405, 0.00292,       74,        4,       70
EIS, 0.09677, 0.00937,       93,        9,       84
EIT, 0.02326, 0.00054,       86,        2,       84
EIV, 0.03261, 0.00106,       92,        3,       89
EIW, 0      , 0      ,       17,        0,       17
EIY, 0.04082, 0.00167,       49,        2,       47
EI_, 0.2    , 0.04   ,        5,        1,        4
EKE, 0.0367 , 0.00135,      109,        4,      105
EKF, 0.06863, 0.00471,      102,        7,       95
EKG, 0.0219 , 0.00048,      137,        3,      134
EKH, 0.02326, 0.00054,       43,        1,       42
EKI, 0.05769, 0.00333,      156,        9,      147
EKK, 0.08   , 0.0064 ,      125,       10,      115
EKL, 0.05484, 0.00301,      310,       17,      293
EKM, 0.08537, 0.00729,       82,        7,       75
EKN, 0.04762, 0.00227,       84,        4,       80
EKP, 0.01852, 0.00034,      108,        2,      106
EKQ, 0.04286, 0.00184,       70,        3,       67
EKR, 0.02804, 0.00079,      107,        3,      104
EKS, 0.04348, 0.00189,       92,        4,       88
EKT, 0.0177 , 0.00031,      113,        2,      111
EKV, 0.04516, 0.00204,      155,        7,      148
EKW, 0.06897, 0.00476,       29,        2,       27
EKY, 0.07447, 0.00555,       94,        7,       87
EK_, 0      , 0      ,        9,        0,        9
ELE, 0.07792, 0.00607,       77,        6,       71
ELF, 0.10309, 0.01063,       97,       10,       87
ELG, 0.10667, 0.01138,      150,       16,      134
ELH, 0.03448, 0.00119,       58,        2,       56
ELI, 0.05714, 0.00327,      175,       10,      165
ELK, 0.06329, 0.00401,      158,       10,      148
ELL, 0.04745, 0.00225,      274,       13,      261
ELM, 0.03571, 0.00128,       84,        3,       81
ELN, 0.04124, 0.0017 ,       97,        4,       93
ELP, 0.04464, 0.00199,      112,        5,      107
ELQ, 0.05357, 0.00287,      112,        6,      106
ELR, 0.05357, 0.00287,      112,        6,      106
ELS, 0.06803, 0.00463,      147,       10,      137
ELT, 0.05344, 0.00286,      131,        7,      124
ELV, 0.06145, 0.00378,      179,       11,      168
ELW, 0      , 0      ,       20,        0,       20
ELY, 0.05435, 0.00295,       92,        5,       87
EL_, 0      , 0      ,        8,        0,        8
EME, 0.04762, 0.00227,       21,        1,       20
EMF, 0.04348, 0.00189,       23,        1,       22
EMG, 0.08696, 0.00756,       46,        4,       42
EMH, 0.17647, 0.03114,       17,        3,       14
EMI, 0.21429, 0.04592,       42,        9,       33
EMK, 0.04878, 0.00238,       41,        2,       39
EML, 0.0625 , 0.00391,       64,        4,       60
EMM, 0      , 0      ,       13,        0,       13
EMN, 0.0625 , 0.00391,       32,        2,       30
EMP, 0.15789, 0.02493,       19,        3,       16
EMQ, 0.03704, 0.00137,       27,        1,       26
EMR, 0.13333, 0.01778,       30,        4,       26
EMS, 0.04878, 0.00238,       41,        2,       39
EMT, 0.06897, 0.00476,       29,        2,       27
EMV, 0.01887, 0.00036,       53,        1,       52
EMW, 0      , 0      ,        6,        0,        6
EMY, 0.05556, 0.00309,       18,        1,       17
EM_, 0.14286, 0.02041,       14,        2,       12
ENE, 0.01923, 0.00037,       52,        1,       51
ENF, 0.0119 , 0.00014,       84,        1,       83
ENG, 0.03419, 0.00117,      117,        4,      113
ENH, 0.05   , 0.0025 ,       20,        1,       19
ENI, 0.05147, 0.00265,      136,        7,      129
ENK, 0.04938, 0.00244,       81,        4,       77
ENL, 0.04321, 0.00187,      162,        7,      155
ENM, 0.07692, 0.00592,       39,        3,       36
ENN, 0.02   , 0.0004 ,       50,        1,       49
ENP, 0.06944, 0.00482,       72,        5,       67
ENQ, 0.11111, 0.01235,       45,        5,       40
ENR, 0.01538, 0.00024,       65,        1,       64
ENS, 0.02632, 0.00069,       76,        2,       74
ENT, 0.02941, 0.00087,       68,        2,       66
ENV, 0.05607, 0.00314,      107,        6,      101
ENW, 0.04   , 0.0016 ,       25,        1,       24
ENY, 0.04255, 0.00181,       47,        2,       45
EN_, 0.11111, 0.01235,        9,        1,        8
EPE, 0      , 0      ,       44,        0,       44
EPF, 0.10606, 0.01125,       66,        7,       59
EPG, 0.02222, 0.00049,       90,        2,       88
EPH, 0.02778, 0.00077,       36,        1,       35
EPI, 0.08247, 0.0068 ,       97,        8,       89
EPK, 0.03333, 0.00111,       90,        3,       87
EPL, 0.04706, 0.00221,      170,        8,      162
EPM, 0.08333, 0.00694,       24,        2,       22
EPN, 0      , 0      ,       77,        0,       77
EPP, 0.06173, 0.00381,       81,        5,       76
EPQ, 0      , 0      ,       62,        0,       62
EPR, 0.01389, 0.00019,       72,        1,       71
EPS, 0.01818, 0.00033,      110,        2,      108
EPT, 0.02062, 0.00043,       97,        2,       95
EPV, 0.07018, 0.00492,      114,        8,      106
EPW, 0.07143, 0.0051 ,       28,        2,       26
EPY, 0.03774, 0.00142,       53,        2,       51
EP_, 0      , 0      ,       12,        0,       12
EQE, 0.02381, 0.00057,       42,        1,       41
EQF, 0.05556, 0.00309,       72,        4,       68
EQG, 0.05882, 0.00346,       68,        4,       64
EQH, 0.07407, 0.00549,       27,        2,       25
EQI, 0.02105, 0.00044,       95,        2,       93
EQK, 0.02667, 0.00071,       75,        2,       73
EQL, 0.04878, 0.00238,      205,       10,      195
EQM, 0.06383, 0.00407,       47,        3,       44
EQN, 0.04   , 0.0016 ,       50,        2,       48
EQP, 0.06897, 0.00476,       58,        4,       54
EQQ, 0.125  , 0.01562,       48,        6,       42
EQR, 0.0303 , 0.00092,       66,        2,       64
EQS, 0.09091, 0.00826,       66,        6,       60
EQT, 0      , 0      ,       42,        0,       42
EQV, 0.07292, 0.00532,       96,        7,       89
EQW, 0.125  , 0.01562,       24,        3,       21
EQY, 0.05172, 0.00268,       58,        3,       55
EQ_, 0.09091, 0.00826,       11,        1,       10
ERE, 0.0625 , 0.00391,       64,        4,       60
ERF, 0.02667, 0.00071,       75,        2,       73
ERG, 0.11392, 0.01298,       79,        9,       70
ERH, 0      , 0      ,       34,        0,       34
ERI, 0.14815, 0.02195,      135,       20,      115
ERK, 0.01205, 0.00015,       83,        1,       82
ERL, 0.06763, 0.00457,      207,       14,      193
ERM, 0      , 0      ,       36,        0,       36
ERN, 0.08333, 0.00694,       60,        5,       55
ERP, 0.06173, 0.00381,       81,        5,       76
ERQ, 0.04688, 0.0022 ,       64,        3,       61
ERR, 0.07895, 0.00623,       76,        6,       70
ERS, 0.11881, 0.01412,      101,       12,       89
ERT, 0.07059, 0.00498,       85,        6,       79
ERV, 0.10884, 0.01185,      147,       16,      131
ERW, 0      , 0      ,       25,        0,       25
ERY, 0.03226, 0.00104,       62,        2,       60
ER_, 0      , 0      ,        3,        0,        3
ESE, 0.1087 , 0.01181,       46,        5,       41
ESF, 0.08861, 0.00785,       79,        7,       72
ESG, 0.02778, 0.00077,      108,        3,      105
ESH, 0.11429, 0.01306,       35,        4,       31
ESI, 0.04762, 0.00227,       84,        4,       80
ESK, 0.04494, 0.00202,       89,        4,       85
ESL, 0.02174, 0.00047,      230,        5,      225
ESM, 0.1    , 0.01   ,       40,        4,       36
ESN, 0.04478, 0.002  ,       67,        3,       64
ESP, 0.02817, 0.00079,       71,        2,       69
ESQ, 0.01471, 0.00022,       68,        1,       67
ESR, 0.02632, 0.00069,       76,        2,       74
ESS, 0.06731, 0.00453,      104,        7,       97
EST, 0.09459, 0.00895,       74,        7,       67
ESV, 0.01852, 0.00034,      108,        2,      106
ESW, 0.03571, 0.00128,       28,        1,       27
ESY, 0.05085, 0.00259,       59,        3,       56
ES_, 0.1    , 0.01   ,       20,        2,       18
ETE, 0      , 0      ,       38,        0,       38
ETF, 0.03125, 0.00098,       64,        2,       62
ETG, 0      , 0      ,      125,        0,      125
ETH, 0      , 0      ,       26,        0,       26
ETI, 0.10619, 0.01128,      113,       12,      101
ETK, 0.08537, 0.00729,       82,        7,       75
ETL, 0.04188, 0.00175,      191,        8,      183
ETM, 0.05   , 0.0025 ,       40,        2,       38
ETN, 0.05172, 0.00268,       58,        3,       55
ETP, 0.01493, 0.00022,       67,        1,       66
ETQ, 0      , 0      ,       52,        0,       52
ETR, 0.06349, 0.00403,       63,        4,       59
ETS, 0.04762, 0.00227,       84,        4,       80
ETT, 0.01408, 0.0002 ,       71,        1,       70
ETV, 0.02459, 0.0006 ,      122,        3,      119
ETW, 0.16667, 0.02778,       24,        4,       20
ETY, 0.06667, 0.00444,       45,        3,       42
ET_, 0.14286, 0.02041,        7,        1,        6
EVE, 0.0641 , 0.00411,       78,        5,       73
EVF, 0.04598, 0.00211,       87,        4,       83
EVG, 0.04717, 0.00222,      106,        5,      101
EVH, 0.03846, 0.00148,       26,        1,       25
EVI, 0.02586, 0.00067,      116,        3,      113
EVK, 0.04396, 0.00193,       91,        4,       87
EVL, 0.0339 , 0.00115,      177,        6,      171
EVM, 0.02439, 0.00059,       41,        1,       40
EVN, 0.05   , 0.0025 ,       80,        4,       76
EVP, 0.05319, 0.00283,       94,        5,       89
EVQ, 0.01389, 0.00019,       72,        1,       71
EVR, 0.02469, 0.00061,       81,        2,       79
EVS, 0.09615, 0.00925,      104,       10,       94
EVT, 0.07407, 0.00549,      108,        8,      100
EVV, 0.07639, 0.00584,      144,       11,      133
EVW, 0.05556, 0.00309,       18,        1,       17
EVY, 0.1    , 0.01   ,       60,        6,       54
EV_, 0      , 0      ,        5,        0,        5
EWE, 0      , 0      ,        7,        0,        7
EWF, 0.35294, 0.12457,       17,        6,       11
EWG, 0.08333, 0.00694,       36,        3,       33
EWH, 0.125  , 0.01562,        8,        1,        7
EWI, 0.10714, 0.01148,       28,        3,       25
EWK, 0.11429, 0.01306,       35,        4,       31
EWL, 0.0303 , 0.00092,       33,        1,       32
EWM, 0.18182, 0.03306,       11,        2,        9
EWN, 0.1875 , 0.03516,       16,        3,       13
EWP, 0.11111, 0.01235,       18,        2,       16
EWQ, 0.375  , 0.14062,       16,        6,       10
EWR, 0.14815, 0.02195,       27,        4,       23
EWS, 0.15   , 0.0225 ,       20,        3,       17
EWT, 0.13333, 0.01778,       30,        4,       26
EWV, 0.09091, 0.00826,       33,        3,       30
EWW, 0.3    , 0.09   ,       10,        3,        7
EWY, 0.13043, 0.01701,       23,        3,       20
EYE, 0.02632, 0.00069,       38,        1,       37
EYF, 0.13043, 0.01701,       46,        6,       40
EYG, 0.10294, 0.0106 ,       68,        7,       61
EYH, 0.1    , 0.01   ,       30,        3,       27
EYI, 0.04478, 0.002  ,       67,        3,       64
EYK, 0.15385, 0.02367,       65,       10,       55
EYL, 0.09174, 0.00842,      109,       10,       99
EYM, 0.13636, 0.0186 ,       22,        3,       19
EYN, 0.02273, 0.00052,       44,        1,       43
EYP, 0.15385, 0.02367,       39,        6,       33
EYQ, 0.06452, 0.00416,       31,        2,       29
EYR, 0.06122, 0.00375,       49,        3,       46
EYS, 0.03448, 0.00119,       58,        2,       56
EYT, 0.19298, 0.03724,       57,       11,       46
EYV, 0.10294, 0.0106 ,       68,        7,       61
EYW, 0.1    , 0.01   ,       20,        2,       18
EYY, 0.21951, 0.04819,       41,        9,       32
EY_, 0      , 0      ,        6,        0,        6
FAF, 0.29412, 0.08651,       17,        5,       12
FAG, 0.07353, 0.00541,       68,        5,       63
FAH, 0.10526, 0.01108,       19,        2,       17
FAI, 0.11111, 0.01235,       45,        5,       40
FAK, 0.0375 , 0.00141,       80,        3,       77
FAL, 0.06897, 0.00476,       58,        4,       54
FAM, 0.09524, 0.00907,       21,        2,       19
FAN, 0.13208, 0.01744,       53,        7,       46
FAP, 0.01754, 0.00031,       57,        1,       56
FAQ, 0.04444, 0.00198,       45,        2,       43
FAR, 0.0566 , 0.0032 ,       53,        3,       50
FAS, 0.06154, 0.00379,       65,        4,       61
FAT, 0.08889, 0.0079 ,       45,        4,       41
FAV, 0.09615, 0.00925,       52,        5,       47
FAW, 0.33333, 0.11111,        6,        2,        4
FAY, 0.08333, 0.00694,       24,        2,       22
FA_, 0      , 0      ,        6,        0,        6
FCF, 0.5    , 0.25   ,        2,        1,        1
FCG, 0.05882, 0.00346,       17,        1,       16
FCH, 0.125  , 0.01562,        8,        1,        7
FCI, 0      , 0      ,        5,        0,        5
FCK, 0      , 0      ,       17,        0,       17
FCL, 0      , 0      ,       20,        0,       20
FCM, 0      , 0      ,        4,        0,        4
FCN, 0      , 0      ,       16,        0,       16
FCP, 0.04545, 0.00207,       22,        1,       21
FCQ, 0      , 0      ,        6,        0,        6
FCR, 0.07143, 0.0051 ,       14,        1,       13
FCS, 0      , 0      ,       22,        0,       22
FCT, 0.07692, 0.00592,       13,        1,       12
FCV, 0.18182, 0.03306,       11,        2,        9
FCW, 0      , 0      ,        3,        0,        3
FCY, 0.13333, 0.01778,       15,        2,       13
FDF, 0.15625, 0.02441,       32,        5,       27
FDG, 0.03261, 0.00106,       92,        3,       89
FDH, 0.04348, 0.00189,       23,        1,       22
FDI, 0.01471, 0.00022,       68,        1,       67
FDK, 0.05556, 0.00309,       90,        5,       85
FDL, 0.08411, 0.00707,      107,        9,       98
FDM, 0.04   , 0.0016 ,       25,        1,       24
FDN, 0.05455, 0.00298,       55,        3,       52
FDP, 0.06557, 0.0043 ,       61,        4,       57
FDQ, 0.04348, 0.00189,       46,        2,       44
FDR, 0.04839, 0.00234,       62,        3,       59
FDS, 0.07407, 0.00549,       81,        6,       75
FDT, 0.04396, 0.00193,       91,        4,       87
FDV, 0.06742, 0.00454,       89,        6,       83
FDW, 0.1    , 0.01   ,       20,        2,       18
FDY, 0      , 0      ,       36,        0,       36
FD_, 0      , 0      ,       10,        0,       10
FEF, 0.11538, 0.01331,       26,        3,       23
FEG, 0.05435, 0.00295,       92,        5,       87
FEH, 0.03448, 0.00119,       29,        1,       28
FEI, 0.10606, 0.01125,       66,        7,       59
FEK, 0.08475, 0.00718,      118,       10,      108
FEL, 0.04167, 0.00174,       96,        4,       92
FEM, 0.13793, 0.01902,       29,        4,       25
FEN, 0.08163, 0.00666,       49,        4,       45
FEP, 0.02899, 0.00084,       69,        2,       67
FEQ, 0.01852, 0.00034,       54,        1,       53
FER, 0.02667, 0.00071,       75,        2,       73
FES, 0.08   , 0.0064 ,       75,        6,       69
FET, 0.03125, 0.00098,       64,        2,       62
FEV, 0.04762, 0.00227,       84,        4,       80
FEW, 0.11111, 0.01235,        9,        1,        8
FEY, 0.08571, 0.00735,       35,        3,       32
FE_, 0      , 0      ,        5,        0,        5
FFF, 0.06667, 0.00444,       15,        1,       14
FFG, 0.06667, 0.00444,       45,        3,       42
FFH, 0.25   , 0.0625 ,       16,        4,       12
FFI, 0.0625 , 0.00391,       32,        2,       30
FFK, 0.09302, 0.00865,       43,        4,       39
FFL, 0.175  , 0.03062,       40,        7,       33
FFM, 0.2    , 0.04   ,       15,        3,       12
FFN, 0.10256, 0.01052,       39,        4,       35
FFP, 0.12821, 0.01644,       39,        5,       34
FFQ, 0.13636, 0.0186 ,       22,        3,       19
FFR, 0.16279, 0.0265 ,       43,        7,       36
FFS, 0.09091, 0.00826,       44,        4,       40
FFT, 0.11765, 0.01384,       34,        4,       30
FFV, 0.1    , 0.01   ,       30,        3,       27
FFW, 0      , 0      ,        8,        0,        8
FFY, 0.05556, 0.00309,       18,        1,       17
FGF, 0.125  , 0.01562,       24,        3,       21
FGG, 0.12698, 0.01612,       63,        8,       55
FGH, 0.04762, 0.00227,       21,        1,       20
FGI, 0.05882, 0.00346,       51,        3,       48
FGK, 0.05   , 0.0025 ,       80,        4,       76
FGL, 0.15957, 0.02546,       94,       15,       79
FGM, 0      , 0      ,       18,        0,       18
FGN, 0.01786, 0.00032,       56,        1,       55
FGP, 0.03704, 0.00137,       54,        2,       52
FGQ, 0.04651, 0.00216,       43,        2,       41
FGR, 0.12   , 0.0144 ,       50,        6,       44
FGS, 0.06897, 0.00476,       87,        6,       81
FGT, 0.05263, 0.00277,       57,        3,       54
FGV, 0.07843, 0.00615,       51,        4,       47
FGW, 0.2    , 0.04   ,       10,        2,        8
FGY, 0.175  , 0.03062,       40,        7,       33
FG_, 0      , 0      ,        4,        0,        4
FHF, 0      , 0      ,       13,        0,       13
FHG, 0.05556, 0.00309,       36,        2,       34
FHH, 0      , 0      ,        8,        0,        8
FHI, 0.17241, 0.02973,       29,        5,       24
FHK, 0.06667, 0.00444,       30,        2,       28
FHL, 0.1087 , 0.01181,       46,        5,       41
FHM, 0.07692, 0.00592,       13,        1,       12
FHN, 0.1    , 0.01   ,       20,        2,       18
FHP, 0.06667, 0.00444,       30,        2,       28
FHQ, 0.09091, 0.00826,       33,        3,       30
FHR, 0.0303 , 0.00092,       33,        1,       32
FHS, 0.06977, 0.00487,       43,        3,       40
FHT, 0.04   , 0.0016 ,       25,        1,       24
FHV, 0.09677, 0.00937,       31,        3,       28
FHW, 0      , 0      ,        1,        0,        1
FHY, 0      , 0      ,       23,        0,       23
FIF, 0.10526, 0.01108,       19,        2,       17
FIG, 0.13462, 0.01812,       52,        7,       45
FIH, 0.05   , 0.0025 ,       20,        1,       19
FII, 0.02703, 0.00073,       37,        1,       36
FIK, 0.03636, 0.00132,       55,        2,       53
FIL, 0.05769, 0.00333,       52,        3,       49
FIM, 0.0625 , 0.00391,       16,        1,       15
FIN, 0.15254, 0.02327,       59,        9,       50
FIP, 0.02778, 0.00077,       36,        1,       35
FIQ, 0.05263, 0.00277,       38,        2,       36
FIR, 0      , 0      ,       37,        0,       37
FIS, 0      , 0      ,       47,        0,       47
FIT, 0      , 0      ,       53,        0,       53
FIV, 0.11364, 0.01291,       44,        5,       39
FIW, 0      , 0      ,        2,        0,        2
FIY, 0.11111, 0.01235,       27,        3,       24
FI_, 0      , 0      ,        1,        0,        1
FKF, 0.16667, 0.02778,       18,        3,       15
FKG, 0.06897, 0.00476,       87,        6,       81
FKH, 0.08333, 0.00694,       24,        2,       22
FKI, 0.025  , 0.00063,       80,        2,       78
FKK, 0.05128, 0.00263,       78,        4,       74
FKL, 0.05208, 0.00271,       96,        5,       91
FKM, 0.05882, 0.00346,       17,        1,       16
FKN, 0.08451, 0.00714,       71,        6,       65
FKP, 0.08108, 0.00657,       37,        3,       34
FKQ, 0.04762, 0.00227,       63,        3,       60
FKR, 0.06557, 0.0043 ,       61,        4,       57
FKS, 0.08696, 0.00756,       69,        6,       63
FKT, 0.11538, 0.01331,       52,        6,       46
FKV, 0.14151, 0.02002,      106,       15,       91
FKW, 0      , 0      ,       14,        0,       14
FKY, 0.04167, 0.00174,       48,        2,       46
FK_, 0      , 0      ,        5,        0,        5
FLF, 0.09524, 0.00907,       21,        2,       19
FLG, 0.06593, 0.00435,       91,        6,       85
FLH, 0.0625 , 0.00391,       32,        2,       30
FLI, 0.02273, 0.00052,       44,        1,       43
FLK, 0.07368, 0.00543,       95,        7,       88
FLL, 0.18182, 0.03306,       88,       16,       72
FLM, 0.16   , 0.0256 ,       25,        4,       21
FLN, 0.11111, 0.01235,       63,        7,       56
FLP, 0.04762, 0.00227,       63,        3,       60
FLQ, 0.03175, 0.00101,       63,        2,       61
FLR, 0.04819, 0.00232,       83,        4,       79
FLS, 0.10112, 0.01023,       89,        9,       80
FLT, 0.03797, 0.00144,       79,        3,       76
FLV, 0.08861, 0.00785,       79,        7,       72
FLW, 0.17647, 0.03114,       17,        3,       14
FLY, 0.13333, 0.01778,       30,        4,       26
FL_, 0      , 0      ,        2,        0,        2
FMF, 0      , 0      ,        5,        0,        5
FMG, 0.1875 , 0.03516,       16,        3,       13
FMH, 0.16667, 0.02778,       12,        2,       10
FMI, 0.25   , 0.0625 ,        8,        2,        6
FMK, 0.04545, 0.00207,       22,        1,       21
FML, 0.10714, 0.01148,       28,        3,       25
FMM, 0      , 0      ,        5,        0,        5
FMN, 0.125  , 0.01562,       16,        2,       14
FMP, 0.13333, 0.01778,       15,        2,       13
FMQ, 0.0625 , 0.00391,       16,        1,       15
FMR, 0.09091, 0.00826,       11,        1,       10
FMS, 0.1875 , 0.03516,       16,        3,       13
FMT, 0.10526, 0.01108,       19,        2,       17
FMV, 0.16667, 0.02778,       18,        3,       15
FMW, 0      , 0      ,        5,        0,        5
FMY, 0.1    , 0.01   ,       10,        1,        9
FM_, 0      , 0      ,        4,        0,        4
FNF, 0      , 0      ,       13,        0,       13
FNG, 0.11594, 0.01344,       69,        8,       61
FNH, 0      , 0      ,       23,        0,       23
FNI, 0.12766, 0.0163 ,       47,        6,       41
FNK, 0.04286, 0.00184,       70,        3,       67
FNL, 0.10959, 0.01201,       73,        8,       65
FNM, 0      , 0      ,       22,        0,       22
FNN, 0.02   , 0.0004 ,       50,        1,       49
FNP, 0.03704, 0.00137,       54,        2,       52
FNQ, 0.02222, 0.00049,       45,        1,       44
FNR, 0.09259, 0.00857,       54,        5,       49
FNS, 0.03333, 0.00111,       60,        2,       58
FNT, 0.125  , 0.01562,       48,        6,       42
FNV, 0.08065, 0.0065 ,       62,        5,       57
FNW, 0.1    , 0.01   ,       10,        1,        9
FNY, 0.04878, 0.00238,       41,        2,       39
FN_, 0      , 0      ,        4,        0,        4
FPF, 0      , 0      ,       17,        0,       17
FPG, 0.03175, 0.00101,       63,        2,       61
FPH, 0      , 0      ,       21,        0,       21
FPI, 0.05263, 0.00277,       38,        2,       36
FPK, 0.03922, 0.00154,       51,        2,       49
FPL, 0.07059, 0.00498,       85,        6,       79
FPM, 0.06667, 0.00444,       15,        1,       14
FPN, 0.08   , 0.0064 ,       50,        4,       46
FPP, 0.04878, 0.00238,       41,        2,       39
FPQ, 0.02778, 0.00077,       36,        1,       35
FPR, 0.05   , 0.0025 ,       40,        2,       38
FPS, 0.12069, 0.01457,       58,        7,       51
FPT, 0.04545, 0.00207,       44,        2,       42
FPV, 0.09091, 0.00826,       66,        6,       60
FPW, 0.11765, 0.01384,       17,        2,       15
FPY, 0.06452, 0.00416,       31,        2,       29
FP_, 0      , 0      ,        5,        0,        5
FQF, 0      , 0      ,       21,        0,       21
FQG, 0.03333, 0.00111,       60,        2,       58
FQH, 0.2    , 0.04   ,       20,        4,       16
FQI, 0.07547, 0.0057 ,       53,        4,       49
FQK, 0.07018, 0.00492,       57,        4,       53
FQL, 0.07143, 0.0051 ,       56,        4,       52
FQM, 0      , 0      ,       26,        0,       26
FQN, 0.04   , 0.0016 ,       50,        2,       48
FQP, 0      , 0      ,       38,        0,       38
FQQ, 0.04651, 0.00216,       43,        2,       41
FQR, 0.025  , 0.00063,       40,        1,       39
FQS, 0.08163, 0.00666,       49,        4,       45
FQT, 0.02381, 0.00057,       42,        1,       41
FQV, 0      , 0      ,       54,        0,       54
FQW, 0.09091, 0.00826,       11,        1,       10
FQY, 0.11429, 0.01306,       35,        4,       31
FQ_, 0      , 0      ,        4,        0,        4
FRF, 0.09524, 0.00907,       21,        2,       19
FRG, 0.0274 , 0.00075,       73,        2,       71
FRH, 0.125  , 0.01562,       24,        3,       21
FRI, 0.06383, 0.00407,       47,        3,       44
FRK, 0.10448, 0.01092,       67,        7,       60
FRL, 0.0198 , 0.00039,      101,        2,       99
FRM, 0.10526, 0.01108,       19,        2,       17
FRN, 0.02083, 0.00043,       48,        1,       47
FRP, 0.04348, 0.00189,       46,        2,       44
FRQ, 0.02273, 0.00052,       44,        1,       43
FRR, 0.11111, 0.01235,       54,        6,       48
FRS, 0.07229, 0.00523,       83,        6,       77
FRT, 0.08   , 0.0064 ,       50,        4,       46
FRV, 0.1087 , 0.01181,       92,       10,       82
FRW, 0.14286, 0.02041,        7,        1,        6
FRY, 0.10256, 0.01052,       39,        4,       35
FR_, 0.5    , 0.25   ,        2,        1,        1
FSF, 0.18182, 0.03306,       33,        6,       27
FSG, 0.04762, 0.00227,       84,        4,       80
FSH, 0.03448, 0.00119,       29,        1,       28
FSI, 0.18056, 0.0326 ,       72,       13,       59
FSK, 0.08081, 0.00653,       99,        8,       91
FSL, 0.075  , 0.00562,      120,        9,      111
FSM, 0.04167, 0.00174,       24,        1,       23
FSN, 0.04918, 0.00242,       61,        3,       58
FSP, 0.01351, 0.00018,       74,        1,       73
FSQ, 0.07018, 0.00492,       57,        4,       53
FSR, 0.05   , 0.0025 ,       60,        3,       57
FSS, 0.04478, 0.002  ,       67,        3,       64
FST, 0.06173, 0.00381,       81,        5,       76
FSV, 0.08247, 0.0068 ,       97,        8,       89
FSW, 0.07692, 0.00592,       13,        1,       12
FSY, 0.07692, 0.00592,       39,        3,       36
FS_, 0.11111, 0.01235,        9,        1,        8
FTF, 0      , 0      ,       25,        0,       25
FTG, 0.04054, 0.00164,       74,        3,       71
FTH, 0.03333, 0.00111,       30,        1,       29
FTI, 0.03279, 0.00107,       61,        2,       59
FTK, 0.02703, 0.00073,       74,        2,       72
FTL, 0.09091, 0.00826,       99,        9,       90
FTM, 0.09524, 0.00907,       21,        2,       19
FTN, 0.08163, 0.00666,       49,        4,       45
FTP, 0.03279, 0.00107,       61,        2,       59
FTQ, 0.02041, 0.00042,       49,        1,       48
FTR, 0.05085, 0.00259,       59,        3,       56
FTS, 0.13924, 0.01939,       79,       11,       68
FTT, 0.03175, 0.00101,       63,        2,       61
FTV, 0.04545, 0.00207,       88,        4,       84
FTW, 0      , 0      ,       14,        0,       14
FTY, 0      , 0      ,       36,        0,       36
FT_, 0      , 0      ,        2,        0,        2
FVF, 0      , 0      ,       12,        0,       12
FVG, 0.09211, 0.00848,       76,        7,       69
FVH, 0.08696, 0.00756,       23,        2,       21
FVI, 0.14286, 0.02041,       42,        6,       36
FVK, 0.0625 , 0.00391,       64,        4,       60
FVL, 0.06667, 0.00444,       60,        4,       56
FVM, 0.0625 , 0.00391,       16,        1,       15
FVN, 0.05556, 0.00309,       54,        3,       51
FVP, 0.08621, 0.00743,       58,        5,       53
FVQ, 0.05882, 0.00346,       51,        3,       48
FVR, 0.10169, 0.01034,       59,        6,       53
FVS, 0.05882, 0.00346,       68,        4,       64
FVT, 0.05128, 0.00263,       39,        2,       37
FVV, 0.01818, 0.00033,       55,        1,       54
FVW, 0      , 0      ,       10,        0,       10
FVY, 0.12   , 0.0144 ,       25,        3,       22
FV_, 0.33333, 0.11111,        3,        1,        2
FWF, 0      , 0      ,        4,        0,        4
FWG, 0.21429, 0.04592,       14,        3,       11
FWH, 0.5    , 0.25   ,        2,        1,        1
FWI, 0      , 0      ,       11,        0,       11
FWK, 0.05   , 0.0025 ,       20,        1,       19
FWL, 0.06667, 0.00444,       15,        1,       14
FWM, 0      , 0      ,        6,        0,        6
FWN, 0.33333, 0.11111,        9,        3,        6
FWP, 0.26316, 0.06925,       19,        5,       14
FWQ, 0.23529, 0.05536,       17,        4,       13
FWR, 0.15385, 0.02367,       13,        2,       11
FWS, 0.18182, 0.03306,       11,        2,        9
FWT, 0      , 0      ,        8,        0,        8
FWV, 0      , 0      ,       14,        0,       14
FWW, 0      , 0      ,        5,        0,        5
FWY, 0.15385, 0.02367,       13,        2,       11
FW_, 0      , 0      ,        3,        0,        3
FYF, 0.15   , 0.0225 ,       20,        3,       17
FYG, 0.23913, 0.05718,       46,       11,       35
FYH, 0.2    , 0.04   ,       15,        3,       12
FYI, 0.14706, 0.02163,       34,        5,       29
FYK, 0.08333, 0.00694,       48,        4,       44
FYL, 0.12245, 0.01499,       49,        6,       43
FYM, 0.08333, 0.00694,       12,        1,       11
FYN, 0.15625, 0.02441,       32,        5,       27
FYP, 0.11765, 0.01384,       34,        4,       30
FYQ, 0      , 0      ,       27,        0,       27
FYR, 0.2    , 0.04   ,       45,        9,       36
FYS, 0.07692, 0.00592,       52,        4,       48
FYT, 0.17073, 0.02915,       41,        7,       34
FYV, 0.25641, 0.06575,       39,       10,       29
FYW, 0.3    , 0.09   ,       10,        3,        7
FYY, 0.14286, 0.02041,       35,        5,       30
FY_, 0      , 0      ,        1,        0,        1
GAG, 0.04545, 0.00207,       66,        3,       63
GAH, 0.03846, 0.00148,       26,        1,       25
GAI, 0.08511, 0.00724,       94,        8,       86
GAK, 0.05172, 0.00268,      116,        6,      110
GAL, 0.04403, 0.00194,      159,        7,      152
GAM, 0.04   , 0.0016 ,       50,        2,       48
GAN, 0.09722, 0.00945,       72,        7,       65
GAP, 0.05319, 0.00283,       94,        5,       89
GAQ, 0.09231, 0.00852,       65,        6,       59
GAR, 0.02105, 0.00044,       95,        2,       93
GAS, 0.11966, 0.01432,      117,       14,      103
GAT, 0.02632, 0.00069,      114,        3,      111
GAV, 0.06299, 0.00397,      127,        8,      119
GAW, 0.13333, 0.01778,       15,        2,       13
GAY, 0.07143, 0.0051 ,       42,        3,       39
GA_, 0.1    , 0.01   ,       10,        1,        9
GCG, 0.06667, 0.00444,       15,        1,       14
GCH, 0.125  , 0.01562,        8,        1,        7
GCI, 0      , 0      ,       23,        0,       23
GCK, 0.09524, 0.00907,       21,        2,       19
GCL, 0.08571, 0.00735,       35,        3,       32
GCM, 0.25   , 0.0625 ,        4,        1,        3
GCN, 0.05882, 0.00346,       17,        1,       16
GCP, 0.1    , 0.01   ,       30,        3,       27
GCQ, 0.11111, 0.01235,       18,        2,       16
GCR, 0.13333, 0.01778,       30,        4,       26
GCS, 0.16667, 0.02778,       30,        5,       25
GCT, 0.07692, 0.00592,       26,        2,       24
GCV, 0.14706, 0.02163,       34,        5,       29
GCW, 0.6    , 0.36   ,        5,        3,        2
GCY, 0.26667, 0.07111,       30,        8,       22
GC_, 0      , 0      ,        1,        0,        1
GDG, 0.06494, 0.00422,       77,        5,       72
GDH, 0.05128, 0.00263,       39,        2,       37
GDI, 0.05   , 0.0025 ,      120,        6,      114
GDK, 0.05   , 0.0025 ,      160,        8,      152
GDL, 0.02235, 0.0005 ,      179,        4,      175
GDM, 0.09756, 0.00952,       41,        4,       37
GDN, 0.01515, 0.00023,       66,        1,       65
GDP, 0.03252, 0.00106,      123,        4,      119
GDQ, 0.09091, 0.00826,       66,        6,       60
GDR, 0.06557, 0.0043 ,      122,        8,      114
GDS, 0.03623, 0.00131,      138,        5,      133
GDT, 0.09346, 0.00873,      107,       10,       97
GDV, 0.0641 , 0.00411,      156,       10,      146
GDW, 0.13333, 0.01778,       30,        4,       26
GDY, 0.04396, 0.00193,       91,        4,       87
GD_, 0      , 0      ,        5,        0,        5
GEG, 0.0274 , 0.00075,       73,        2,       71
GEH, 0.02439, 0.00059,       41,        1,       40
GEI, 0.05645, 0.00319,      124,        7,      117
GEK, 0.03401, 0.00116,      147,        5,      142
GEL, 0.07429, 0.00552,      175,       13,      162
GEM, 0.06122, 0.00375,       49,        3,       46
GEN, 0.05435, 0.00295,       92,        5,       87
GEP, 0.07194, 0.00518,      139,       10,      129
GEQ, 0.04   , 0.0016 ,       75,        3,       72
GER, 0.07018, 0.00492,      114,        8,      106
GES, 0.07692, 0.00592,      104,        8,       96
GET, 0.02521, 0.00064,      119,        3,      116
GEV, 0.03704, 0.00137,      162,        6,      156
GEW, 0.03571, 0.00128,       28,        1,       27
GEY, 0.01562, 0.00024,       64,        1,       63
GE_, 0      , 0      ,       10,        0,       10
GFG, 0.17647, 0.03114,       51,        9,       42
GFH, 0.09677, 0.00937,       31,        3,       28
GFI, 0.11864, 0.01408,       59,        7,       52
GFK, 0.15625, 0.02441,       64,       10,       54
GFL, 0.12195, 0.01487,       82,       10,       72
GFM, 0.10526, 0.01108,       19,        2,       17
GFN, 0.25926, 0.06722,       54,       14,       40
GFP, 0.03846, 0.00148,       52,        2,       50
GFQ, 0.07895, 0.00623,       38,        3,       35
GFR, 0.05172, 0.00268,       58,        3,       55
GFS, 0.17391, 0.03025,       92,       16,       76
GFT, 0.17391, 0.03025,       46,        8,       38
GFV, 0.10976, 0.01205,       82,        9,       73
GFW, 0.26316, 0.06925,       19,        5,       14
GFY, 0.1    , 0.01   ,       50,        5,       45
GF_, 0      , 0      ,        1,        0,        1
GGG, 0.09859, 0.00972,       71,        7,       64
GGH, 0.06061, 0.00367,       33,        2,       31
GGI, 0.06316, 0.00399,       95,        6,       89
GGK, 0.01031, 0.00011,       97,        1,       96
GGL, 0.05195, 0.0027 ,      154,        8,      146
GGM, 0.08333, 0.00694,       36,        3,       33
GGN, 0.07792, 0.00607,       77,        6,       71
GGP, 0.01176, 0.00014,       85,        1,       84
GGQ, 0.03797, 0.00144,       79,        3,       76
GGR, 0.05983, 0.00358,      117,        7,      110
GGS, 0.0922 , 0.0085 ,      141,       13,      128
GGT, 0.06   , 0.0036 ,      100,        6,       94
GGV, 0.07143, 0.0051 ,      126,        9,      117
GGW, 0.05556, 0.00309,       36,        2,       34
GGY, 0.10959, 0.01201,       73,        8,       65
GG_, 0      , 0      ,       14,        0,       14
GHG, 0.24138, 0.05826,       29,        7,       22
GHH, 0      , 0      ,       22,        0,       22
GHI, 0.08889, 0.0079 ,       45,        4,       41
GHK, 0.05405, 0.00292,       37,        2,       35
GHL, 0.08333, 0.00694,       60,        5,       55
GHM, 0.1    , 0.01   ,       20,        2,       18
GHN, 0.05263, 0.00277,       19,        1,       18
GHP, 0.06452, 0.00416,       31,        2,       29
GHQ, 0.07692, 0.00592,       13,        1,       12
GHR, 0.09375, 0.00879,       32,        3,       29
GHS, 0.16   , 0.0256 ,       50,        8,       42
GHT, 0.06383, 0.00407,       47,        3,       44
GHV, 0.14286, 0.02041,       49,        7,       42
GHW, 0.4    , 0.16   ,        5,        2,        3
GHY, 0.13158, 0.01731,       38,        5,       33
GH_, 0      , 0      ,        3,        0,        3
GIG, 0.16667, 0.02778,       48,        8,       40
GIH, 0.03448, 0.00119,       29,        1,       28
GII, 0.12329, 0.0152 ,       73,        9,       64
GIK, 0.05155, 0.00266,       97,        5,       92
GIL, 0.04274, 0.00183,      117,        5,      112
GIM, 0.2069 , 0.04281,       29,        6,       23
GIN, 0.06061, 0.00367,       66,        4,       62
GIP, 0.08219, 0.00676,       73,        6,       67
GIQ, 0.07692, 0.00592,       52,        4,       48
GIR, 0.04225, 0.00179,       71,        3,       68
GIS, 0.09333, 0.00871,       75,        7,       68
GIT, 0.11688, 0.01366,       77,        9,       68
GIV, 0.04167, 0.00174,       96,        4,       92
GIW, 0.1    , 0.01   ,       20,        2,       18
GIY, 0.14634, 0.02142,       41,        6,       35
GI_, 0      , 0      ,        3,        0,        3
GKG, 0.03846, 0.00148,       52,        2,       50
GKH, 0      , 0      ,       44,        0,       44
GKI, 0.04795, 0.0023 ,      146,        7,      139
GKK, 0.06364, 0.00405,      110,        7,      103
GKL, 0.06542, 0.00428,      214,       14,      200
GKM, 0.08108, 0.00657,       37,        3,       34
GKN, 0.06494, 0.00422,       77,        5,       72
GKP, 0.04255, 0.00181,       94,        4,       90
GKQ, 0.01724, 0.0003 ,       58,        1,       57
GKR, 0.03883, 0.00151,      103,        4,       99
GKS, 0.0381 , 0.00145,      105,        4,      101
GKT, 0.05   , 0.0025 ,      120,        6,      114
GKV, 0.08594, 0.00739,      128,       11,      117
GKW, 0.03226, 0.00104,       31,        1,       30
GKY, 0.01205, 0.00015,       83,        1,       82
GK_, 0      , 0      ,        7,        0,        7
GLG, 0.16667, 0.02778,       66,       11,       55
GLH, 0.03846, 0.00148,       52,        2,       50
GLI, 0.13014, 0.01694,      146,       19,      127
GLK, 0.06452, 0.00416,      155,       10,      145
GLL, 0.05854, 0.00343,      205,       12,      193
GLM, 0.06667, 0.00444,       45,        3,       42
GLN, 0.02532, 0.00064,       79,        2,       77
GLP, 0.06294, 0.00396,      143,        9,      134
GLQ, 0.03448, 0.00119,       87,        3,       84
GLR, 0.05344, 0.00286,      131,        7,      124
GLS, 0.08209, 0.00674,      134,       11,      123
GLT, 0.10938, 0.01196,      128,       14,      114
GLV, 0.0625 , 0.00391,      160,       10,      150
GLW, 0      , 0      ,       32,        0,       32
GLY, 0.05479, 0.003  ,       73,        4,       69
GL_, 0.125  , 0.01562,        8,        1,        7
GMG, 0      , 0      ,       15,        0,       15
GMH, 0.07692, 0.00592,       13,        1,       12
GMI, 0.10811, 0.01169,       37,        4,       33
GMK, 0.02857, 0.00082,       35,        1,       34
GML, 0.13333, 0.01778,       60,        8,       52
GMM, 0      , 0      ,       11,        0,       11
GMN, 0.15385, 0.02367,       26,        4,       22
GMP, 0.07143, 0.0051 ,       28,        2,       26
GMQ, 0.13793, 0.01902,       29,        4,       25
GMR, 0      , 0      ,       20,        0,       20
GMS, 0.05263, 0.00277,       38,        2,       36
GMT, 0.18421, 0.03393,       38,        7,       31
GMV, 0      , 0      ,       40,        0,       40
GMW, 0.11111, 0.01235,        9,        1,        8
GMY, 0.0625 , 0.00391,       16,        1,       15
GM_, 0.125  , 0.01562,        8,        1,        7
GNG, 0.16667, 0.02778,       48,        8,       40
GNH, 0.10345, 0.0107 ,       29,        3,       26
GNI, 0.04132, 0.00171,      121,        5,      116
GNK, 0.05333, 0.00284,       75,        4,       71
GNL, 0.088  , 0.00774,      125,       11,      114
GNM, 0.04167, 0.00174,       24,        1,       23
GNN, 0.09836, 0.00967,       61,        6,       55
GNP, 0.08511, 0.00724,       94,        8,       86
GNQ, 0.04688, 0.0022 ,       64,        3,       61
GNR, 0.10938, 0.01196,       64,        7,       57
GNS, 0.07   , 0.0049 ,      100,        7,       93
GNT, 0.10112, 0.01023,       89,        9,       80
GNV, 0.03906, 0.00153,      128,        5,      123
GNW, 0      , 0      ,       24,        0,       24
GNY, 0.03279, 0.00107,       61,        2,       59
GN_, 0.14286, 0.02041,        7,        1,        6
GPG, 0.01852, 0.00034,       54,        1,       53
GPH, 0.03448, 0.00119,       29,        1,       28
GPI, 0.04301, 0.00185,       93,        4,       89
GPK, 0.03448, 0.00119,       87,        3,       84
GPL, 0.06667, 0.00444,      120,        8,      112
GPM, 0.0625 , 0.00391,       32,        2,       30
GPN, 0.06383, 0.00407,       47,        3,       44
GPP, 0.02703, 0.00073,       74,        2,       72
GPQ, 0      , 0      ,       60,        0,       60
GPR, 0.05333, 0.00284,       75,        4,       71
GPS, 0.07895, 0.00623,       76,        6,       70
GPT, 0.0641 , 0.00411,       78,        5,       73
GPV, 0.04348, 0.00189,       92,        4,       88
GPW, 0      , 0      ,       14,        0,       14
GPY, 0.02632, 0.00069,       38,        1,       37
GP_, 0      , 0      ,        4,        0,        4
GQG, 0      , 0      ,       35,        0,       35
GQH, 0.08333, 0.00694,       24,        2,       22
GQI, 0.08974, 0.00805,       78,        7,       71
GQK, 0.08451, 0.00714,       71,        6,       65
GQL, 0.08333, 0.00694,      108,        9,       99
GQM, 0.02703, 0.00073,       37,        1,       36
GQN, 0.09434, 0.0089 ,       53,        5,       48
GQP, 0.03125, 0.00098,       64,        2,       62
GQQ, 0.07273, 0.00529,       55,        4,       51
GQR, 0.08108, 0.00657,       74,        6,       68
GQS, 0.0303 , 0.00092,       66,        2,       64
GQT, 0.07812, 0.0061 ,       64,        5,       59
GQV, 0.08621, 0.00743,      116,       10,      106
GQW, 0.04545, 0.00207,       22,        1,       21
GQY, 0.09091, 0.00826,       55,        5,       50
GQ_, 0.25   , 0.0625 ,        4,        1,        3
GRG, 0.16949, 0.02873,       59,       10,       49
GRH, 0.03704, 0.00137,       27,        1,       26
GRI, 0.08264, 0.00683,      121,       10,      111
GRK, 0.07527, 0.00567,       93,        7,       86
GRL, 0.0733 , 0.00537,      191,       14,      177
GRM, 0.25   , 0.0625 ,       36,        9,       27
GRN, 0.06557, 0.0043 ,       61,        4,       57
GRP, 0.01136, 0.00013,       88,        1,       87
GRQ, 0.06061, 0.00367,       66,        4,       62
GRR, 0.09735, 0.00948,      113,       11,      102
GRS, 0.09   , 0.0081 ,      100,        9,       91
GRT, 0.16832, 0.02833,      101,       17,       84
GRV, 0.1223 , 0.01496,      139,       17,      122
GRW, 0.17241, 0.02973,       29,        5,       24
GRY, 0.06897, 0.00476,       58,        4,       54
GR_, 0      , 0      ,        2,        0,        2
GSG, 0.02   , 0.0004 ,      100,        2,       98
GSH, 0.0303 , 0.00092,       66,        2,       64
GSI, 0.10909, 0.0119 ,      110,       12,       98
GSK, 0.04587, 0.0021 ,      109,        5,      104
GSL, 0.04142, 0.00172,      169,        7,      162
GSM, 0.02632, 0.00069,       38,        1,       37
GSN, 0.03846, 0.00148,       78,        3,       75
GSP, 0.0431 , 0.00186,      116,        5,      111
GSQ, 0.03529, 0.00125,       85,        3,       82
GSR, 0.08696, 0.00756,       92,        8,       84
GSS, 0.07386, 0.00546,      176,       13,      163
GST, 0.07087, 0.00502,      127,        9,      118
GSV, 0.03205, 0.00103,      156,        5,      151
GSW, 0.16667, 0.02778,       30,        5,       25
GSY, 0.04   , 0.0016 ,      100,        4,       96
GS_, 0      , 0      ,       16,        0,       16
GTG, 0.1    , 0.01   ,       70,        7,       63
GTH, 0.04762, 0.00227,       42,        2,       40
GTI, 0.05556, 0.00309,      126,        7,      119
GTK, 0.05618, 0.00316,       89,        5,       84
GTL, 0.03401, 0.00116,      147,        5,      142
GTM, 0      , 0      ,       25,        0,       25
GTN, 0.04688, 0.0022 ,       64,        3,       61
GTP, 0.07368, 0.00543,       95,        7,       88
GTQ, 0.05263, 0.00277,       57,        3,       54
GTR, 0.10127, 0.01025,       79,        8,       71
GTS, 0.05785, 0.00335,      121,        7,      114
GTT, 0.09091, 0.00826,      110,       10,      100
GTV, 0.03306, 0.00109,      121,        4,      117
GTW, 0.03333, 0.00111,       30,        1,       29
GTY, 0.04878, 0.00238,       82,        4,       78
GT_, 0      , 0      ,        7,        0,        7
GVG, 0.10909, 0.0119 ,       55,        6,       49
GVH, 0.08571, 0.00735,       35,        3,       32
GVI, 0.07317, 0.00535,       82,        6,       76
GVK, 0.04211, 0.00177,       95,        4,       91
GVL, 0.08904, 0.00793,      146,       13,      133
GVM, 0.03571, 0.00128,       28,        1,       27
GVN, 0.02985, 0.00089,       67,        2,       65
GVP, 0.1134 , 0.01286,       97,       11,       86
GVQ, 0.02899, 0.00084,       69,        2,       67
GVR, 0.11842, 0.01402,       76,        9,       67
GVS, 0.10924, 0.01193,      119,       13,      106
GVT, 0.04301, 0.00185,       93,        4,       89
GVV, 0.07383, 0.00545,      149,       11,      138
GVW, 0.17391, 0.03025,       23,        4,       19
GVY, 0.03509, 0.00123,       57,        2,       55
GV_, 0      , 0      ,        6,        0,        6
GWG, 0.25   , 0.0625 ,       24,        6,       18
GWH, 0.42857, 0.18367,        7,        3,        4
GWI, 0.04348, 0.00189,       23,        1,       22
GWK, 0.12   , 0.0144 ,       25,        3,       22
GWL, 0.2069 , 0.04281,       29,        6,       23
GWM, 0.125  , 0.01562,        8,        1,        7
GWN, 0.18182, 0.03306,       22,        4,       18
GWP, 0.17647, 0.03114,       17,        3,       14
GWQ, 0.14286, 0.02041,        7,        1,        6
GWR, 0.1    , 0.01   ,       20,        2,       18
GWS, 0.29032, 0.08429,       31,        9,       22
GWT, 0.19355, 0.03746,       31,        6,       25
GWV, 0.25   , 0.0625 ,       24,        6,       18
GWW, 0.42857, 0.18367,        7,        3,        4
GWY, 0.18182, 0.03306,       22,        4,       18
GYG, 0.16667, 0.02778,       42,        7,       35
GYH, 0.13333, 0.01778,       30,        4,       26
GYI, 0.11594, 0.01344,       69,        8,       61
GYK, 0.09877, 0.00975,       81,        8,       73
GYL, 0.16   , 0.0256 ,      100,       16,       84
GYM, 0.25   , 0.0625 ,       20,        5,       15
GYN, 0.07018, 0.00492,       57,        4,       53
GYP, 0.13115, 0.0172 ,       61,        8,       53
GYQ, 0.125  , 0.01562,       32,        4,       28
GYR, 0.23333, 0.05444,       60,       14,       46
GYS, 0.12766, 0.0163 ,       94,       12,       82
GYT, 0.16667, 0.02778,       78,       13,       65
GYV, 0.18841, 0.0355 ,       69,       13,       56
GYW, 0.2    , 0.04   ,       15,        3,       12
GYY, 0.08511, 0.00724,       47,        4,       43
GY_, 0      , 0      ,        1,        0,        1
HAH, 0.14286, 0.02041,        7,        1,        6
HAI, 0.06452, 0.00416,       31,        2,       29
HAK, 0      , 0      ,       31,        0,       31
HAL, 0.07317, 0.00535,       41,        3,       38
HAM, 0      , 0      ,       12,        0,       12
HAN, 0      , 0      ,       17,        0,       17
HAP, 0.04762, 0.00227,       21,        1,       20
HAQ, 0      , 0      ,       27,        0,       27
HAR, 0.06061, 0.00367,       33,        2,       31
HAS, 0.05714, 0.00327,       35,        2,       33
HAT, 0      , 0      ,       24,        0,       24
HAV, 0.125  , 0.01562,       32,        4,       28
HAW, 0.125  , 0.01562,        8,        1,        7
HAY, 0.09091, 0.00826,       11,        1,       10
HA_, 0      , 0      ,        3,        0,        3
HCI, 0.07143, 0.0051 ,       14,        1,       13
HCK, 0.1    , 0.01   ,       10,        1,        9
HCL, 0.07143, 0.0051 ,       14,        1,       13
HCM, 0      , 0      ,        3,        0,        3
HCN, 0      , 0      ,        8,        0,        8
HCP, 0.1    , 0.01   ,       10,        1,        9
HCQ, 0      , 0      ,       12,        0,       12
HCR, 0.11111, 0.01235,        9,        1,        8
HCS, 0.09091, 0.00826,       11,        1,       10
HCT, 0      , 0      ,        5,        0,        5
HCV, 0.13333, 0.01778,       15,        2,       13
HCW, 0      , 0      ,        2,        0,        2
HCY, 0      , 0      ,        9,        0,        9
HDH, 0      , 0      ,        2,        0,        2
HDI, 0.06667, 0.00444,       30,        2,       28
HDK, 0.02857, 0.00082,       35,        1,       34
HDL, 0.03636, 0.00132,       55,        2,       53
HDM, 0.1    , 0.01   ,       10,        1,        9
HDN, 0.1    , 0.01   ,       20,        2,       18
HDP, 0.02941, 0.00087,       34,        1,       33
HDQ, 0      , 0      ,       31,        0,       31
HDR, 0.08333, 0.00694,       24,        2,       22
HDS, 0.04167, 0.00174,       24,        1,       23
HDT, 0.17647, 0.03114,       17,        3,       14
HDV, 0.1087 , 0.01181,       46,        5,       41
HDW, 0.14286, 0.02041,        7,        1,        6
HDY, 0.2    , 0.04   ,       20,        4,       16
HD_, 1      , 1      ,        1,        1,        0
HEH, 0      , 0      ,       11,        0,       11
HEI, 0.06383, 0.00407,       47,        3,       44
HEK, 0.0303 , 0.00092,       33,        1,       32
HEL, 0.12162, 0.01479,       74,        9,       65
HEM, 0.08696, 0.00756,       23,        2,       21
HEN, 0      , 0      ,       27,        0,       27
HEP, 0.05714, 0.00327,       35,        2,       33
HEQ, 0.03448, 0.00119,       29,        1,       28
HER, 0.07407, 0.00549,       27,        2,       25
HES, 0.09677, 0.00937,       31,        3,       28
HET, 0.10811, 0.01169,       37,        4,       33
HEV, 0.04348, 0.00189,       46,        2,       44
HEW, 0      , 0      ,       13,        0,       13
HEY, 0.21053, 0.04432,       19,        4,       15
HE_, 0      , 0      ,        2,        0,        2
HFH, 0.125  , 0.01562,        8,        1,        7
HFI, 0.08333, 0.00694,       24,        2,       22
HFK, 0.21875, 0.04785,       32,        7,       25
HFL, 0.05882, 0.00346,       34,        2,       32
HFM, 0.1    , 0.01   ,       10,        1,        9
HFN, 0.33333, 0.11111,       15,        5,       10
HFP, 0.16   , 0.0256 ,       25,        4,       21
HFQ, 0.08696, 0.00756,       23,        2,       21
HFR, 0.0625 , 0.00391,       16,        1,       15
HFS, 0.05556, 0.00309,       36,        2,       34
HFT, 0.06061, 0.00367,       33,        2,       31
HFV, 0.08333, 0.00694,       36,        3,       33
HFW, 0      , 0      ,       20,        0,       20
HFY, 0.16667, 0.02778,        6,        1,        5
HF_, 0.5    , 0.25   ,        2,        1,        1
HGH, 0      , 0      ,        4,        0,        4
HGI, 0.07317, 0.00535,       41,        3,       38
HGK, 0      , 0      ,       42,        0,       42
HGL, 0.07547, 0.0057 ,       53,        4,       49
HGM, 0.09091, 0.00826,       11,        1,       10
HGN, 0      , 0      ,       39,        0,       39
HGP, 0      , 0      ,       30,        0,       30
HGQ, 0.03333, 0.00111,       30,        1,       29
HGR, 0.06667, 0.00444,       30,        2,       28
HGS, 0.04878, 0.00238,       41,        2,       39
HGT, 0      , 0      ,       37,        0,       37
HGV, 0.08333, 0.00694,       36,        3,       33
HGW, 0.2    , 0.04   ,        5,        1,        4
HGY, 0.04   , 0.0016 ,       25,        1,       24
HG_, 0      , 0      ,        7,        0,        7
HHH, 0      , 0      ,       54,        0,       54
HHI, 0.05882, 0.00346,       17,        1,       16
HHK, 0      , 0      ,       12,        0,       12
HHL, 0.03846, 0.00148,       26,        1,       25
HHM, 0.23077, 0.05325,       13,        3,       10
HHN, 0      , 0      ,        8,        0,        8
HHP, 0      , 0      ,       13,        0,       13
HHQ, 0.2    , 0.04   ,       10,        2,        8
HHR, 0      , 0      ,       15,        0,       15
HHS, 0.0625 , 0.00391,       16,        1,       15
HHT, 0.0625 , 0.00391,       16,        1,       15
HHV, 0.08   , 0.0064 ,       25,        2,       23
HHW, 0      , 0      ,        7,        0,        7
HHY, 0.28571, 0.08163,        7,        2,        5
HH_, 0      , 0      ,       15,        0,       15
HIH, 0      , 0      ,        3,        0,        3
HII, 0.18182, 0.03306,       22,        4,       18
HIK, 0.09677, 0.00937,       31,        3,       28
HIL, 0.08511, 0.00724,       47,        4,       43
HIM, 0      , 0      ,        5,        0,        5
HIN, 0      , 0      ,       22,        0,       22
HIP, 0.07143, 0.0051 ,       28,        2,       26
HIQ, 0      , 0      ,       23,        0,       23
HIR, 0.08696, 0.00756,       23,        2,       21
HIS, 0.0303 , 0.00092,       33,        1,       32
HIT, 0.04762, 0.00227,       21,        1,       20
HIV, 0.10714, 0.01148,       28,        3,       25
HIW, 0      , 0      ,        9,        0,        9
HIY, 0.05882, 0.00346,       17,        1,       16
HI_, 1      , 1      ,        1,        1,        0
HKH, 0      , 0      ,        5,        0,        5
HKI, 0.11429, 0.01306,       35,        4,       31
HKK, 0.11364, 0.01291,       44,        5,       39
HKL, 0.06757, 0.00457,       74,        5,       69
HKM, 0.04545, 0.00207,       22,        1,       21
HKN, 0.12903, 0.01665,       31,        4,       27
HKP, 0      , 0      ,       20,        0,       20
HKQ, 0.03704, 0.00137,       27,        1,       26
HKR, 0      , 0      ,       29,        0,       29
HKS, 0.02703, 0.00073,       37,        1,       36
HKT, 0.09524, 0.00907,       21,        2,       19
HKV, 0.12195, 0.01487,       41,        5,       36
HKW, 0.15385, 0.02367,       13,        2,       11
HKY, 0.03846, 0.00148,       26,        1,       25
HK_, 0      , 0      ,        2,        0,        2
HLH, 0.18182, 0.03306,       11,        2,        9
HLI, 0.09524, 0.00907,       42,        4,       38
HLK, 0.04   , 0.0016 ,       50,        2,       48
HLL, 0.03488, 0.00122,       86,        3,       83
HLM, 0.1    , 0.01   ,       10,        1,        9
HLN, 0.06452, 0.00416,       31,        2,       29
HLP, 0.10417, 0.01085,       48,        5,       43
HLQ, 0.06977, 0.00487,       43,        3,       40
HLR, 0.0625 , 0.00391,       48,        3,       45
HLS, 0.06818, 0.00465,       44,        3,       41
HLT, 0.07317, 0.00535,       41,        3,       38
HLV, 0.12121, 0.01469,       66,        8,       58
HLW, 0      , 0      ,        5,        0,        5
HLY, 0.11538, 0.01331,       26,        3,       23
HL_, 1      , 1      ,        1,        1,        0
HMH, 0      , 0      ,        3,        0,        3
HMI, 0.08333, 0.00694,       12,        1,       11
HMK, 0      , 0      ,       14,        0,       14
HML, 0.13793, 0.01902,       29,        4,       25
HMM, 0.16667, 0.02778,        6,        1,        5
HMN, 0      , 0      ,        9,        0,        9
HMP, 0      , 0      ,       12,        0,       12
HMQ, 0      , 0      ,       15,        0,       15
HMR, 0      , 0      ,       11,        0,       11
HMS, 0.07692, 0.00592,       13,        1,       12
HMT, 0.09091, 0.00826,       11,        1,       10
HMV, 0.07692, 0.00592,       13,        1,       12
HMW, 0      , 0      ,        3,        0,        3
HMY, 1      , 1      ,        2,        2,        0
HM_, 0      , 0      ,        4,        0,        4
HNH, 0      , 0      ,        3,        0,        3
HNI, 0.05882, 0.00346,       34,        2,       32
HNK, 0.08333, 0.00694,       24,        2,       22
HNL, 0.09524, 0.00907,       42,        4,       38
HNM, 0.08333, 0.00694,       12,        1,       11
HNN, 0.04348, 0.00189,       23,        1,       22
HNP, 0.07407, 0.00549,       27,        2,       25
HNQ, 0      , 0      ,       23,        0,       23
HNR, 0.09524, 0.00907,       21,        2,       19
HNS, 0      , 0      ,       19,        0,       19
HNT, 0.04   , 0.0016 ,       25,        1,       24
HNV, 0.09375, 0.00879,       32,        3,       29
HNW, 0      , 0      ,        6,        0,        6
HNY, 0.23529, 0.05536,       17,        4,       13
HN_, 0.5    , 0.25   ,        2,        1,        1
HPH, 0      , 0      ,        5,        0,        5
HPI, 0      , 0      ,       27,        0,       27
HPK, 0      , 0      ,       37,        0,       37
HPL, 0.02326, 0.00054,       43,        1,       42
HPM, 0      , 0      ,       12,        0,       12
HPN, 0.04348, 0.00189,       23,        1,       22
HPP, 0      , 0      ,       26,        0,       26
HPQ, 0      , 0      ,       14,        0,       14
HPR, 0.05556, 0.00309,       18,        1,       17
HPS, 0      , 0      ,       33,        0,       33
HPT, 0.07143, 0.0051 ,       28,        2,       26
HPV, 0.17857, 0.03189,       28,        5,       23
HPW, 0.07692, 0.00592,       13,        1,       12
HPY, 0      , 0      ,       17,        0,       17
HP_, 0.33333, 0.11111,        3,        1,        2
HQH, 0      , 0      ,        9,        0,        9
HQI, 0.21429, 0.04592,       28,        6,       22
HQK, 0.03846, 0.00148,       26,        1,       25
HQL, 0.0597 , 0.00356,       67,        4,       63
HQM, 0.25   , 0.0625 ,        4,        1,        3
HQN, 0.1    , 0.01   ,       10,        1,        9
HQP, 0      , 0      ,       14,        0,       14
HQQ, 0.03846, 0.00148,       26,        1,       25
HQR, 0.04762, 0.00227,       21,        1,       20
HQS, 0.08   , 0.0064 ,       25,        2,       23
HQT, 0      , 0      ,       16,        0,       16
HQV, 0.24242, 0.05877,       33,        8,       25
HQW, 0.14286, 0.02041,        7,        1,        6
HQY, 0.06667, 0.00444,       15,        1,       14
HQ_, 0      , 0      ,        2,        0,        2
HRH, 0.1    , 0.01   ,       10,        1,        9
HRI, 0.07895, 0.00623,       38,        3,       35
HRK, 0.06897, 0.00476,       29,        2,       27
HRL, 0.04   , 0.0016 ,       50,        2,       48
HRM, 0      , 0      ,        7,        0,        7
HRN, 0.04   , 0.0016 ,       25,        1,       24
HRP, 0.09677, 0.00937,       31,        3,       28
HRQ, 0.05556, 0.00309,       18,        1,       17
HRR, 0.05882, 0.00346,       34,        2,       32
HRS, 0.10811, 0.01169,       37,        4,       33
HRT, 0.13636, 0.0186 ,       22,        3,       19
HRV, 0.1    , 0.01   ,       40,        4,       36
HRW, 0.25   , 0.0625 ,        8,        2,        6
HRY, 0.03226, 0.00104,       31,        1,       30
HR_, 0      , 0      ,        1,        0,        1
HSH, 0      , 0      ,        4,        0,        4
HSI, 0.09375, 0.00879,       32,        3,       29
HSK, 0      , 0      ,       36,        0,       36
HSL, 0.0411 , 0.00169,       73,        3,       70
HSM, 0      , 0      ,       18,        0,       18
HSN, 0.03333, 0.00111,       30,        1,       29
HSP, 0      , 0      ,       36,        0,       36
HSQ, 0      , 0      ,       34,        0,       34
HSR, 0.02941, 0.00087,       34,        1,       33
HSS, 0.16667, 0.02778,       42,        7,       35
HST, 0.03571, 0.00128,       28,        1,       27
HSV, 0.07547, 0.0057 ,       53,        4,       49
HSW, 0      , 0      ,        9,        0,        9
HSY, 0.2    , 0.04   ,       25,        5,       20
HS_, 0      , 0      ,        9,        0,        9
HTH, 0      , 0      ,       10,        0,       10
HTI, 0.03704, 0.00137,       27,        1,       26
HTK, 0.03448, 0.00119,       29,        1,       28
HTL, 0.02083, 0.00043,       48,        1,       47
HTM, 0      , 0      ,       13,        0,       13
HTN, 0.04545, 0.00207,       22,        1,       21
HTP, 0      , 0      ,       22,        0,       22
HTQ, 0      , 0      ,       17,        0,       17
HTR, 0.05556, 0.00309,       18,        1,       17
HTS, 0      , 0      ,       20,        0,       20
HTT, 0.0303 , 0.00092,       33,        1,       32
HTV, 0.02941, 0.00087,       34,        1,       33
HTW, 0      , 0      ,        8,        0,        8
HTY, 0.11111, 0.01235,       18,        2,       16
HT_, 0      , 0      ,        2,        0,        2
HVH, 0      , 0      ,        3,        0,        3
HVI, 0      , 0      ,       25,        0,       25
HVK, 0      , 0      ,       28,        0,       28
HVL, 0.04   , 0.0016 ,       50,        2,       48
HVM, 0      , 0      ,       14,        0,       14
HVN, 0.05   , 0.0025 ,       20,        1,       19
HVP, 0.15625, 0.02441,       32,        5,       27
HVQ, 0.07692, 0.00592,       26,        2,       24
HVR, 0.04348, 0.00189,       23,        1,       22
HVS, 0.1    , 0.01   ,       40,        4,       36
HVT, 0      , 0      ,       28,        0,       28
HVV, 0.0625 , 0.00391,       32,        2,       30
HVW, 0.33333, 0.11111,        3,        1,        2
HVY, 0.11111, 0.01235,       18,        2,       16
HV_, 0      , 0      ,        3,        0,        3
HWH, 0      , 0      ,        5,        0,        5
HWI, 0      , 0      ,        6,        0,        6
HWK, 0.2    , 0.04   ,       10,        2,        8
HWL, 0      , 0      ,       10,        0,       10
HWM, 0      , 0      ,        6,        0,        6
HWN, 0      , 0      ,        4,        0,        4
HWP, 0.1    , 0.01   ,       10,        1,        9
HWQ, 0      , 0      ,        2,        0,        2
HWR, 0.6    , 0.36   ,        5,        3,        2
HWS, 0.28571, 0.08163,        7,        2,        5
HWT, 0.21429, 0.04592,       14,        3,       11
HWV, 0.4    , 0.16   ,        5,        2,        3
HWW, 0      , 0      ,        3,        0,        3
HWY, 0.16667, 0.02778,        6,        1,        5
HYH, 0      , 0      ,        4,        0,        4
HYI, 0.07407, 0.00549,       27,        2,       25
HYK, 0.11538, 0.01331,       26,        3,       23
HYL, 0.12821, 0.01644,       39,        5,       34
HYM, 0.16667, 0.02778,        6,        1,        5
HYN, 0.11111, 0.01235,       18,        2,       16
HYP, 0.05882, 0.00346,       17,        1,       16
HYQ, 0.125  , 0.01562,       16,        2,       14
HYR, 0.28571, 0.08163,       14,        4,       10
HYS, 0.0625 , 0.00391,       32,        2,       30
HYT, 0.2381 , 0.05669,       21,        5,       16
HYV, 0.04   , 0.0016 ,       25,        1,       24
HYW, 0      , 0      ,       11,        0,       11
HYY, 0.19048, 0.03628,       21,        4,       17
HY_, 0      , 0      ,        1,        0,        1
IAI, 0.08   , 0.0064 ,       25,        2,       23
IAK, 0.03226, 0.00104,       93,        3,       90
IAL, 0.08654, 0.00749,      104,        9,       95
IAM, 0.0625 , 0.00391,       32,        2,       30
IAN, 0.04878, 0.00238,       82,        4,       78
IAP, 0      , 0      ,       49,        0,       49
IAQ, 0.11429, 0.01306,       70,        8,       62
IAR, 0.02778, 0.00077,       72,        2,       70
IAS, 0.0303 , 0.00092,       99,        3,       96
IAT, 0.09589, 0.00919,       73,        7,       66
IAV, 0.08333, 0.00694,       72,        6,       66
IAW, 0.11111, 0.01235,        9,        1,        8
IAY, 0.08824, 0.00779,       34,        3,       31
IA_, 0      , 0      ,        6,        0,        6
ICI, 0.5    , 0.25   ,        4,        2,        2
ICK, 0.03125, 0.00098,       32,        1,       31
ICL, 0.09375, 0.00879,       32,        3,       29
ICM, 0.11111, 0.01235,        9,        1,        8
ICN, 0.0625 , 0.00391,       16,        1,       15
ICP, 0.05263, 0.00277,       19,        1,       18
ICQ, 0.16   , 0.0256 ,       25,        4,       21
ICR, 0      , 0      ,       20,        0,       20
ICS, 0.05882, 0.00346,       17,        1,       16
ICT, 0      , 0      ,       16,        0,       16
ICV, 0.10526, 0.01108,       19,        2,       17
ICW, 0      , 0      ,        3,        0,        3
ICY, 0.3    , 0.09   ,       10,        3,        7
IC_, 0      , 0      ,        1,        0,        1
IDI, 0.04878, 0.00238,       41,        2,       39
IDK, 0.04511, 0.00204,      133,        6,      127
IDL, 0.06748, 0.00455,      163,       11,      152
IDM, 0      , 0      ,       33,        0,       33
IDN, 0.05634, 0.00317,       71,        4,       67
IDP, 0.02381, 0.00057,       84,        2,       82
IDQ, 0.06349, 0.00403,       63,        4,       59
IDR, 0.05435, 0.00295,       92,        5,       87
IDS, 0.08911, 0.00794,      101,        9,       92
IDT, 0.03333, 0.00111,       90,        3,       87
IDV, 0.04839, 0.00234,      124,        6,      118
IDW, 0.06452, 0.00416,       31,        2,       29
IDY, 0.05085, 0.00259,       59,        3,       56
ID_, 0      , 0      ,        3,        0,        3
IEI, 0.02857, 0.00082,       35,        1,       34
IEK, 0.05674, 0.00322,      141,        8,      133
IEL, 0.10651, 0.01134,      169,       18,      151
IEM, 0.02564, 0.00066,       39,        1,       38
IEN, 0.05128, 0.00263,       78,        4,       74
IEP, 0.03659, 0.00134,       82,        3,       79
IEQ, 0.03371, 0.00114,       89,        3,       86
IER, 0.0155 , 0.00024,      129,        2,      127
IES, 0.06364, 0.00405,      110,        7,      103
IET, 0.05882, 0.00346,       68,        4,       64
IEV, 0.03252, 0.00106,      123,        4,      119
IEW, 0.09375, 0.00879,       32,        3,       29
IEY, 0.11111, 0.01235,       54,        6,       48
IE_, 0      , 0      ,        3,        0,        3
IFI, 0      , 0      ,       20,        0,       20
IFK, 0.09589, 0.00919,       73,        7,       66
IFL, 0.09434, 0.0089 ,       53,        5,       48
IFM, 0.13333, 0.01778,       15,        2,       13
IFN, 0.11111, 0.01235,       45,        5,       40
IFP, 0.08108, 0.00657,       37,        3,       34
IFQ, 0.14894, 0.02218,       47,        7,       40
IFR, 0.09615, 0.00925,       52,        5,       47
IFS, 0.09677, 0.00937,       62,        6,       56
IFT, 0.11667, 0.01361,       60,        7,       53
IFV, 0.06   , 0.0036 ,       50,        3,       47
IFW, 0      , 0      ,        7,        0,        7
IFY, 0.15789, 0.02493,       38,        6,       32
IF_, 0.2    , 0.04   ,        5,        1,        4
IGI, 0.15385, 0.02367,       26,        4,       22
IGK, 0.02381, 0.00057,       84,        2,       82
IGL, 0.0625 , 0.00391,      112,        7,      105
IGM, 0.08696, 0.00756,       23,        2,       21
IGN, 0.05797, 0.00336,       69,        4,       65
IGP, 0      , 0      ,       45,        0,       45
IGQ, 0.05   , 0.0025 ,       60,        3,       57
IGR, 0.0875 , 0.00766,       80,        7,       73
IGS, 0.04651, 0.00216,       86,        4,       82
IGT, 0.04819, 0.00232,       83,        4,       79
IGV, 0.03571, 0.00128,       56,        2,       54
IGW, 0.05556, 0.00309,       18,        1,       17
IGY, 0.04878, 0.00238,       41,        2,       39
IG_, 0      , 0      ,       10,        0,       10
IHI, 0.0625 , 0.00391,       16,        1,       15
IHK, 0.08   , 0.0064 ,       50,        4,       46
IHL, 0.04167, 0.00174,       48,        2,       46
IHM, 0      , 0      ,        4,        0,        4
IHN, 0.03125, 0.00098,       32,        1,       31
IHP, 0.1    , 0.01   ,       30,        3,       27
IHQ, 0.05556, 0.00309,       36,        2,       34
IHR, 0.02857, 0.00082,       35,        1,       34
IHS, 0.25   , 0.0625 ,       52,       13,       39
IHT, 0.11905, 0.01417,       42,        5,       37
IHV, 0.08824, 0.00779,       34,        3,       31
IHW, 0      , 0      ,        5,        0,        5
IHY, 0.08   , 0.0064 ,       25,        2,       23
IH_, 0      , 0      ,        2,        0,        2
III, 0      , 0      ,        9,        0,        9
IIK, 0.07292, 0.00532,       96,        7,       89
IIL, 0.05172, 0.00268,       58,        3,       55
IIM, 0.04167, 0.00174,       24,        1,       23
IIN, 0.08824, 0.00779,       68,        6,       62
IIP, 0.09804, 0.00961,       51,        5,       46
IIQ, 0.0625 , 0.00391,       48,        3,       45
IIR, 0.07273, 0.00529,       55,        4,       51
IIS, 0.11538, 0.01331,       78,        9,       69
IIT, 0.11765, 0.01384,       51,        6,       45
IIV, 0.04918, 0.00242,       61,        3,       58
IIW, 0.07692, 0.00592,       13,        1,       12
IIY, 0.0625 , 0.00391,       16,        1,       15
IKI, 0.0625 , 0.00391,       48,        3,       45
IKK, 0.07483, 0.0056 ,      147,       11,      136
IKL, 0.03226, 0.00104,      124,        4,      120
IKM, 0.10526, 0.01108,       38,        4,       34
IKN, 0.10101, 0.0102 ,       99,       10,       89
IKP, 0.02469, 0.00061,       81,        2,       79
IKQ, 0.05814, 0.00338,       86,        5,       81
IKR, 0.02381, 0.00057,       84,        2,       82
IKS, 0.05042, 0.00254,      119,        6,      113
IKT, 0.04819, 0.00232,       83,        4,       79
IKV, 0.08527, 0.00727,      129,       11,      118
IKW, 0.12   , 0.0144 ,       25,        3,       22
IKY, 0.06   , 0.0036 ,       50,        3,       47
IK_, 0.125  , 0.01562,        8,        1,        7
ILI, 0.07143, 0.0051 ,       28,        2,       26
ILK, 0.07971, 0.00635,      138,       11,      127
ILL, 0.08333, 0.00694,      108,        9,       99
ILM, 0      , 0      ,       16,        0,       16
ILN, 0.03883, 0.00151,      103,        4,       99
ILP, 0.09709, 0.00943,      103,       10,       93
ILQ, 0.07059, 0.00498,       85,        6,       79
ILR, 0.09677, 0.00937,       93,        9,       84
ILS, 0.08271, 0.00684,      133,       11,      122
ILT, 0.07071, 0.005  ,       99,        7,       92
ILV, 0.04651, 0.00216,       86,        4,       82
ILW, 0.05263, 0.00277,       19,        1,       18
ILY, 0.10526, 0.01108,       57,        6,       51
IL_, 0.16667, 0.02778,        6,        1,        5
IMI, 0.07692, 0.00592,       13,        1,       12
IMK, 0.12766, 0.0163 ,       47,        6,       41
IML, 0.03704, 0.00137,       27,        1,       26
IMM, 0.09091, 0.00826,       11,        1,       10
IMN, 0.05   , 0.0025 ,       20,        1,       19
IMP, 0.09524, 0.00907,       21,        2,       19
IMQ, 0.25   , 0.0625 ,       24,        6,       18
IMR, 0.07692, 0.00592,       26,        2,       24
IMS, 0.05   , 0.0025 ,       20,        1,       19
IMT, 0.04762, 0.00227,       21,        1,       20
IMV, 0.14286, 0.02041,       14,        2,       12
IMW, 0      , 0      ,        6,        0,        6
IMY, 0.16667, 0.02778,       18,        3,       15
IM_, 0      , 0      ,        6,        0,        6
INI, 0.13889, 0.01929,       36,        5,       31
INK, 0.06593, 0.00435,       91,        6,       85
INL, 0.03636, 0.00132,      110,        4,      106
INM, 0.07895, 0.00623,       38,        3,       35
INN, 0.06329, 0.00401,       79,        5,       74
INP, 0.07692, 0.00592,       65,        5,       60
INQ, 0.05455, 0.00298,       55,        3,       52
INR, 0.04348, 0.00189,       69,        3,       66
INS, 0.04706, 0.00221,       85,        4,       81
INT, 0.07042, 0.00496,       71,        5,       66
INV, 0.11579, 0.01341,       95,       11,       84
INW, 0.09091, 0.00826,       22,        2,       20
INY, 0.125  , 0.01562,       56,        7,       49
IPI, 0.04762, 0.00227,       42,        2,       40
IPK, 0.05333, 0.00284,       75,        4,       71
IPL, 0.02727, 0.00074,      110,        3,      107
IPM, 0.14286, 0.02041,       21,        3,       18
IPN, 0.02128, 0.00045,       47,        1,       46
IPP, 0      , 0      ,       57,        0,       57
IPQ, 0.02326, 0.00054,       43,        1,       42
IPR, 0.05333, 0.00284,       75,        4,       71
IPS, 0.09783, 0.00957,       92,        9,       83
IPT, 0.0303 , 0.00092,       66,        2,       64
IPV, 0.11111, 0.01235,       90,       10,       80
IPW, 0.09091, 0.00826,       11,        1,       10
IPY, 0.075  , 0.00562,       40,        3,       37
IP_, 0      , 0      ,        5,        0,        5
IQI, 0.03448, 0.00119,       29,        1,       28
IQK, 0.05952, 0.00354,       84,        5,       79
IQL, 0.08696, 0.00756,       92,        8,       84
IQM, 0      , 0      ,       21,        0,       21
IQN, 0.02941, 0.00087,       68,        2,       66
IQP, 0.08889, 0.0079 ,       45,        4,       41
IQQ, 0.02564, 0.00066,       78,        2,       76
IQR, 0.09091, 0.00826,       55,        5,       50
IQS, 0.09091, 0.00826,       88,        8,       80
IQT, 0.11321, 0.01282,       53,        6,       47
IQV, 0.01695, 0.00029,       59,        1,       58
IQW, 0.09091, 0.00826,       11,        1,       10
IQY, 0.08824, 0.00779,       34,        3,       31
IQ_, 0      , 0      ,        4,        0,        4
IRI, 0.15789, 0.02493,       38,        6,       32
IRK, 0.08403, 0.00706,      119,       10,      109
IRL, 0.05357, 0.00287,      112,        6,      106
IRM, 0.12821, 0.01644,       39,        5,       34
IRN, 0.15493, 0.024  ,       71,       11,       60
IRP, 0.08955, 0.00802,       67,        6,       61
IRQ, 0.08824, 0.00779,       68,        6,       62
IRR, 0.07792, 0.00607,       77,        6,       71
IRS, 0.06542, 0.00428,      107,        7,      100
IRT, 0.11864, 0.01408,       59,        7,       52
IRV, 0.06173, 0.00381,       81,        5,       76
IRW, 0.08333, 0.00694,       12,        1,       11
IRY, 0.15517, 0.02408,       58,        9,       49
IR_, 0      , 0      ,        2,        0,        2
ISI, 0.14634, 0.02142,       41,        6,       35
ISK, 0.05714, 0.00327,      105,        6,       99
ISL, 0.06667, 0.00444,      120,        8,      112
ISM, 0.09091, 0.00826,       44,        4,       40
ISN, 0.05263, 0.00277,       76,        4,       72
ISP, 0.07407, 0.00549,       81,        6,       75
ISQ, 0.05195, 0.0027 ,       77,        4,       73
ISR, 0.10638, 0.01132,       94,       10,       84
ISS, 0.06422, 0.00412,      109,        7,      102
IST, 0.04598, 0.00211,       87,        4,       83
ISV, 0.06667, 0.00444,       90,        6,       84
ISW, 0      , 0      ,       17,        0,       17
ISY, 0.08451, 0.00714,       71,        6,       65
IS_, 0.25   , 0.0625 ,        4,        1,        3
ITI, 0.02439, 0.00059,       41,        1,       40
ITK, 0.03704, 0.00137,      108,        4,      104
ITL, 0.06061, 0.00367,      132,        8,      124
ITM, 0.05405, 0.00292,       37,        2,       35
ITN, 0.04545, 0.00207,       66,        3,       63
ITP, 0.08333, 0.00694,       84,        7,       77
ITQ, 0.03636, 0.00132,       55,        2,       53
ITR, 0.06667, 0.00444,       75,        5,       70
ITS, 0.04301, 0.00185,       93,        4,       89
ITT, 0.05   , 0.0025 ,       80,        4,       76
ITV, 0.05833, 0.0034 ,      120,        7,      113
ITW, 0.04762, 0.00227,       21,        1,       20
ITY, 0.06349, 0.00403,       63,        4,       59
IT_, 0      , 0      ,        2,        0,        2
IVI, 0.04348, 0.00189,       23,        1,       22
IVK, 0.06316, 0.00399,       95,        6,       89
IVL, 0.03704, 0.00137,       81,        3,       78
IVM, 0.2381 , 0.05669,       21,        5,       16
IVN, 0.06667, 0.00444,       75,        5,       70
IVP, 0.04167, 0.00174,       72,        3,       69
IVQ, 0.07547, 0.0057 ,       53,        4,       49
IVR, 0.05063, 0.00256,       79,        4,       75
IVS, 0.05556, 0.00309,       90,        5,       85
IVT, 0.05405, 0.00292,       74,        4,       70
IVV, 0.08772, 0.00769,       57,        5,       52
IVW, 0      , 0      ,        7,        0,        7
IVY, 0.14286, 0.02041,       21,        3,       18
IV_, 0      , 0      ,        4,        0,        4
IWI, 0.125  , 0.01562,        8,        1,        7
IWK, 0.04348, 0.00189,       23,        1,       22
IWL, 0.09524, 0.00907,       21,        2,       19
IWM, 0.1    , 0.01   ,       10,        1,        9
IWN, 0      , 0      ,       15,        0,       15
IWP, 0.05   , 0.0025 ,       20,        1,       19
IWQ, 0.08333, 0.00694,       12,        1,       11
IWR, 0      , 0      ,       12,        0,       12
IWS, 0      , 0      ,       14,        0,       14
IWT, 0.14815, 0.02195,       27,        4,       23
IWV, 0      , 0      ,       15,        0,       15
IWW, 0      , 0      ,        3,        0,        3
IWY, 0.33333, 0.11111,        9,        3,        6
IYI, 0.15789, 0.02493,       19,        3,       16
IYK, 0.15686, 0.02461,       51,        8,       43
IYL, 0.15789, 0.02493,       57,        9,       48
IYM, 0.05   , 0.0025 ,       20,        1,       19
IYN, 0.16071, 0.02583,       56,        9,       47
IYP, 0.09756, 0.00952,       41,        4,       37
IYQ, 0.05556, 0.00309,       36,        2,       34
IYR, 0.12963, 0.0168 ,       54,        7,       47
IYS, 0.14286, 0.02041,       63,        9,       54
IYT, 0.20588, 0.04239,       34,        7,       27
IYV, 0.11111, 0.01235,       45,        5,       40
IYW, 0      , 0      ,        5,        0,        5
IYY, 0.11765, 0.01384,       34,        4,       30
IY_, 0      , 0      ,        3,        0,        3
KAK, 0      , 0      ,       53,        0,       53
KAL, 0.04348, 0.00189,      184,        8,      176
KAM, 0.02   , 0.0004 ,       50,        1,       49
KAN, 0.04412, 0.00195,       68,        3,       65
KAP, 0.0303 , 0.00092,       66,        2,       64
KAQ, 0.01923, 0.00037,       52,        1,       51
KAR, 0.02469, 0.00061,       81,        2,       79
KAS, 0.03947, 0.00156,       76,        3,       73
KAT, 0.02439, 0.00059,       82,        2,       80
KAV, 0.06897, 0.00476,      116,        8,      108
KAW, 0      , 0      ,       11,        0,       11
KAY, 0.07143, 0.0051 ,       42,        3,       39
KA_, 0      , 0      ,       13,        0,       13
KCK, 0      , 0      ,       14,        0,       14
KCL, 0.07317, 0.00535,       41,        3,       38
KCM, 0.1    , 0.01   ,       10,        1,        9
KCN, 0      , 0      ,       11,        0,       11
KCP, 0.07692, 0.00592,       26,        2,       24
KCQ, 0      , 0      ,       17,        0,       17
KCR, 0.04167, 0.00174,       24,        1,       23
KCS, 0      , 0      ,       20,        0,       20
KCT, 0      , 0      ,       13,        0,       13
KCV, 0.03846, 0.00148,       26,        1,       25
KCY, 0.08333, 0.00694,       12,        1,       11
KC_, 0      , 0      ,        2,        0,        2
KDK, 0.01852, 0.00034,       54,        1,       53
KDL, 0.02041, 0.00042,      196,        4,      192
KDM, 0.07895, 0.00623,       38,        3,       35
KDN, 0.01053, 0.00011,       95,        1,       94
KDP, 0.05556, 0.00309,       90,        5,       85
KDQ, 0.03571, 0.00128,       56,        2,       54
KDR, 0.04938, 0.00244,       81,        4,       77
KDS, 0.03604, 0.0013 ,      111,        4,      107
KDT, 0.02885, 0.00083,      104,        3,      101
KDV, 0.05455, 0.00298,      110,        6,      104
KDW, 0.13043, 0.01701,       23,        3,       20
KDY, 0.04167, 0.00174,       72,        3,       69
KD_, 0      , 0      ,        9,        0,        9
KEK, 0      , 0      ,       84,        0,       84
KEL, 0.02922, 0.00085,      308,        9,      299
KEM, 0.01667, 0.00028,       60,        1,       59
KEN, 0.0098 , 0.0001 ,      102,        1,      101
KEP, 0      , 0      ,       78,        0,       78
KEQ, 0.03371, 0.00114,       89,        3,       86
KER, 0.06796, 0.00462,      103,        7,       96
KES, 0.01709, 0.00029,      117,        2,      115
KET, 0.04762, 0.00227,      105,        5,      100
KEV, 0.04396, 0.00193,      182,        8,      174
KEW, 0.03125, 0.00098,       32,        1,       31
KEY, 0.02597, 0.00067,       77,        2,       75
KE_, 0.08333, 0.00694,       12,        1,       11
KFK, 0      , 0      ,       27,        0,       27
KFL, 0.12048, 0.01452,       83,       10,       73
KFM, 0.33333, 0.11111,       21,        7,       14
KFN, 0.07812, 0.0061 ,       64,        5,       59
KFP, 0.2093 , 0.04381,       43,        9,       34
KFQ, 0.05   , 0.0025 ,       40,        2,       38
KFR, 0.175  , 0.03062,       40,        7,       33
KFS, 0.07692, 0.00592,       52,        4,       48
KFT, 0.08511, 0.00724,       47,        4,       43
KFV, 0.08333, 0.00694,       60,        5,       55
KFW, 0      , 0      ,       11,        0,       11
KFY, 0.22   , 0.0484 ,       50,       11,       39
KF_, 0      , 0      ,        2,        0,        2
KGK, 0.0625 , 0.00391,       64,        4,       60
KGL, 0.03817, 0.00146,      131,        5,      126
KGM, 0.1    , 0.01   ,       40,        4,       36
KGN, 0.04167, 0.00174,       96,        4,       92
KGP, 0.01538, 0.00024,       65,        1,       64
KGQ, 0.01515, 0.00023,       66,        1,       65
KGR, 0.05556, 0.00309,       72,        4,       68
KGS, 0.02632, 0.00069,      114,        3,      111
KGT, 0.0177 , 0.00031,      113,        2,      111
KGV, 0.05   , 0.0025 ,      100,        5,       95
KGW, 0.07692, 0.00592,       13,        1,       12
KGY, 0.01389, 0.00019,       72,        1,       71
KG_, 0      , 0      ,       13,        0,       13
KHK, 0.05882, 0.00346,       17,        1,       16
KHL, 0.12308, 0.01515,       65,        8,       57
KHM, 0.04762, 0.00227,       21,        1,       20
KHN, 0.04   , 0.0016 ,       25,        1,       24
KHP, 0.04167, 0.00174,       24,        1,       23
KHQ, 0.05882, 0.00346,       17,        1,       16
KHR, 0.03571, 0.00128,       28,        1,       27
KHS, 0.05128, 0.00263,       39,        2,       37
KHT, 0.09524, 0.00907,       21,        2,       19
KHV, 0.15217, 0.02316,       46,        7,       39
KHW, 0      , 0      ,        7,        0,        7
KHY, 0.13333, 0.01778,       30,        4,       26
KH_, 0      , 0      ,        3,        0,        3
KIK, 0.08   , 0.0064 ,       50,        4,       46
KIL, 0.08   , 0.0064 ,      125,       10,      115
KIM, 0.03571, 0.00128,       28,        1,       27
KIN, 0.11594, 0.01344,       69,        8,       61
KIP, 0.01493, 0.00022,       67,        1,       66
KIQ, 0.05556, 0.00309,       54,        3,       51
KIR, 0.01282, 0.00016,       78,        1,       77
KIS, 0.09877, 0.00975,       81,        8,       73
KIT, 0.04545, 0.00207,       66,        3,       63
KIV, 0.04494, 0.00202,       89,        4,       85
KIW, 0.25   , 0.0625 ,       16,        4,       12
KIY, 0.09302, 0.00865,       43,        4,       39
KI_, 0      , 0      ,        7,        0,        7
KKK, 0.04545, 0.00207,       66,        3,       63
KKL, 0.04527, 0.00205,      243,       11,      232
KKM, 0.05882, 0.00346,       51,        3,       48
KKN, 0.02597, 0.00067,       77,        2,       75
KKP, 0.05   , 0.0025 ,       60,        3,       57
KKQ, 0.03333, 0.00111,       60,        2,       58
KKR, 0.0375 , 0.00141,       80,        3,       77
KKS, 0.02469, 0.00061,       81,        2,       79
KKT, 0.02105, 0.00044,       95,        2,       93
KKV, 0.03571, 0.00128,      140,        5,      135
KKW, 0.04878, 0.00238,       41,        2,       39
KKY, 0.06329, 0.00401,       79,        5,       74
KK_, 0.05263, 0.00277,       19,        1,       18
KLK, 0.11538, 0.01331,       78,        9,       69
KLL, 0.11066, 0.01224,      244,       27,      217
KLM, 0.06122, 0.00375,       49,        3,       46
KLN, 0.05426, 0.00294,      129,        7,      122
KLP, 0.0303 , 0.00092,       99,        3,       96
KLQ, 0.06542, 0.00428,      107,        7,      100
KLR, 0.03448, 0.00119,      116,        4,      112
KLS, 0.08088, 0.00654,      136,       11,      125
KLT, 0.06452, 0.00416,      124,        8,      116
KLV, 0.07273, 0.00529,      165,       12,      153
KLW, 0.14286, 0.02041,       21,        3,       18
KLY, 0.09195, 0.00846,       87,        8,       79
KL_, 0      , 0      ,       12,        0,       12
KMK, 0.24   , 0.0576 ,       25,        6,       19
KML, 0.03846, 0.00148,       52,        2,       50
KMM, 0.125  , 0.01562,       16,        2,       14
KMN, 0.13636, 0.0186 ,       22,        3,       19
KMP, 0      , 0      ,       18,        0,       18
KMQ, 0.08333, 0.00694,       24,        2,       22
KMR, 0.09091, 0.00826,       22,        2,       20
KMS, 0.05556, 0.00309,       36,        2,       34
KMT, 0.0625 , 0.00391,       32,        2,       30
KMV, 0      , 0      ,       32,        0,       32
KMW, 0      , 0      ,        5,        0,        5
KMY, 0.05882, 0.00346,       17,        1,       16
KM_, 0      , 0      ,       18,        0,       18
KNK, 0      , 0      ,       47,        0,       47
KNL, 0.02778, 0.00077,      144,        4,      140
KNM, 0.025  , 0.00063,       40,        1,       39
KNN, 0.06452, 0.00416,       62,        4,       58
KNP, 0.07143, 0.0051 ,       56,        4,       52
KNQ, 0.01887, 0.00036,       53,        1,       52
KNR, 0.01754, 0.00031,       57,        1,       56
KNS, 0.05   , 0.0025 ,       80,        4,       76
KNT, 0.06667, 0.00444,       60,        4,       56
KNV, 0.05495, 0.00302,       91,        5,       86
KNW, 0.04762, 0.00227,       21,        1,       20
KNY, 0.10204, 0.01041,       49,        5,       44
KN_, 0      , 0      ,        7,        0,        7
KPK, 0      , 0      ,       33,        0,       33
KPL, 0.04724, 0.00223,      127,        6,      121
KPM, 0.06897, 0.00476,       29,        2,       27
KPN, 0.05172, 0.00268,       58,        3,       55
KPP, 0.02083, 0.00043,       48,        1,       47
KPQ, 0.05556, 0.00309,       36,        2,       34
KPR, 0.05455, 0.00298,       55,        3,       52
KPS, 0.02778, 0.00077,       72,        2,       70
KPT, 0.07692, 0.00592,       65,        5,       60
KPV, 0.02151, 0.00046,       93,        2,       91
KPW, 0.07143, 0.0051 ,       14,        1,       13
KPY, 0      , 0      ,       40,        0,       40
KP_, 0      , 0      ,        9,        0,        9
KQK, 0.07407, 0.00549,       27,        2,       25
KQL, 0.05512, 0.00304,      127,        7,      120
KQM, 0.13793, 0.01902,       29,        4,       25
KQN, 0.02703, 0.00073,       37,        1,       36
KQP, 0.02632, 0.00069,       38,        1,       37
KQQ, 0.01613, 0.00026,       62,        1,       61
KQR, 0.02381, 0.00057,       42,        1,       41
KQS, 0.05797, 0.00336,       69,        4,       65
KQT, 0.04762, 0.00227,       42,        2,       40
KQV, 0.06098, 0.00372,       82,        5,       77
KQW, 0.05263, 0.00277,       19,        1,       18
KQY, 0.06667, 0.00444,       45,        3,       42
KQ_, 0      , 0      ,        6,        0,        6
KRK, 0.06   , 0.0036 ,       50,        3,       47
KRL, 0.01974, 0.00039,      152,        3,      149
KRM, 0.02564, 0.00066,       39,        1,       38
KRN, 0.12195, 0.01487,       41,        5,       36
KRP, 0.04348, 0.00189,       46,        2,       44
KRQ, 0.075  , 0.00562,       40,        3,       37
KRR, 0.05195, 0.0027 ,       77,        4,       73
KRS, 0.13253, 0.01756,       83,       11,       72
KRT, 0.07407, 0.00549,       81,        6,       75
KRV, 0.05495, 0.00302,       91,        5,       86
KRW, 0.11429, 0.01306,       35,        4,       31
KRY, 0.05556, 0.00309,       54,        3,       51
KR_, 0.125  , 0.01562,       16,        2,       14
KSK, 0.04082, 0.00167,       49,        2,       47
KSL, 0.01807, 0.00033,      166,        3,      163
KSM, 0.05714, 0.00327,       35,        2,       33
KSN, 0.08065, 0.0065 ,       62,        5,       57
KSP, 0.01235, 0.00015,       81,        1,       80
KSQ, 0.02   , 0.0004 ,       50,        1,       49
KSR, 0.04286, 0.00184,       70,        3,       67
KSS, 0.03488, 0.00122,       86,        3,       83
KST, 0.03659, 0.00134,       82,        3,       79
KSV, 0.0122 , 0.00015,       82,        1,       81
KSW, 0      , 0      ,       21,        0,       21
KSY, 0.04545, 0.00207,       66,        3,       63
KS_, 0      , 0      ,       12,        0,       12
KTK, 0      , 0      ,       43,        0,       43
KTL, 0.05028, 0.00253,      179,        9,      170
KTM, 0.03571, 0.00128,       28,        1,       27
KTN, 0.06557, 0.0043 ,       61,        4,       57
KTP, 0.01163, 0.00014,       86,        1,       85
KTQ, 0.05556, 0.00309,       54,        3,       51
KTR, 0.03448, 0.00119,       58,        2,       56
KTS, 0.04167, 0.00174,       72,        3,       69
KTT, 0.08235, 0.00678,       85,        7,       78
KTV, 0.08333, 0.00694,       96,        8,       88
KTW, 0      , 0      ,       22,        0,       22
KTY, 0.05797, 0.00336,       69,        4,       65
KT_, 0      , 0      ,        5,        0,        5
KVK, 0.12   , 0.0144 ,       50,        6,       44
KVL, 0.05612, 0.00315,      196,       11,      185
KVM, 0.14706, 0.02163,       34,        5,       29
KVN, 0.05634, 0.00317,       71,        4,       67
KVP, 0.04286, 0.00184,       70,        3,       67
KVQ, 0.04348, 0.00189,       46,        2,       44
KVR, 0.07042, 0.00496,       71,        5,       66
KVS, 0.05556, 0.00309,      108,        6,      102
KVT, 0.03261, 0.00106,       92,        3,       89
KVV, 0.07812, 0.0061 ,      128,       10,      118
KVW, 0.13636, 0.0186 ,       22,        3,       19
KVY, 0.06522, 0.00425,       46,        3,       43
KV_, 0      , 0      ,        3,        0,        3
KWK, 0.33333, 0.11111,       12,        4,        8
KWL, 0.11538, 0.01331,       26,        3,       23
KWM, 0.11111, 0.01235,        9,        1,        8
KWN, 0.11111, 0.01235,       18,        2,       16
KWP, 0      , 0      ,        8,        0,        8
KWQ, 0.125  , 0.01562,       16,        2,       14
KWR, 0.38889, 0.15123,       18,        7,       11
KWS, 0.05263, 0.00277,       19,        1,       18
KWT, 0.22222, 0.04938,        9,        2,        7
KWV, 0.25   , 0.0625 ,       32,        8,       24
KWW, 0.1    , 0.01   ,       10,        1,        9
KWY, 0.11765, 0.01384,       17,        2,       15
KW_, 0      , 0      ,        2,        0,        2
KYK, 0.02778, 0.00077,       36,        1,       35
KYL, 0.06977, 0.00487,       86,        6,       80
KYM, 0      , 0      ,       18,        0,       18
KYN, 0.11538, 0.01331,       52,        6,       46
KYP, 0.06452, 0.00416,       31,        2,       29
KYQ, 0.01923, 0.00037,       52,        1,       51
KYR, 0.18966, 0.03597,       58,       11,       47
KYS, 0.01449, 0.00021,       69,        1,       68
KYT, 0.09434, 0.0089 ,       53,        5,       48
KYV, 0.03571, 0.00128,       56,        2,       54
KYW, 0      , 0      ,       16,        0,       16
KYY, 0.17742, 0.03148,       62,       11,       51
LAL, 0.05376, 0.00289,       93,        5,       88
LAM, 0.04545, 0.00207,       44,        2,       42
LAN, 0.03448, 0.00119,      116,        4,      112
LAP, 0.1    , 0.01   ,      140,       14,      126
LAQ, 0.05143, 0.00264,      175,        9,      166
LAR, 0.03597, 0.00129,      139,        5,      134
LAS, 0.04   , 0.0016 ,      175,        7,      168
LAT, 0.05147, 0.00265,      136,        7,      129
LAV, 0.05072, 0.00257,      138,        7,      131
LAW, 0.03226, 0.00104,       31,        1,       30
LAY, 0.07843, 0.00615,       51,        4,       47
LA_, 0      , 0      ,        8,        0,        8
LCL, 0.10345, 0.0107 ,       29,        3,       26
LCM, 0      , 0      ,        7,        0,        7
LCN, 0.07407, 0.00549,       27,        2,       25
LCP, 0.125  , 0.01562,       24,        3,       21
LCQ, 0.03448, 0.00119,       29,        1,       28
LCR, 0.02381, 0.00057,       42,        1,       41
LCS, 0.05882, 0.00346,       34,        2,       32
LCT, 0.05882, 0.00346,       34,        2,       32
LCV, 0.06897, 0.00476,       29,        2,       27
LCW, 0      , 0      ,        1,        0,        1
LCY, 0      , 0      ,       25,        0,       25
LC_, 0      , 0      ,        2,        0,        2
LDL, 0.06742, 0.00454,       89,        6,       83
LDM, 0.08065, 0.0065 ,       62,        5,       57
LDN, 0.032  , 0.00102,      125,        4,      121
LDP, 0.05844, 0.00342,      154,        9,      145
LDQ, 0.06195, 0.00384,      113,        7,      106
LDR, 0.0559 , 0.00312,      161,        9,      152
LDS, 0.09341, 0.00872,      182,       17,      165
LDT, 0.05926, 0.00351,      135,        8,      127
LDV, 0.05682, 0.00323,      176,       10,      166
LDW, 0.06667, 0.00444,       30,        2,       28
LDY, 0.07407, 0.00549,       81,        6,       75
LD_, 0      , 0      ,        7,        0,        7
LEL, 0.04412, 0.00195,      136,        6,      130
LEM, 0.03125, 0.00098,       64,        2,       62
LEN, 0.05143, 0.00264,      175,        9,      166
LEP, 0.06081, 0.0037 ,      148,        9,      139
LEQ, 0.08333, 0.00694,      180,       15,      165
LER, 0.04046, 0.00164,      173,        7,      166
LES, 0.04046, 0.00164,      173,        7,      166
LET, 0.04242, 0.0018 ,      165,        7,      158
LEV, 0.04523, 0.00205,      199,        9,      190
LEW, 0.03704, 0.00137,       27,        1,       26
LEY, 0.0241 , 0.00058,       83,        2,       81
LE_, 0.1    , 0.01   ,       20,        2,       18
LFL, 0.12281, 0.01508,       57,        7,       50
LFM, 0.09524, 0.00907,       21,        2,       19
LFN, 0.08197, 0.00672,       61,        5,       56
LFP, 0.13235, 0.01752,       68,        9,       59
LFQ, 0.06154, 0.00379,       65,        4,       61
LFR, 0.09412, 0.00886,       85,        8,       77
LFS, 0.04902, 0.0024 ,      102,        5,       97
LFT, 0.06061, 0.00367,       66,        4,       62
LFV, 0.10127, 0.01025,       79,        8,       71
LFW, 0      , 0      ,        6,        0,        6
LFY, 0.15385, 0.02367,       52,        8,       44
LF_, 0.28571, 0.08163,        7,        2,        5
LGL, 0.08257, 0.00682,      109,        9,      100
LGM, 0.06383, 0.00407,       47,        3,       44
LGN, 0.0354 , 0.00125,      113,        4,      109
LGP, 0.01136, 0.00013,       88,        1,       87
LGQ, 0.03371, 0.00114,       89,        3,       86
LGR, 0.04225, 0.00179,      142,        6,      136
LGS, 0.02286, 0.00052,      175,        4,      171
LGT, 0.048  , 0.0023 ,      125,        6,      119
LGV, 0.10526, 0.01108,      114,       12,      102
LGW, 0      , 0      ,       28,        0,       28
LGY, 0.04938, 0.00244,       81,        4,       77
LG_, 0      , 0      ,       14,        0,       14
LHL, 0.03704, 0.00137,       54,        2,       52
LHM, 0      , 0      ,       22,        0,       22
LHN, 0.09677, 0.00937,       62,        6,       56
LHP, 0.07273, 0.00529,       55,        4,       51
LHQ, 0.06061, 0.00367,       66,        4,       62
LHR, 0.03896, 0.00152,       77,        3,       74
LHS, 0.10667, 0.01138,       75,        8,       67
LHT, 0.10417, 0.01085,       48,        5,       43
LHV, 0.0625 , 0.00391,       64,        4,       60
LHW, 0.25   , 0.0625 ,        8,        2,        6
LHY, 0.10417, 0.01085,       48,        5,       43
LH_, 0      , 0      ,        2,        0,        2
LIL, 0.15789, 0.02493,       57,        9,       48
LIM, 0.03333, 0.00111,       30,        1,       29
LIN, 0.11111, 0.01235,       90,       10,       80
LIP, 0.07216, 0.00521,       97,        7,       90
LIQ, 0.07778, 0.00605,       90,        7,       83
LIR, 0.06931, 0.0048 ,      101,        7,       94
LIS, 0.04412, 0.00195,      136,        6,      130
LIT, 0.06061, 0.00367,       99,        6,       93
LIV, 0.04598, 0.00211,       87,        4,       83
LIW, 0.2    , 0.04   ,       15,        3,       12
LIY, 0.06977, 0.00487,       43,        3,       40
LI_, 0.14286, 0.02041,        7,        1,        6
LKL, 0.05426, 0.00294,      129,        7,      122
LKM, 0.04918, 0.00242,       61,        3,       58
LKN, 0.10145, 0.01029,      138,       14,      124
LKP, 0.0431 , 0.00186,      116,        5,      111
LKQ, 0.04762, 0.00227,      126,        6,      120
LKR, 0.08125, 0.0066 ,      160,       13,      147
LKS, 0.07477, 0.00559,      214,       16,      198
LKT, 0.02907, 0.00085,      172,        5,      167
LKV, 0.04469, 0.002  ,      179,        8,      171
LKW, 0.0625 , 0.00391,       48,        3,       45
LKY, 0.09639, 0.00929,       83,        8,       75
LK_, 0.04545, 0.00207,       22,        1,       21
LLL, 0.0678 , 0.0046 ,      118,        8,      110
LLM, 0.09434, 0.0089 ,       53,        5,       48
LLN, 0.04839, 0.00234,      186,        9,      177
LLP, 0.0565 , 0.00319,      177,       10,      167
LLQ, 0.0929 , 0.00863,      183,       17,      166
LLR, 0.08602, 0.0074 ,      186,       16,      170
LLS, 0.06222, 0.00387,      225,       14,      211
LLT, 0.08671, 0.00752,      173,       15,      158
LLV, 0.11765, 0.01384,      136,       16,      120
LLW, 0.04167, 0.00174,       24,        1,       23
LLY, 0.06757, 0.00457,       74,        5,       69
LL_, 0      , 0      ,        8,        0,        8
LML, 0.13636, 0.0186 ,       22,        3,       19
LMM, 0.29412, 0.08651,       17,        5,       12
LMN, 0.11628, 0.01352,       43,        5,       38
LMP, 0.0303 , 0.00092,       33,        1,       32
LMQ, 0.06   , 0.0036 ,       50,        3,       47
LMR, 0.02174, 0.00047,       46,        1,       45
LMS, 0.09836, 0.00967,       61,        6,       55
LMT, 0.10811, 0.01169,       37,        4,       33
LMV, 0.17073, 0.02915,       41,        7,       34
LMW, 0      , 0      ,        6,        0,        6
LMY, 0      , 0      ,       17,        0,       17
LM_, 0.1    , 0.01   ,       10,        1,        9
LNL, 0.03158, 0.001  ,       95,        3,       92
LNM, 0.08108, 0.00657,       37,        3,       34
LNN, 0.06015, 0.00362,      133,        8,      125
LNP, 0.05882, 0.00346,      119,        7,      112
LNQ, 0.06329, 0.00401,       79,        5,       74
LNR, 0.07563, 0.00572,      119,        9,      110
LNS, 0.10959, 0.01201,      146,       16,      130
LNT, 0.04587, 0.0021 ,      109,        5,      104
LNV, 0.05512, 0.00304,      127,        7,      120
LNW, 0.13043, 0.01701,       23,        3,       20
LNY, 0.02778, 0.00077,       72,        2,       70
LN_, 0      , 0      ,       11,        0,       11
LPL, 0.01163, 0.00014,       86,        1,       85
LPM, 0.04545, 0.00207,       22,        1,       21
LPN, 0.07609, 0.00579,       92,        7,       85
LPP, 0.03289, 0.00108,      152,        5,      147
LPQ, 0.02353, 0.00055,       85,        2,       83
LPR, 0.04808, 0.00231,      104,        5,       99
LPS, 0.03759, 0.00141,      133,        5,      128
LPT, 0.06838, 0.00468,      117,        8,      109
LPV, 0.0375 , 0.00141,      160,        6,      154
LPW, 0.08333, 0.00694,       36,        3,       33
LPY, 0.04918, 0.00242,       61,        3,       58
LP_, 0.09091, 0.00826,       11,        1,       10
LQL, 0.1134 , 0.01286,       97,       11,       86
LQM, 0      , 0      ,       49,        0,       49
LQN, 0.09804, 0.00961,      102,       10,       92
LQP, 0.03797, 0.00144,       79,        3,       76
LQQ, 0.03521, 0.00124,      142,        5,      137
LQR, 0.06557, 0.0043 ,      122,        8,      114
LQS, 0.04698, 0.00221,      149,        7,      142
LQT, 0.02062, 0.00043,       97,        2,       95
LQV, 0.06338, 0.00402,      142,        9,      133
LQW, 0.0303 , 0.00092,       33,        1,       32
LQY, 0.03659, 0.00134,       82,        3,       79
LQ_, 0.16667, 0.02778,        6,        1,        5
LRL, 0.12605, 0.01589,      119,       15,      104
LRM, 0.10909, 0.0119 ,       55,        6,       49
LRN, 0.11278, 0.01272,      133,       15,      118
LRP, 0.10256, 0.01052,      117,       12,      105
LRQ, 0.07563, 0.00572,      119,        9,      110
LRR, 0.10811, 0.01169,      148,       16,      132
LRS, 0.05978, 0.00357,      184,       11,      173
LRT, 0.10092, 0.01018,      109,       11,       98
LRV, 0.03825, 0.00146,      183,        7,      176
LRW, 0.02941, 0.00087,       34,        1,       33
LRY, 0.09375, 0.00879,       96,        9,       87
LR_, 0      , 0      ,        5,        0,        5
LSL, 0.125  , 0.01562,      120,       15,      105
LSM, 0.02083, 0.00043,       48,        1,       47
LSN, 0.06034, 0.00364,      116,        7,      109
LSP, 0.04605, 0.00212,      152,        7,      145
LSQ, 0.02759, 0.00076,      145,        4,      141
LSR, 0.025  , 0.00063,      160,        4,      156
LSS, 0.07042, 0.00496,      213,       15,      198
LST, 0.08511, 0.00724,      141,       12,      129
LSV, 0.02041, 0.00042,      147,        3,      144
LSW, 0.08571, 0.00735,       35,        3,       32
LSY, 0.05556, 0.00309,       72,        4,       68
LS_, 0.08696, 0.00756,       23,        2,       21
LTL, 0.03409, 0.00116,       88,        3,       85
LTM, 0.04   , 0.0016 ,       50,        2,       48
LTN, 0.07438, 0.00553,      121,        9,      112
LTP, 0      , 0      ,      162,        0,      162
LTQ, 0.02752, 0.00076,      109,        3,      106
LTR, 0.04545, 0.00207,      110,        5,      105
LTS, 0.08276, 0.00685,      145,       12,      133
LTT, 0.05926, 0.00351,      135,        8,      127
LTV, 0.05914, 0.0035 ,      186,       11,      175
LTW, 0.06452, 0.00416,       31,        2,       29
LTY, 0.06098, 0.00372,       82,        5,       77
LT_, 0      , 0      ,        3,        0,        3
LVL, 0.05556, 0.00309,       90,        5,       85
LVM, 0.08511, 0.00724,       47,        4,       43
LVN, 0.05319, 0.00283,       94,        5,       89
LVP, 0.02326, 0.00054,      129,        3,      126
LVQ, 0.04959, 0.00246,      121,        6,      115
LVR, 0.06627, 0.00439,      166,       11,      155
LVS, 0.06329, 0.00401,      158,       10,      148
LVT, 0.07407, 0.00549,      135,       10,      125
LVV, 0.08264, 0.00683,      121,       10,      111
LVW, 0      , 0      ,       11,        0,       11
LVY, 0.06667, 0.00444,       45,        3,       42
LV_, 0.16667, 0.02778,        6,        1,        5
LWL, 0.125  , 0.01562,       16,        2,       14
LWM, 0      , 0      ,        7,        0,        7
LWN, 0.17391, 0.03025,       23,        4,       19
LWP, 0.125  , 0.01562,       24,        3,       21
LWQ, 0.11538, 0.01331,       26,        3,       23
LWR, 0      , 0      ,       28,        0,       28
LWS, 0.23333, 0.05444,       30,        7,       23
LWT, 0.07407, 0.00549,       27,        2,       25
LWV, 0.25   , 0.0625 ,       24,        6,       18
LWW, 0.11111, 0.01235,        9,        1,        8
LWY, 0.15789, 0.02493,       19,        3,       16
LYL, 0.16129, 0.02601,       62,       10,       52
LYM, 0.19231, 0.03698,       26,        5,       21
LYN, 0.10345, 0.0107 ,       87,        9,       78
LYP, 0.1039 , 0.01079,       77,        8,       69
LYQ, 0.06557, 0.0043 ,       61,        4,       57
LYR, 0.14286, 0.02041,       98,       14,       84
LYS, 0.08257, 0.00682,      109,        9,      100
LYT, 0.10256, 0.01052,       78,        8,       70
LYV, 0.07595, 0.00577,       79,        6,       73
LYW, 0.13333, 0.01778,       15,        2,       13
LYY, 0.17647, 0.03114,       68,       12,       56
LY_, 0      , 0      ,        6,        0,        6
MAM, 0      , 0      ,        6,        0,        6
MAN, 0      , 0      ,       17,        0,       17
MAP, 0.06452, 0.00416,       31,        2,       29
MAQ, 0      , 0      ,       31,        0,       31
MAR, 0      , 0      ,       34,        0,       34
MAS, 0      , 0      ,       39,        0,       39
MAT, 0.05882, 0.00346,       34,        2,       32
MAV, 0.04762, 0.00227,       42,        2,       40
MAW, 0      , 0      ,        7,        0,        7
MAY, 0.09524, 0.00907,       21,        2,       19
MA_, 0.08333, 0.00694,       12,        1,       11
MCN, 0      , 0      ,        6,        0,        6
MCP, 0      , 0      ,        6,        0,        6
MCQ, 0      , 0      ,        6,        0,        6
MCR, 0.4    , 0.16   ,        5,        2,        3
MCS, 0      , 0      ,        8,        0,        8
MCT, 0      , 0      ,        6,        0,        6
MCV, 0      , 0      ,        5,        0,        5
MC_, 0.33333, 0.11111,        3,        1,        2
MDM, 0.16667, 0.02778,        6,        1,        5
MDN, 0      , 0      ,       22,        0,       22
MDP, 0.02857, 0.00082,       35,        1,       34
MDQ, 0.02564, 0.00066,       39,        1,       38
MDR, 0.12963, 0.0168 ,       54,        7,       47
MDS, 0.07317, 0.00535,       41,        3,       38
MDT, 0.02703, 0.00073,       37,        1,       36
MDV, 0.02778, 0.00077,       36,        1,       35
MDW, 0.11111, 0.01235,        9,        1,        8
MDY, 0.03448, 0.00119,       29,        1,       28
MD_, 0      , 0      ,        1,        0,        1
MEM, 0.08333, 0.00694,       12,        1,       11
MEN, 0.05263, 0.00277,       38,        2,       36
MEP, 0.09375, 0.00879,       32,        3,       29
MEQ, 0      , 0      ,       38,        0,       38
MER, 0      , 0      ,       40,        0,       40
MES, 0.04545, 0.00207,       44,        2,       42
MET, 0.0625 , 0.00391,       32,        2,       30
MEV, 0.03704, 0.00137,       54,        2,       52
MEW, 0.09091, 0.00826,       11,        1,       10
MEY, 0.09677, 0.00937,       31,        3,       28
ME_, 0      , 0      ,        1,        0,        1
MFM, 0      , 0      ,        3,        0,        3
MFN, 0.16667, 0.02778,       18,        3,       15
MFP, 0.125  , 0.01562,        8,        1,        7
MFQ, 0      , 0      ,        7,        0,        7
MFR, 0.25   , 0.0625 ,       20,        5,       15
MFS, 0.08333, 0.00694,       24,        2,       22
MFT, 0.05882, 0.00346,       17,        1,       16
MFV, 0.125  , 0.01562,       16,        2,       14
MFW, 0.16667, 0.02778,        6,        1,        5
MFY, 0.23077, 0.05325,       13,        3,       10
MF_, 0      , 0      ,        2,        0,        2
MGM, 0      , 0      ,        5,        0,        5
MGN, 0.04167, 0.00174,       24,        1,       23
MGP, 0.13636, 0.0186 ,       44,        6,       38
MGQ, 0.06897, 0.00476,       29,        2,       27
MGR, 0      , 0      ,       24,        0,       24
MGS, 0.02564, 0.00066,       39,        1,       38
MGT, 0.22581, 0.05099,       31,        7,       24
MGV, 0.05556, 0.00309,       36,        2,       34
MGW, 0.3    , 0.09   ,       10,        3,        7
MGY, 0      , 0      ,        9,        0,        9
MG_, 0      , 0      ,        5,        0,        5
MHM, 0      , 0      ,        3,        0,        3
MHN, 0      , 0      ,        6,        0,        6
MHP, 0.0625 , 0.00391,       16,        1,       15
MHQ, 0.125  , 0.01562,       16,        2,       14
MHR, 0.08333, 0.00694,       12,        1,       11
MHS, 0      , 0      ,       38,        0,       38
MHT, 0      , 0      ,        8,        0,        8
MHV, 0      , 0      ,       10,        0,       10
MHW, 0.6    , 0.36   ,        5,        3,        2
MHY, 0      , 0      ,        7,        0,        7
MH_, 0      , 0      ,        8,        0,        8
MIM, 0      , 0      ,        3,        0,        3
MIN, 0.10714, 0.01148,       28,        3,       25
MIP, 0.05   , 0.0025 ,       20,        1,       19
MIQ, 0.04   , 0.0016 ,       25,        1,       24
MIR, 0.10345, 0.0107 ,       29,        3,       26
MIS, 0.03571, 0.00128,       28,        1,       27
MIT, 0.03704, 0.00137,       27,        1,       26
MIV, 0.08696, 0.00756,       23,        2,       21
MIW, 0.2    , 0.04   ,        5,        1,        4
MIY, 0.125  , 0.01562,        8,        1,        7
MKM, 0.11111, 0.01235,        9,        1,        8
MKN, 0.03448, 0.00119,       29,        1,       28
MKP, 0.02941, 0.00087,       34,        1,       33
MKQ, 0.05405, 0.00292,       37,        2,       35
MKR, 0.05556, 0.00309,       36,        2,       34
MKS, 0.08108, 0.00657,       37,        3,       34
MKT, 0.0303 , 0.00092,       33,        1,       32
MKV, 0.07692, 0.00592,       39,        3,       36
MKW, 0      , 0      ,        9,        0,        9
MKY, 0      , 0      ,       24,        0,       24
MK_, 0      , 0      ,        3,        0,        3
MLM, 0      , 0      ,        9,        0,        9
MLN, 0.06818, 0.00465,       44,        3,       41
MLP, 0.10256, 0.01052,       39,        4,       35
MLQ, 0.09302, 0.00865,       43,        4,       39
MLR, 0      , 0      ,       36,        0,       36
MLS, 0.02326, 0.00054,       43,        1,       42
MLT, 0.06452, 0.00416,       31,        2,       29
MLV, 0.06977, 0.00487,       43,        3,       40
MLW, 0      , 0      ,        6,        0,        6
MLY, 0.08696, 0.00756,       23,        2,       21
ML_, 1      , 1      ,        2,        2,        0
MMM, 0      , 0      ,        1,        0,        1
MMN, 0.17647, 0.03114,       17,        3,       14
MMP, 0.2    , 0.04   ,        5,        1,        4
MMQ, 0.35294, 0.12457,       17,        6,       11
MMR, 0.07143, 0.0051 ,       14,        1,       13
MMS, 0.14286, 0.02041,       14,        2,       12
MMT, 0.28571, 0.08163,       14,        4,       10
MMV, 0.1875 , 0.03516,       16,        3,       13
MMW, 0.5    , 0.25   ,        2,        1,        1
MMY, 0.25   , 0.0625 ,        8,        2,        6
MM_, 0      , 0      ,        1,        0,        1
MNM, 0      , 0      ,        3,        0,        3
MNN, 0.29412, 0.08651,       17,        5,       12
MNP, 0      , 0      ,       24,        0,       24
MNQ, 0      , 0      ,       22,        0,       22
MNR, 0.04545, 0.00207,       22,        1,       21
MNS, 0.05263, 0.00277,       38,        2,       36
MNT, 0.12   , 0.0144 ,       25,        3,       22
MNV, 0.03571, 0.00128,       28,        1,       27
MNW, 0      , 0      ,        8,        0,        8
MNY, 0.11111, 0.01235,        9,        1,        8
MN_, 0      , 0      ,        3,        0,        3
MPM, 0.6    , 0.36   ,        5,        3,        2
MPN, 0      , 0      ,       24,        0,       24
MPP, 0.06667, 0.00444,       15,        1,       14
MPQ, 0.1    , 0.01   ,       10,        1,        9
MPR, 0.09524, 0.00907,       21,        2,       19
MPS, 0.03125, 0.00098,       32,        1,       31
MPT, 0.10526, 0.01108,       19,        2,       17
MPV, 0.05882, 0.00346,       34,        2,       32
MPW, 0      , 0      ,        8,        0,        8
MPY, 0      , 0      ,        4,        0,        4
MP_, 0      , 0      ,        3,        0,        3
MQM, 0.28571, 0.08163,        7,        2,        5
MQN, 0      , 0      ,       21,        0,       21
MQP, 0.04167, 0.00174,       24,        1,       23
MQQ, 0.08696, 0.00756,       23,        2,       21
MQR, 0.14286, 0.02041,       28,        4,       24
MQS, 0.08   , 0.0064 ,       25,        2,       23
MQT, 0.11111, 0.01235,       27,        3,       24
MQV, 0.11429, 0.01306,       35,        4,       31
MQW, 0      , 0      ,        4,        0,        4
MQY, 0      , 0      ,       12,        0,       12
MQ_, 0      , 0      ,        4,        0,        4
MRM, 0      , 0      ,        7,        0,        7
MRN, 0.13333, 0.01778,       15,        2,       13
MRP, 0.0625 , 0.00391,       16,        1,       15
MRQ, 0.05556, 0.00309,       36,        2,       34
MRR, 0.17647, 0.03114,       34,        6,       28
MRS, 0.03333, 0.00111,       30,        1,       29
MRT, 0.12   , 0.0144 ,       25,        3,       22
MRV, 0.09756, 0.00952,       41,        4,       37
MRW, 0      , 0      ,        6,        0,        6
MRY, 0.21053, 0.04432,       19,        4,       15
MR_, 0      , 0      ,        2,        0,        2
MSM, 0      , 0      ,        5,        0,        5
MSN, 0      , 0      ,       19,        0,       19
MSP, 0.03226, 0.00104,       31,        1,       30
MSQ, 0.05263, 0.00277,       19,        1,       18
MSR, 0.05405, 0.00292,       37,        2,       35
MSS, 0.09756, 0.00952,       41,        4,       37
MST, 0.14286, 0.02041,       35,        5,       30
MSV, 0.05128, 0.00263,       39,        2,       37
MSW, 0      , 0      ,        5,        0,        5
MSY, 0.16667, 0.02778,       36,        6,       30
MS_, 0.14286, 0.02041,        7,        1,        6
MTM, 0.1    , 0.01   ,       10,        1,        9
MTN, 0      , 0      ,       21,        0,       21
MTP, 0.04167, 0.00174,       24,        1,       23
MTQ, 0.05263, 0.00277,       19,        1,       18
MTR, 0.08333, 0.00694,       24,        2,       22
MTS, 0.03125, 0.00098,       32,        1,       31
MTT, 0.07692, 0.00592,       26,        2,       24
MTV, 0.11111, 0.01235,       27,        3,       24
MTW, 0      , 0      ,        4,        0,        4
MTY, 0.13333, 0.01778,       15,        2,       13
MT_, 0      , 0      ,        3,        0,        3
MVM, 0      , 0      ,        7,        0,        7
MVN, 0.0625 , 0.00391,       16,        1,       15
MVP, 0      , 0      ,       30,        0,       30
MVQ, 0.05263, 0.00277,       19,        1,       18
MVR, 0.05263, 0.00277,       19,        1,       18
MVS, 0.05556, 0.00309,       36,        2,       34
MVT, 0.09677, 0.00937,       31,        3,       28
MVV, 0      , 0      ,       27,        0,       27
MVW, 0.28571, 0.08163,        7,        2,        5
MVY, 0.1875 , 0.03516,       16,        3,       13
MV_, 0      , 0      ,        2,        0,        2
MWN, 0.42857, 0.18367,        7,        3,        4
MWP, 0.5    , 0.25   ,        4,        2,        2
MWQ, 0.33333, 0.11111,        6,        2,        4
MWR, 0      , 0      ,        6,        0,        6
MWS, 0      , 0      ,        5,        0,        5
MWT, 0      , 0      ,        4,        0,        4
MWV, 0.2    , 0.04   ,        5,        1,        4
MWW, 0.33333, 0.11111,        3,        1,        2
MWY, 0.25   , 0.0625 ,        4,        1,        3
MYM, 0      , 0      ,        1,        0,        1
MYN, 0.2    , 0.04   ,       10,        2,        8
MYP, 0.16667, 0.02778,       18,        3,       15
MYQ, 0.13333, 0.01778,       15,        2,       13
MYR, 0.06667, 0.00444,       15,        1,       14
MYS, 0.16   , 0.0256 ,       25,        4,       21
MYT, 0.14286, 0.02041,       14,        2,       12
MYV, 0.07692, 0.00592,       13,        1,       12
MYW, 0.4    , 0.16   ,        5,        2,        3
MYY, 0.13333, 0.01778,       15,        2,       13
NAN, 0.04167, 0.00174,       24,        1,       23
NAP, 0      , 0      ,       49,        0,       49
NAQ, 0.08889, 0.0079 ,       45,        4,       41
NAR, 0.02632, 0.00069,       38,        1,       37
NAS, 0.0814 , 0.00663,       86,        7,       79
NAT, 0.05172, 0.00268,       58,        3,       55
NAV, 0.01818, 0.00033,       55,        1,       54
NAW, 0.05882, 0.00346,       17,        1,       16
NAY, 0.04878, 0.00238,       41,        2,       39
NA_, 0      , 0      ,        7,        0,        7
NCN, 0      , 0      ,        6,        0,        6
NCP, 0      , 0      ,       12,        0,       12
NCQ, 0      , 0      ,       14,        0,       14
NCR, 0      , 0      ,       22,        0,       22
NCS, 0      , 0      ,       22,        0,       22
NCT, 0.04167, 0.00174,       24,        1,       23
NCV, 0      , 0      ,       17,        0,       17
NCW, 0.16667, 0.02778,        6,        1,        5
NCY, 0.11111, 0.01235,       18,        2,       16
NDN, 0.04545, 0.00207,       22,        1,       21
NDP, 0.04286, 0.00184,       70,        3,       67
NDQ, 0.04444, 0.00198,       45,        2,       43
NDR, 0.0303 , 0.00092,       66,        2,       64
NDS, 0.01471, 0.00022,       68,        1,       67
NDT, 0.05882, 0.00346,       51,        3,       48
NDV, 0.04054, 0.00164,       74,        3,       71
NDW, 0.10526, 0.01108,       19,        2,       17
NDY, 0.14894, 0.02218,       47,        7,       40
ND_, 0      , 0      ,        3,        0,        3
NEN, 0.11111, 0.01235,       27,        3,       24
NEP, 0.04938, 0.00244,       81,        4,       77
NEQ, 0.04255, 0.00181,       47,        2,       45
NER, 0.04167, 0.00174,       72,        3,       69
NES, 0.01136, 0.00013,       88,        1,       87
NET, 0.02532, 0.00064,       79,        2,       77
NEV, 0.02941, 0.00087,      102,        3,       99
NEW, 0.04   , 0.0016 ,       25,        1,       24
NEY, 0.05   , 0.0025 ,       60,        3,       57
NE_, 0      , 0      ,        7,        0,        7
NFN, 0      , 0      ,       23,        0,       23
NFP, 0.05128, 0.00263,       39,        2,       37
NFQ, 0.02174, 0.00047,       46,        1,       45
NFR, 0.08   , 0.0064 ,       50,        4,       46
NFS, 0.05882, 0.00346,       68,        4,       64
NFT, 0.0678 , 0.0046 ,       59,        4,       55
NFV, 0.06522, 0.00425,       46,        3,       43
NFW, 0.25   , 0.0625 ,       12,        3,        9
NFY, 0.16667, 0.02778,       30,        5,       25
NF_, 0.25   , 0.0625 ,        4,        1,        3
NGN, 0.02564, 0.00066,       39,        1,       38
NGP, 0.04444, 0.00198,       45,        2,       43
NGQ, 0.01695, 0.00029,       59,        1,       58
NGR, 0.01205, 0.00015,       83,        1,       82
NGS, 0.04505, 0.00203,      111,        5,      106
NGT, 0.03061, 0.00094,       98,        3,       95
NGV, 0.06863, 0.00471,      102,        7,       95
NGW, 0.1    , 0.01   ,       20,        2,       18
NGY, 0.14286, 0.02041,       63,        9,       54
NG_, 0      , 0      ,        7,        0,        7
NHN, 0.23077, 0.05325,       13,        3,       10
NHP, 0.04   , 0.0016 ,       25,        1,       24
NHQ, 0.125  , 0.01562,       16,        2,       14
NHR, 0.15789, 0.02493,       19,        3,       16
NHS, 0.11538, 0.01331,       26,        3,       23
NHT, 0.04   , 0.0016 ,       25,        1,       24
NHV, 0.07143, 0.0051 ,       28,        2,       26
NHW, 0      , 0      ,        4,        0,        4
NHY, 0.05263, 0.00277,       19,        1,       18
NIN, 0.03226, 0.00104,       31,        1,       30
NIP, 0.03509, 0.00123,       57,        2,       55
NIQ, 0.04762, 0.00227,       42,        2,       40
NIR, 0.07143, 0.0051 ,       56,        4,       52
NIS, 0.08889, 0.0079 ,       90,        8,       82
NIT, 0.06667, 0.00444,       75,        5,       70
NIV, 0.06173, 0.00381,       81,        5,       76
NIW, 0.06667, 0.00444,       15,        1,       14
NIY, 0.13953, 0.01947,       43,        6,       37
NI_, 0      , 0      ,        6,        0,        6
NKN, 0.03333, 0.00111,       30,        1,       29
NKP, 0.03846, 0.00148,       52,        2,       50
NKQ, 0.02   , 0.0004 ,       50,        1,       49
NKR, 0.04412, 0.00195,       68,        3,       65
NKS, 0.1    , 0.01   ,       70,        7,       63
NKT, 0.06494, 0.00422,       77,        5,       72
NKV, 0.07547, 0.0057 ,      106,        8,       98
NKW, 0.08333, 0.00694,       12,        1,       11
NKY, 0.05172, 0.00268,       58,        3,       55
NK_, 0      , 0      ,        5,        0,        5
NLN, 0      , 0      ,       38,        0,       38
NLP, 0.06173, 0.00381,       81,        5,       76
NLQ, 0.01515, 0.00023,       66,        1,       65
NLR, 0.02667, 0.00071,       75,        2,       73
NLS, 0.14815, 0.02195,      108,       16,       92
NLT, 0.05208, 0.00271,       96,        5,       91
NLV, 0.04717, 0.00222,      106,        5,      101
NLW, 0.0625 , 0.00391,       16,        1,       15
NLY, 0.02857, 0.00082,       70,        2,       68
NL_, 0      , 0      ,        5,        0,        5
NMN, 0.11111, 0.01235,        9,        1,        8
NMP, 0.20833, 0.0434 ,       24,        5,       19
NMQ, 0.25   , 0.0625 ,       12,        3,        9
NMR, 0      , 0      ,       15,        0,       15
NMS, 0      , 0      ,       21,        0,       21
NMT, 0.04762, 0.00227,       21,        1,       20
NMV, 0.16667, 0.02778,       24,        4,       20
NMW, 0.16667, 0.02778,        6,        1,        5
NMY, 0.15385, 0.02367,       13,        2,       11
NM_, 0.11111, 0.01235,        9,        1,        8
NNN, 0.03704, 0.00137,       27,        1,       26
NNP, 0.08   , 0.0064 ,       50,        4,       46
NNQ, 0      , 0      ,       31,        0,       31
NNR, 0.08475, 0.00718,       59,        5,       54
NNS, 0.02817, 0.00079,       71,        2,       69
NNT, 0.01961, 0.00038,       51,        1,       50
NNV, 0.04478, 0.002  ,       67,        3,       64
NNW, 0.11111, 0.01235,       18,        2,       16
NNY, 0.05172, 0.00268,       58,        3,       55
NN_, 0      , 0      ,        5,        0,        5
NPN, 0.04082, 0.00167,       49,        2,       47
NPP, 0      , 0      ,       65,        0,       65
NPQ, 0.05128, 0.00263,       39,        2,       37
NPR, 0.09375, 0.00879,       32,        3,       29
NPS, 0.01205, 0.00015,       83,        1,       82
NPT, 0.0303 , 0.00092,       66,        2,       64
NPV, 0.03571, 0.00128,       56,        2,       54
NPW, 0      , 0      ,        6,        0,        6
NPY, 0.05263, 0.00277,       38,        2,       36
NP_, 0      , 0      ,        3,        0,        3
NQN, 0.05   , 0.0025 ,       20,        1,       19
NQP, 0      , 0      ,       27,        0,       27
NQQ, 0      , 0      ,       46,        0,       46
NQR, 0.04878, 0.00238,       41,        2,       39
NQS, 0.07692, 0.00592,       65,        5,       60
NQT, 0.10526, 0.01108,       38,        4,       34
NQV, 0.03704, 0.00137,       54,        2,       52
NQW, 0      , 0      ,        9,        0,        9
NQY, 0      , 0      ,       30,        0,       30
NQ_, 0      , 0      ,        1,        0,        1
NRN, 0.07407, 0.00549,       27,        2,       25
NRP, 0.05455, 0.00298,       55,        3,       52
NRQ, 0.10714, 0.01148,       28,        3,       25
NRR, 0.03922, 0.00154,       51,        2,       49
NRS, 0.17647, 0.03114,       68,       12,       56
NRT, 0.11321, 0.01282,       53,        6,       47
NRV, 0.03488, 0.00122,       86,        3,       83
NRW, 0.15789, 0.02493,       19,        3,       16
NRY, 0.14286, 0.02041,       56,        8,       48
NR_, 0      , 0      ,        2,        0,        2
NSN, 0.06897, 0.00476,       29,        2,       27
NSP, 0.03175, 0.00101,       63,        2,       61
NSQ, 0.04545, 0.00207,       44,        2,       42
NSR, 0      , 0      ,       65,        0,       65
NSS, 0.03361, 0.00113,      119,        4,      115
NST, 0.0303 , 0.00092,       66,        2,       64
NSV, 0.07317, 0.00535,       82,        6,       76
NSW, 0      , 0      ,       17,        0,       17
NSY, 0      , 0      ,       40,        0,       40
NS_, 0.1    , 0.01   ,       10,        1,        9
NTN, 0      , 0      ,       20,        0,       20
NTP, 0.04167, 0.00174,       48,        2,       46
NTQ, 0.02703, 0.00073,       37,        1,       36
NTR, 0      , 0      ,       39,        0,       39
NTS, 0.06061, 0.00367,       66,        4,       62
NTT, 0.09677, 0.00937,       62,        6,       56
NTV, 0.01299, 0.00017,       77,        1,       76
NTW, 0.0625 , 0.00391,       16,        1,       15
NTY, 0.04082, 0.00167,       49,        2,       47
NT_, 0      , 0      ,        1,        0,        1
NVN, 0.10345, 0.0107 ,       29,        3,       26
NVP, 0.04545, 0.00207,       88,        4,       84
NVQ, 0.03704, 0.00137,       54,        2,       52
NVR, 0.03774, 0.00142,       53,        2,       51
NVS, 0.03797, 0.00144,       79,        3,       76
NVT, 0.0875 , 0.00766,       80,        7,       73
NVV, 0.0375 , 0.00141,       80,        3,       77
NVW, 0      , 0      ,       10,        0,       10
NVY, 0.09756, 0.00952,       41,        4,       37
NWN, 0.08333, 0.00694,       12,        1,       11
NWP, 0      , 0      ,       16,        0,       16
NWQ, 0      , 0      ,        8,        0,        8
NWR, 0.05556, 0.00309,       18,        1,       17
NWS, 0.04348, 0.00189,       23,        1,       22
NWT, 0.05263, 0.00277,       19,        1,       18
NWV, 0.13043, 0.01701,       23,        3,       20
NWW, 0      , 0      ,        6,        0,        6
NWY, 0.5    , 0.25   ,       16,        8,        8
NYN, 0      , 0      ,       15,        0,       15
NYP, 0.08696, 0.00756,       46,        4,       42
NYQ, 0.2439 , 0.05949,       41,       10,       31
NYR, 0.03922, 0.00154,       51,        2,       49
NYS, 0.12766, 0.0163 ,       47,        6,       41
NYT, 0.1    , 0.01   ,       40,        4,       36
NYV, 0.21311, 0.04542,       61,       13,       48
NYW, 0      , 0      ,       17,        0,       17
NYY, 0.27778, 0.07716,       36,       10,       26
NY_, 0      , 0      ,        2,        0,        2
PAP, 0.03226, 0.00104,       31,        1,       30
PAQ, 0.02174, 0.00047,       46,        1,       45
PAR, 0.07692, 0.00592,       52,        4,       48
PAS, 0.03614, 0.00131,       83,        3,       80
PAT, 0.02899, 0.00084,       69,        2,       67
PAV, 0.02469, 0.00061,       81,        2,       79
PAW, 0.07143, 0.0051 ,       14,        1,       13
PAY, 0.02222, 0.00049,       45,        1,       44
PA_, 0      , 0      ,        9,        0,        9
PCP, 0.0625 , 0.00391,       16,        1,       15
PCQ, 0.08   , 0.0064 ,       25,        2,       23
PCR, 0.09091, 0.00826,       11,        1,       10
PCS, 0.03448, 0.00119,       29,        1,       28
PCT, 0.11538, 0.01331,       26,        3,       23
PCV, 0.13636, 0.0186 ,       22,        3,       19
PCW, 0      , 0      ,        6,        0,        6
PCY, 0      , 0      ,        6,        0,        6
PDP, 0.11429, 0.01306,       35,        4,       31
PDQ, 0.0678 , 0.0046 ,       59,        4,       55
PDR, 0.06557, 0.0043 ,       61,        4,       57
PDS, 0.04211, 0.00177,       95,        4,       91
PDT, 0.0125 , 0.00016,       80,        1,       79
PDV, 0.04545, 0.00207,       88,        4,       84
PDW, 0      , 0      ,       19,        0,       19
PDY, 0.0597 , 0.00356,       67,        4,       63
PD_, 0      , 0      ,        7,        0,        7
PEP, 0.07895, 0.00623,       38,        3,       35
PEQ, 0.04   , 0.0016 ,       50,        2,       48
PER, 0.01333, 0.00018,       75,        1,       74
PES, 0.04255, 0.00181,       94,        4,       90
PET, 0.03704, 0.00137,       81,        3,       78
PEV, 0.07692, 0.00592,      104,        8,       96
PEW, 0.15   , 0.0225 ,       40,        6,       34
PEY, 0.07547, 0.0057 ,       53,        4,       49
PE_, 0      , 0      ,       17,        0,       17
PFP, 0.11111, 0.01235,       27,        3,       24
PFQ, 0.15909, 0.02531,       44,        7,       37
PFR, 0.01852, 0.00034,       54,        1,       53
PFS, 0.01852, 0.00034,       54,        1,       53
PFT, 0.10526, 0.01108,       57,        6,       51
PFV, 0.16667, 0.02778,       60,       10,       50
PFW, 0.125  , 0.01562,        8,        1,        7
PFY, 0.04348, 0.00189,       23,        1,       22
PF_, 0      , 0      ,        2,        0,        2
PGP, 0      , 0      ,       29,        0,       29
PGQ, 0.03774, 0.00142,       53,        2,       51
PGR, 0.01695, 0.00029,       59,        1,       58
PGS, 0.02459, 0.0006 ,      122,        3,      119
PGT, 0.03448, 0.00119,       87,        3,       84
PGV, 0.02439, 0.00059,       82,        2,       80
PGW, 0.03704, 0.00137,       27,        1,       26
PGY, 0.02381, 0.00057,       42,        1,       41
PG_, 0      , 0      ,       25,        0,       25
PHP, 0.06667, 0.00444,       15,        1,       14
PHQ, 0.0625 , 0.00391,       16,        1,       15
PHR, 0.08696, 0.00756,       23,        2,       21
PHS, 0.06897, 0.00476,       29,        2,       27
PHT, 0.07895, 0.00623,       38,        3,       35
PHV, 0.05405, 0.00292,       37,        2,       35
PHW, 0      , 0      ,        6,        0,        6
PHY, 0.08333, 0.00694,       12,        1,       11
PH_, 0      , 0      ,        3,        0,        3
PIP, 0.09091, 0.00826,       44,        4,       40
PIQ, 0.10417, 0.01085,       48,        5,       43
PIR, 0      , 0      ,       57,        0,       57
PIS, 0.11111, 0.01235,       81,        9,       72
PIT, 0.08955, 0.00802,       67,        6,       61
PIV, 0.025  , 0.00063,       80,        2,       78
PIW, 0      , 0      ,        9,        0,        9
PIY, 0.09375, 0.00879,       32,        3,       29
PI_, 0.14286, 0.02041,        7,        1,        6
PKP, 0      , 0      ,       26,        0,       26
PKQ, 0.02326, 0.00054,       43,        1,       42
PKR, 0.04918, 0.00242,       61,        3,       58
PKS, 0.03947, 0.00156,       76,        3,       73
PKT, 0.0303 , 0.00092,       66,        2,       64
PKV, 0.05825, 0.00339,      103,        6,       97
PKW, 0      , 0      ,       24,        0,       24
PKY, 0.04444, 0.00198,       45,        2,       43
PK_, 0      , 0      ,       14,        0,       14
PLP, 0.04396, 0.00193,       91,        4,       87
PLQ, 0.03571, 0.00128,       84,        3,       81
PLR, 0.05556, 0.00309,       90,        5,       85
PLS, 0.03704, 0.00137,      135,        5,      130
PLT, 0.02459, 0.0006 ,      122,        3,      119
PLV, 0.04505, 0.00203,      111,        5,      106
PLW, 0      , 0      ,       27,        0,       27
PLY, 0.10169, 0.01034,       59,        6,       53
PL_, 0      , 0      ,        4,        0,        4
PMP, 0      , 0      ,       10,        0,       10
PMQ, 0.125  , 0.01562,       16,        2,       14
PMR, 0.22222, 0.04938,       18,        4,       14
PMS, 0      , 0      ,       18,        0,       18
PMT, 0.15385, 0.02367,       26,        4,       22
PMV, 0.26923, 0.07249,       26,        7,       19
PMW, 0      , 0      ,        3,        0,        3
PMY, 0      , 0      ,       14,        0,       14
PM_, 0      , 0      ,        7,        0,        7
PNP, 0      , 0      ,       25,        0,       25
PNQ, 0.07692, 0.00592,       39,        3,       36
PNR, 0.07547, 0.0057 ,       53,        4,       49
PNS, 0.05085, 0.00259,       59,        3,       56
PNT, 0.03922, 0.00154,       51,        2,       49
PNV, 0.05714, 0.00327,       70,        4,       66
PNW, 0.125  , 0.01562,       16,        2,       14
PNY, 0.10169, 0.01034,       59,        6,       53
PN_, 0      , 0      ,        3,        0,        3
PPP, 0.03774, 0.00142,       53,        2,       51
PPQ, 0.01818, 0.00033,       55,        1,       54
PPR, 0.02041, 0.00042,       49,        1,       48
PPS, 0      , 0      ,       70,        0,       70
PPT, 0.03125, 0.00098,       64,        2,       62
PPV, 0      , 0      ,       69,        0,       69
PPW, 0.08333, 0.00694,       12,        1,       11
PPY, 0.14286, 0.02041,       28,        4,       24
PP_, 0      , 0      ,       10,        0,       10
PQP, 0.03704, 0.00137,       27,        1,       26
PQQ, 0.01961, 0.00038,       51,        1,       50
PQR, 0.05   , 0.0025 ,       40,        2,       38
PQS, 0.02041, 0.00042,       49,        1,       48
PQT, 0.07843, 0.00615,       51,        4,       47
PQV, 0.09524, 0.00907,       63,        6,       57
PQW, 0.11111, 0.01235,        9,        1,        8
PQY, 0.15385, 0.02367,       26,        4,       22
PQ_, 0      , 0      ,        4,        0,        4
PRP, 0.07143, 0.0051 ,       28,        2,       26
PRQ, 0.09091, 0.00826,       33,        3,       30
PRR, 0.06122, 0.00375,       49,        3,       46
PRS, 0.04348, 0.00189,       69,        3,       66
PRT, 0.13793, 0.01902,       58,        8,       50
PRV, 0.11594, 0.01344,       69,        8,       61
PRW, 0      , 0      ,       12,        0,       12
PRY, 0.08696, 0.00756,       46,        4,       42
PR_, 0.09091, 0.00826,       11,        1,       10
PSP, 0.03125, 0.00098,       32,        1,       31
PSQ, 0.07407, 0.00549,       54,        4,       50
PSR, 0      , 0      ,       58,        0,       58
PSS, 0.0566 , 0.0032 ,      106,        6,      100
PST, 0.03922, 0.00154,       51,        2,       49
PSV, 0.03093, 0.00096,       97,        3,       94
PSW, 0.07143, 0.0051 ,       14,        1,       13
PSY, 0      , 0      ,       45,        0,       45
PS_, 0      , 0      ,       16,        0,       16
PTP, 0.04651, 0.00216,       43,        2,       41
PTQ, 0.02778, 0.00077,       36,        1,       35
PTR, 0.04348, 0.00189,       46,        2,       44
PTS, 0.02667, 0.00071,       75,        2,       73
PTT, 0.01667, 0.00028,       60,        1,       59
PTV, 0.0122 , 0.00015,       82,        1,       81
PTW, 0.12   , 0.0144 ,       25,        3,       22
PTY, 0.05455, 0.00298,       55,        3,       52
PT_, 0      , 0      ,        2,        0,        2
PVP, 0.05263, 0.00277,       38,        2,       36
PVQ, 0.11111, 0.01235,       54,        6,       48
PVR, 0.02083, 0.00043,       48,        1,       47
PVS, 0.04651, 0.00216,      129,        6,      123
PVT, 0.03371, 0.00114,       89,        3,       86
PVV, 0.04545, 0.00207,       88,        4,       84
PVW, 0      , 0      ,       20,        0,       20
PVY, 0.09756, 0.00952,       41,        4,       37
PV_, 0      , 0      ,        2,        0,        2
PWP, 0      , 0      ,        9,        0,        9
PWQ, 0      , 0      ,       10,        0,       10
PWR, 0      , 0      ,       11,        0,       11
PWS, 0.13043, 0.01701,       23,        3,       20
PWT, 0.10526, 0.01108,       19,        2,       17
PWV, 0      , 0      ,       11,        0,       11
PWW, 0      , 0      ,        1,        0,        1
PWY, 0.05882, 0.00346,       17,        1,       16
PYP, 0.08696, 0.00756,       23,        2,       21
PYQ, 0.03125, 0.00098,       32,        1,       31
PYR, 0.03571, 0.00128,       28,        1,       27
PYS, 0.16279, 0.0265 ,       43,        7,       36
PYT, 0.17073, 0.02915,       41,        7,       34
PYV, 0.08475, 0.00718,       59,        5,       54
PYW, 0.18182, 0.03306,       11,        2,        9
PYY, 0.25   , 0.0625 ,       32,        8,       24
PY_, 0      , 0      ,        1,        0,        1
QAQ, 0      , 0      ,       25,        0,       25
QAR, 0.03922, 0.00154,       51,        2,       49
QAS, 0.02817, 0.00079,       71,        2,       69
QAT, 0.06557, 0.0043 ,       61,        4,       57
QAV, 0.04878, 0.00238,       82,        4,       78
QAW, 0.09091, 0.00826,       11,        1,       10
QAY, 0      , 0      ,       36,        0,       36
QA_, 0      , 0      ,        8,        0,        8
QCQ, 0      , 0      ,       11,        0,       11
QCR, 0.09091, 0.00826,       22,        2,       20
QCS, 0      , 0      ,       13,        0,       13
QCT, 0.05556, 0.00309,       18,        1,       17
QCV, 0      , 0      ,       11,        0,       11
QCW, 0      , 0      ,        3,        0,        3
QCY, 0      , 0      ,        9,        0,        9
QDQ, 0      , 0      ,       22,        0,       22
QDR, 0.02381, 0.00057,       42,        1,       41
QDS, 0.04348, 0.00189,       46,        2,       44
QDT, 0.01724, 0.0003 ,       58,        1,       57
QDV, 0.09091, 0.00826,       77,        7,       70
QDW, 0.05882, 0.00346,       17,        1,       16
QDY, 0.02174, 0.00047,       46,        1,       45
QD_, 0.11111, 0.01235,        9,        1,        8
QEQ, 0.02778, 0.00077,       36,        1,       35
QER, 0.02941, 0.00087,       68,        2,       66
QES, 0.08235, 0.00678,       85,        7,       78
QET, 0.01887, 0.00036,       53,        1,       52
QEV, 0.03371, 0.00114,       89,        3,       86
QEW, 0.03571, 0.00128,       28,        1,       27
QEY, 0.02174, 0.00047,       46,        1,       45
QE_, 0      , 0      ,        8,        0,        8
QFQ, 0      , 0      ,       15,        0,       15
QFR, 0.08571, 0.00735,       35,        3,       32
QFS, 0.09524, 0.00907,       42,        4,       38
QFT, 0.07273, 0.00529,       55,        4,       51
QFV, 0.04762, 0.00227,       42,        2,       40
QFW, 0      , 0      ,        5,        0,        5
QFY, 0.09677, 0.00937,       31,        3,       28
QF_, 0      , 0      ,        2,        0,        2
QGQ, 0.02703, 0.00073,       37,        1,       36
QGR, 0.03774, 0.00142,       53,        2,       51
QGS, 0.03846, 0.00148,       78,        3,       75
QGT, 0.03077, 0.00095,       65,        2,       63
QGV, 0.07143, 0.0051 ,       56,        4,       52
QGW, 0.06667, 0.00444,       15,        1,       14
QGY, 0.03704, 0.00137,       27,        1,       26
QG_, 0      , 0      ,        1,        0,        1
QHQ, 0.22222, 0.04938,        9,        2,        7
QHR, 0.08   , 0.0064 ,       25,        2,       23
QHS, 0.15789, 0.02493,       19,        3,       16
QHT, 0.15   , 0.0225 ,       20,        3,       17
QHV, 0.03448, 0.00119,       29,        1,       28
QHW, 0      , 0      ,        8,        0,        8
QHY, 0.04348, 0.00189,       23,        1,       22
QIQ, 0.04762, 0.00227,       21,        1,       20
QIR, 0.11765, 0.01384,       51,        6,       45
QIS, 0.05263, 0.00277,       57,        3,       54
QIT, 0.11364, 0.01291,       44,        5,       39
QIV, 0.04762, 0.00227,       63,        3,       60
QIW, 0      , 0      ,       14,        0,       14
QIY, 0.05405, 0.00292,       37,        2,       35
QI_, 0      , 0      ,        1,        0,        1
QKQ, 0.05882, 0.00346,       17,        1,       16
QKR, 0.05085, 0.00259,       59,        3,       56
QKS, 0.05714, 0.00327,       70,        4,       66
QKT, 0.05128, 0.00263,       39,        2,       37
QKV, 0.01064, 0.00011,       94,        1,       93
QKW, 0.04167, 0.00174,       24,        1,       23
QKY, 0.02439, 0.00059,       41,        1,       40
QK_, 0      , 0      ,        4,        0,        4
QLQ, 0.04878, 0.00238,       41,        2,       39
QLR, 0.04878, 0.00238,       82,        4,       78
QLS, 0.04348, 0.00189,      115,        5,      110
QLT, 0.05155, 0.00266,       97,        5,       92
QLV, 0.0625 , 0.00391,      112,        7,      105
QLW, 0.11111, 0.01235,        9,        1,        8
QLY, 0.0625 , 0.00391,       48,        3,       45
QL_, 0      , 0      ,        7,        0,        7
QMQ, 0      , 0      ,        6,        0,        6
QMR, 0      , 0      ,       21,        0,       21
QMS, 0      , 0      ,       21,        0,       21
QMT, 0.05   , 0.0025 ,       20,        1,       19
QMV, 0.125  , 0.01562,       32,        4,       28
QMW, 0      , 0      ,        3,        0,        3
QMY, 0      , 0      ,       11,        0,       11
QM_, 0      , 0      ,       10,        0,       10
QNQ, 0.11765, 0.01384,       17,        2,       15
QNR, 0.07895, 0.00623,       38,        3,       35
QNS, 0.11765, 0.01384,       51,        6,       45
QNT, 0.125  , 0.01562,       40,        5,       35
QNV, 0.05455, 0.00298,       55,        3,       52
QNW, 0.05556, 0.00309,       18,        1,       17
QNY, 0.05405, 0.00292,       37,        2,       35
QN_, 0      , 0      ,        4,        0,        4
QPQ, 0      , 0      ,       16,        0,       16
QPR, 0.06452, 0.00416,       31,        2,       29
QPS, 0.02   , 0.0004 ,       50,        1,       49
QPT, 0      , 0      ,       45,        0,       45
QPV, 0.05085, 0.00259,       59,        3,       56
QPW, 0.08333, 0.00694,       12,        1,       11
QPY, 0      , 0      ,       30,        0,       30
QP_, 0.16667, 0.02778,       12,        2,       10
QQQ, 0.0303 , 0.00092,       33,        1,       32
QQR, 0.03333, 0.00111,       60,        2,       58
QQS, 0.03922, 0.00154,       51,        2,       49
QQT, 0.02041, 0.00042,       49,        1,       48
QQV, 0.09756, 0.00952,       82,        8,       74
QQW, 0.05556, 0.00309,       18,        1,       17
QQY, 0.02439, 0.00059,       41,        1,       40
QQ_, 0      , 0      ,        9,        0,        9
QRQ, 0.11765, 0.01384,       17,        2,       15
QRR, 0.08065, 0.0065 ,       62,        5,       57
QRS, 0.0625 , 0.00391,       48,        3,       45
QRT, 0.01613, 0.00026,       62,        1,       61
QRV, 0.08511, 0.00724,       94,        8,       86
QRW, 0      , 0      ,       16,        0,       16
QRY, 0.09524, 0.00907,       42,        4,       38
QR_, 0      , 0      ,        1,        0,        1
QSQ, 0      , 0      ,       29,        0,       29
QSR, 0.02273, 0.00052,       44,        1,       43
QSS, 0.04286, 0.00184,       70,        3,       67
QST, 0.04762, 0.00227,       63,        3,       60
QSV, 0.07865, 0.00619,       89,        7,       82
QSW, 0      , 0      ,       17,        0,       17
QSY, 0.0303 , 0.00092,       33,        1,       32
QS_, 0      , 0      ,        4,        0,        4
QTQ, 0.09091, 0.00826,       11,        1,       10
QTR, 0.06383, 0.00407,       47,        3,       44
QTS, 0.07273, 0.00529,       55,        4,       51
QTT, 0.09804, 0.00961,       51,        5,       46
QTV, 0.0625 , 0.00391,       80,        5,       75
QTW, 0      , 0      ,        8,        0,        8
QTY, 0.06452, 0.00416,       31,        2,       29
QT_, 0.4    , 0.16   ,        5,        2,        3
QVQ, 0.04762, 0.00227,       21,        1,       20
QVR, 0.12821, 0.01644,       39,        5,       34
QVS, 0.06897, 0.00476,       58,        4,       54
QVT, 0.11594, 0.01344,       69,        8,       61
QVV, 0.07778, 0.00605,       90,        7,       83
QVW, 0.25   , 0.0625 ,       12,        3,        9
QVY, 0.04348, 0.00189,       46,        2,       44
QV_, 0      , 0      ,       11,        0,       11
QWQ, 0.07692, 0.00592,       13,        1,       12
QWR, 0.05882, 0.00346,       17,        1,       16
QWS, 0.14286, 0.02041,       14,        2,       12
QWT, 0.26667, 0.07111,       15,        4,       11
QWV, 0.22727, 0.05165,       22,        5,       17
QWW, 0.25   , 0.0625 ,        4,        1,        3
QWY, 0.15385, 0.02367,       13,        2,       11
QYQ, 0.04545, 0.00207,       22,        1,       21
QYR, 0.05556, 0.00309,       36,        2,       34
QYS, 0.0625 , 0.00391,       32,        2,       30
QYT, 0.0625 , 0.00391,       32,        2,       30
QYV, 0.08333, 0.00694,       48,        4,       44
QYW, 0.07692, 0.00592,       13,        1,       12
QYY, 0.06667, 0.00444,       45,        3,       42
QY_, 0.5    , 0.25   ,        2,        1,        1
RAR, 0      , 0      ,       38,        0,       38
RAS, 0.02857, 0.00082,       70,        2,       68
RAT, 0.01818, 0.00033,       55,        1,       54
RAV, 0.02299, 0.00053,       87,        2,       85
RAW, 0      , 0      ,       15,        0,       15
RAY, 0.08824, 0.00779,       34,        3,       31
RA_, 0.1    , 0.01   ,       10,        1,        9
RCR, 0      , 0      ,        7,        0,        7
RCS, 0      , 0      ,       24,        0,       24
RCT, 0      , 0      ,       11,        0,       11
RCV, 0      , 0      ,       18,        0,       18
RCW, 0.2    , 0.04   ,        5,        1,        4
RCY, 0.13333, 0.01778,       15,        2,       13
RC_, 0      , 0      ,        6,        0,        6
RDR, 0.03571, 0.00128,       28,        1,       27
RDS, 0.06742, 0.00454,       89,        6,       83
RDT, 0.07143, 0.0051 ,       56,        4,       52
RDV, 0.07059, 0.00498,       85,        6,       79
RDW, 0      , 0      ,       20,        0,       20
RDY, 0.04878, 0.00238,       41,        2,       39
RD_, 0      , 0      ,        8,        0,        8
RER, 0.03636, 0.00132,       55,        2,       53
RES, 0      , 0      ,       83,        0,       83
RET, 0.0137 , 0.00019,       73,        1,       72
REV, 0.00758, 0.00006,      132,        1,      131
REW, 0.06061, 0.00367,       33,        2,       31
REY, 0.04688, 0.0022 ,       64,        3,       61
RE_, 0      , 0      ,        7,        0,        7
RFR, 0      , 0      ,       18,        0,       18
RFS, 0.09375, 0.00879,       64,        6,       58
RFT, 0.06818, 0.00465,       44,        3,       41
RFV, 0.10638, 0.01132,       47,        5,       42
RFW, 0.06667, 0.00444,       15,        1,       14
RFY, 0.13793, 0.01902,       29,        4,       25
RF_, 0      , 0      ,        6,        0,        6
RGR, 0.06667, 0.00444,       30,        2,       28
RGS, 0.0354 , 0.00125,      113,        4,      109
RGT, 0.07059, 0.00498,       85,        6,       79
RGV, 0.04301, 0.00185,       93,        4,       89
RGW, 0.35   , 0.1225 ,       20,        7,       13
RGY, 0.04545, 0.00207,       44,        2,       42
RG_, 0      , 0      ,        7,        0,        7
RHR, 0      , 0      ,        7,        0,        7
RHS, 0.06667, 0.00444,       30,        2,       28
RHT, 0.12   , 0.0144 ,       25,        3,       22
RHV, 0.09091, 0.00826,       33,        3,       30
RHW, 0      , 0      ,        5,        0,        5
RHY, 0.03333, 0.00111,       30,        1,       29
RH_, 0      , 0      ,        4,        0,        4
RIR, 0.12903, 0.01665,       31,        4,       27
RIS, 0.11688, 0.01366,       77,        9,       68
RIT, 0.07547, 0.0057 ,       53,        4,       49
RIV, 0      , 0      ,       71,        0,       71
RIW, 0      , 0      ,       12,        0,       12
RIY, 0.08333, 0.00694,       36,        3,       33
RI_, 0      , 0      ,        5,        0,        5
RKR, 0.05   , 0.0025 ,       40,        2,       38
RKS, 0.05195, 0.0027 ,       77,        4,       73
RKT, 0.03896, 0.00152,       77,        3,       74
RKV, 0.02151, 0.00046,       93,        2,       91
RKW, 0.17647, 0.03114,       17,        3,       14
RKY, 0.03922, 0.00154,       51,        2,       49
RK_, 0      , 0      ,        8,        0,        8
RLR, 0.02   , 0.0004 ,       50,        1,       49
RLS, 0.07258, 0.00527,      124,        9,      115
RLT, 0.06897, 0.00476,      116,        8,      108
RLV, 0.08403, 0.00706,      119,       10,      109
RLW, 0      , 0      ,       21,        0,       21
RLY, 0.08333, 0.00694,       72,        6,       66
RL_, 0.125  , 0.01562,        8,        1,        7
RMR, 0.13333, 0.01778,       15,        2,       13
RMS, 0.06061, 0.00367,       33,        2,       31
RMT, 0.04348, 0.00189,       23,        1,       22
RMV, 0.11111, 0.01235,       27,        3,       24
RMW, 0.125  , 0.01562,        8,        1,        7
RMY, 0.09091, 0.00826,       11,        1,       10
RM_, 0.2    , 0.04   ,        5,        1,        4
RNR, 0.15385, 0.02367,       26,        4,       22
RNS, 0.11321, 0.01282,       53,        6,       47
RNT, 0.11628, 0.01352,       43,        5,       38
RNV, 0.08571, 0.00735,       70,        6,       64
RNW, 0      , 0      ,       11,        0,       11
RNY, 0.025  , 0.00063,       40,        1,       39
RN_, 0      , 0      ,        5,        0,        5
RPR, 0.06897, 0.00476,       29,        2,       27
RPS, 0.04545, 0.00207,       66,        3,       63
RPT, 0.08772, 0.00769,       57,        5,       52
RPV, 0.03704, 0.00137,       81,        3,       78
RPW, 0      , 0      ,       12,        0,       12
RPY, 0.03571, 0.00128,       28,        1,       27
RP_, 0.25   , 0.0625 ,        8,        2,        6
RQR, 0      , 0      ,       18,        0,       18
RQS, 0.04615, 0.00213,       65,        3,       62
RQT, 0.04082, 0.00167,       49,        2,       47
RQV, 0.09333, 0.00871,       75,        7,       68
RQW, 0      , 0      ,       11,        0,       11
RQY, 0.1    , 0.01   ,       30,        3,       27
RQ_, 0      , 0      ,        7,        0,        7
RRR, 0.075  , 0.00562,       40,        3,       37
RRS, 0.21429, 0.04592,       70,       15,       55
RRT, 0.16393, 0.02687,       61,       10,       51
RRV, 0.02174, 0.00047,       92,        2,       90
RRW, 0      , 0      ,       15,        0,       15
RRY, 0.12727, 0.0162 ,       55,        7,       48
RR_, 0      , 0      ,        8,        0,        8
RSR, 0.06452, 0.00416,       31,        2,       29
RSS, 0.01942, 0.00038,      103,        2,      101
RST, 0.03947, 0.00156,       76,        3,       73
RSV, 0.02913, 0.00085,      103,        3,      100
RSW, 0      , 0      ,       19,        0,       19
RSY, 0.05172, 0.00268,       58,        3,       55
RS_, 0      , 0      ,       10,        0,       10
RTR, 0.13333, 0.01778,       30,        4,       26
RTS, 0.0641 , 0.00411,       78,        5,       73
RTT, 0.11765, 0.01384,       51,        6,       45
RTV, 0.1    , 0.01   ,      110,       11,       99
RTW, 0.11111, 0.01235,       18,        2,       16
RTY, 0.10204, 0.01041,       49,        5,       44
RT_, 0.28571, 0.08163,        7,        2,        5
RVR, 0.09756, 0.00952,       41,        4,       37
RVS, 0.04348, 0.00189,       69,        3,       66
RVT, 0.08   , 0.0064 ,       75,        6,       69
RVV, 0.07965, 0.00634,      113,        9,      104
RVW, 0.11765, 0.01384,       17,        2,       15
RVY, 0.04082, 0.00167,       49,        2,       47
RV_, 0.33333, 0.11111,        6,        2,        4
RWR, 0      , 0      ,       10,        0,       10
RWS, 0.33333, 0.11111,       21,        7,       14
RWT, 0.17391, 0.03025,       23,        4,       19
RWV, 0.04167, 0.00174,       24,        1,       23
RWW, 0.25   , 0.0625 ,        4,        1,        3
RWY, 0.1    , 0.01   ,       10,        1,        9
RW_, 0      , 0      ,        1,        0,        1
RYR, 0.10714, 0.01148,       28,        3,       25
RYS, 0.07812, 0.0061 ,       64,        5,       59
RYT, 0.0625 , 0.00391,       48,        3,       45
RYV, 0.14516, 0.02107,       62,        9,       53
RYW, 0.28571, 0.08163,       14,        4,       10
RYY, 0.11765, 0.01384,       34,        4,       30
SAS, 0.03333, 0.00111,       60,        2,       58
SAT, 0.03529, 0.00125,       85,        3,       82
SAV, 0.01923, 0.00037,      104,        2,      102
SAW, 0.04   , 0.0016 ,       25,        1,       24
SAY, 0.04839, 0.00234,       62,        3,       59
SA_, 0      , 0      ,       12,        0,       12
SCS, 0      , 0      ,       13,        0,       13
SCT, 0.07143, 0.0051 ,       28,        2,       26
SCV, 0.02857, 0.00082,       35,        1,       34
SCW, 0.16667, 0.02778,        6,        1,        5
SCY, 0.08333, 0.00694,       12,        1,       11
SC_, 0      , 0      ,        2,        0,        2
SDS, 0.03636, 0.00132,       55,        2,       53
SDT, 0.05195, 0.0027 ,       77,        4,       73
SDV, 0.056  , 0.00314,      125,        7,      118
SDW, 0.08571, 0.00735,       35,        3,       32
SDY, 0.06349, 0.00403,       63,        4,       59
SD_, 0      , 0      ,        6,        0,        6
SES, 0.08333, 0.00694,       48,        4,       44
SET, 0      , 0      ,       85,        0,       85
SEV, 0.0678 , 0.0046 ,      118,        8,      110
SEW, 0      , 0      ,       17,        0,       17
SEY, 0.01493, 0.00022,       67,        1,       66
SE_, 0.33333, 0.11111,        6,        2,        4
SFS, 0.11321, 0.01282,       53,        6,       47
SFT, 0.04688, 0.0022 ,       64,        3,       61
SFV, 0.11538, 0.01331,       78,        9,       69
SFW, 0.125  , 0.01562,        8,        1,        7
SFY, 0.18182, 0.03306,       33,        6,       27
SGS, 0.08824, 0.00779,       68,        6,       62
SGT, 0.06667, 0.00444,      120,        8,      112
SGV, 0.04878, 0.00238,      123,        6,      117
SGW, 0.04348, 0.00189,       23,        1,       22
SGY, 0.05333, 0.00284,       75,        4,       71
SG_, 0.03774, 0.00142,       53,        2,       51
SHS, 0.04167, 0.00174,       24,        1,       23
SHT, 0.06977, 0.00487,       43,        3,       40
SHV, 0.09524, 0.00907,       42,        4,       38
SHW, 0.4    , 0.16   ,       15,        6,        9
SHY, 0.08696, 0.00756,       23,        2,       21
SH_, 0      , 0      ,        2,        0,        2
SIS, 0.17391, 0.03025,       46,        8,       38
SIT, 0.05263, 0.00277,       95,        5,       90
SIV, 0.10526, 0.01108,       76,        8,       68
SIW, 0.04762, 0.00227,       21,        1,       20
SIY, 0.08571, 0.00735,       35,        3,       32
SI_, 0      , 0      ,        3,        0,        3
SKS, 0.08   , 0.0064 ,       50,        4,       46
SKT, 0.07692, 0.00592,       91,        7,       84
SKV, 0.04464, 0.00199,      112,        5,      107
SKW, 0.08696, 0.00756,       23,        2,       21
SKY, 0.06061, 0.00367,       66,        4,       62
SK_, 0      , 0      ,        4,        0,        4
SLS, 0.06122, 0.00375,       98,        6,       92
SLT, 0.06612, 0.00437,      121,        8,      113
SLV, 0.06122, 0.00375,      147,        9,      138
SLW, 0.1    , 0.01   ,       20,        2,       18
SLY, 0.01099, 0.00012,       91,        1,       90
SL_, 0.08333, 0.00694,       12,        1,       11
SMS, 0.16   , 0.0256 ,       25,        4,       21
SMT, 0.03704, 0.00137,       27,        1,       26
SMV, 0.0625 , 0.00391,       32,        2,       30
SMW, 0.125  , 0.01562,        8,        1,        7
SMY, 0.10526, 0.01108,       19,        2,       17
SM_, 0      , 0      ,       14,        0,       14
SNS, 0.03704, 0.00137,       27,        1,       26
SNT, 0      , 0      ,       55,        0,       55
SNV, 0.07059, 0.00498,       85,        6,       79
SNW, 0.03846, 0.00148,       26,        1,       25
SNY, 0.19608, 0.03845,       51,       10,       41
SN_, 0      , 0      ,        9,        0,        9
SPS, 0.02174, 0.00047,       46,        1,       45
SPT, 0      , 0      ,       68,        0,       68
SPV, 0.05102, 0.0026 ,       98,        5,       93
SPW, 0.07143, 0.0051 ,       14,        1,       13
SPY, 0.03279, 0.00107,       61,        2,       59
SP_, 0.16667, 0.02778,        6,        1,        5
SQS, 0.04255, 0.00181,       47,        2,       45
SQT, 0.03704, 0.00137,       54,        2,       52
SQV, 0.03704, 0.00137,       81,        3,       78
SQW, 0.11111, 0.01235,       18,        2,       16
SQY, 0.04   , 0.0016 ,       50,        2,       48
SQ_, 0      , 0      ,        9,        0,        9
SRS, 0.06522, 0.00425,       46,        3,       43
SRT, 0.03125, 0.00098,       64,        2,       62
SRV, 0.09434, 0.0089 ,      106,       10,       96
SRW, 0      , 0      ,       27,        0,       27
SRY, 0.05634, 0.00317,       71,        4,       67
SR_, 0      , 0      ,        8,        0,        8
SSS, 0.07059, 0.00498,       85,        6,       79
SST, 0.06838, 0.00468,      117,        8,      109
SSV, 0.07595, 0.00577,      158,       12,      146
SSW, 0.08   , 0.0064 ,       25,        2,       23
SSY, 0.14474, 0.02095,       76,       11,       65
SS_, 0.05263, 0.00277,       19,        1,       18
STS, 0.10417, 0.01085,       48,        5,       43
STT, 0.08434, 0.00711,       83,        7,       76
STV, 0.01852, 0.00034,      108,        2,      106
STW, 0.10526, 0.01108,       19,        2,       17
STY, 0.07692, 0.00592,       52,        4,       48
ST_, 0.1    , 0.01   ,       10,        1,        9
SVS, 0.02   , 0.0004 ,       50,        1,       49
SVT, 0.08421, 0.00709,       95,        8,       87
SVV, 0.0381 , 0.00145,      105,        4,      101
SVW, 0.09524, 0.00907,       21,        2,       19
SVY, 0.04167, 0.00174,       48,        2,       46
SV_, 0.07692, 0.00592,       13,        1,       12
SWS, 0.21053, 0.04432,       19,        4,       15
SWT, 0.08333, 0.00694,       24,        2,       22
SWV, 0.14815, 0.02195,       27,        4,       23
SWW, 0      , 0      ,        3,        0,        3
SWY, 0.23077, 0.05325,       13,        3,       10
SW_, 1      , 1      ,        1,        1,        0
SYS, 0.23684, 0.05609,       38,        9,       29
SYT, 0.07895, 0.00623,       76,        6,       70
SYV, 0.11538, 0.01331,       78,        9,       69
SYW, 0.08333, 0.00694,       12,        1,       11
SYY, 0.06522, 0.00425,       46,        3,       43
SY_, 0.5    , 0.25   ,        2,        1,        1
TAT, 0.04167, 0.00174,       48,        2,       46
TAV, 0.02299, 0.00053,       87,        2,       85
TAW, 0      , 0      ,       13,        0,       13
TAY, 0.125  , 0.01562,       40,        5,       35
TA_, 0.1    , 0.01   ,       10,        1,        9
TCT, 0      , 0      ,        7,        0,        7
TCV, 0.22222, 0.04938,       18,        4,       14
TCW, 0      , 0      ,        5,        0,        5
TCY, 0.375  , 0.14062,        8,        3,        5
TDT, 0.05714, 0.00327,       35,        2,       33
TDV, 0.06667, 0.00444,       90,        6,       84
TDW, 0.15789, 0.02493,       19,        3,       16
TDY, 0.09091, 0.00826,       66,        6,       60
TD_, 0.11111, 0.01235,        9,        1,        8
TET, 0.04651, 0.00216,       43,        2,       41
TEV, 0.06383, 0.00407,       94,        6,       88
TEW, 0.1875 , 0.03516,       16,        3,       13
TEY, 0.06452, 0.00416,       62,        4,       58
TE_, 0      , 0      ,        7,        0,        7
TFT, 0.05556, 0.00309,       36,        2,       34
TFV, 0.14035, 0.0197 ,       57,        8,       49
TFW, 0      , 0      ,        4,        0,        4
TFY, 0.07895, 0.00623,       38,        3,       35
TF_, 0      , 0      ,        3,        0,        3
TGT, 0.09524, 0.00907,       63,        6,       57
TGV, 0.03529, 0.00125,       85,        3,       82
TGW, 0.0625 , 0.00391,       16,        1,       15
TGY, 0.03922, 0.00154,       51,        2,       49
TG_, 0      , 0      ,       10,        0,       10
THT, 0.2    , 0.04   ,       10,        2,        8
THV, 0.05128, 0.00263,       39,        2,       37
THW, 0.125  , 0.01562,        8,        1,        7
THY, 0.18182, 0.03306,       22,        4,       18
TIT, 0.08   , 0.0064 ,       50,        4,       46
TIV, 0.01754, 0.00031,       57,        1,       56
TIW, 0      , 0      ,       14,        0,       14
TIY, 0.175  , 0.03062,       40,        7,       33
TI_, 0      , 0      ,        3,        0,        3
TKT, 0.11905, 0.01417,       42,        5,       37
TKV, 0.06364, 0.00405,      110,        7,      103
TKW, 0      , 0      ,       13,        0,       13
TKY, 0      , 0      ,       57,        0,       57
TK_, 0      , 0      ,        4,        0,        4
TLT, 0.07042, 0.00496,       71,        5,       66
TLV, 0.04511, 0.00204,      133,        6,      127
TLW, 0.1    , 0.01   ,       10,        1,        9
TLY, 0.04348, 0.00189,       69,        3,       66
TL_, 0      , 0      ,        5,        0,        5
TMT, 0.33333, 0.11111,        9,        3,        6
TMV, 0.13043, 0.01701,       23,        3,       20
TMW, 0      , 0      ,        3,        0,        3
TMY, 0.06667, 0.00444,       15,        1,       14
TM_, 0      , 0      ,        8,        0,        8
TNT, 0.06061, 0.00367,       33,        2,       31
TNV, 0.11364, 0.01291,       88,       10,       78
TNW, 0      , 0      ,        9,        0,        9
TNY, 0.02273, 0.00052,       44,        1,       43
TN_, 0      , 0      ,        4,        0,        4
TPT, 0.09756, 0.00952,       41,        4,       37
TPV, 0.03333, 0.00111,       90,        3,       87
TPW, 0.09524, 0.00907,       21,        2,       19
TPY, 0.07692, 0.00592,       39,        3,       36
TP_, 0      , 0      ,        9,        0,        9
TQT, 0.05882, 0.00346,       34,        2,       32
TQV, 0.07042, 0.00496,       71,        5,       66
TQW, 0.14286, 0.02041,       21,        3,       18
TQY, 0.07895, 0.00623,       38,        3,       35
TQ_, 0.125  , 0.01562,        8,        1,        7
TRT, 0.05   , 0.0025 ,       40,        2,       38
TRV, 0.09091, 0.00826,       88,        8,       80
TRW, 0.14286, 0.02041,       14,        2,       12
TRY, 0.03846, 0.00148,       52,        2,       50
TR_, 0      , 0      ,        9,        0,        9
TST, 0.05128, 0.00263,       39,        2,       37
TSV, 0.0566 , 0.0032 ,      106,        6,      100
TSW, 0.07692, 0.00592,       13,        1,       12
TSY, 0.05769, 0.00333,       52,        3,       49
TS_, 0      , 0      ,        8,        0,        8
TTT, 0.17308, 0.02996,       52,        9,       43
TTV, 0.03125, 0.00098,       96,        3,       93
TTW, 0.04   , 0.0016 ,       25,        1,       24
TTY, 0.07895, 0.00623,       38,        3,       35
TT_, 0.4    , 0.16   ,       10,        4,        6
TVT, 0.05556, 0.00309,       36,        2,       34
TVV, 0.0404 , 0.00163,       99,        4,       95
TVW, 0      , 0      ,       16,        0,       16
TVY, 0.06818, 0.00465,       44,        3,       41
TV_, 0      , 0      ,        9,        0,        9
TWT, 0.08333, 0.00694,       12,        1,       11
TWV, 0.16667, 0.02778,       18,        3,       15
TWW, 0.2    , 0.04   ,        5,        1,        4
TWY, 0.33333, 0.11111,        3,        1,        2
TW_, 0      , 0      ,        1,        0,        1
TYT, 0.03333, 0.00111,       30,        1,       29
TYV, 0.14286, 0.02041,       49,        7,       42
TYW, 0      , 0      ,       10,        0,       10
TYY, 0.14634, 0.02142,       41,        6,       35
TY_, 0      , 0      ,        2,        0,        2
VAV, 0.05172, 0.00268,       58,        3,       55
VAW, 0.05   , 0.0025 ,       20,        1,       19
VAY, 0.08   , 0.0064 ,       50,        4,       46
VA_, 0      , 0      ,        6,        0,        6
VCV, 0.11111, 0.01235,        9,        1,        8
VCW, 0      , 0      ,        6,        0,        6
VCY, 0.14286, 0.02041,       14,        2,       12
VDV, 0.07246, 0.00525,       69,        5,       64
VDW, 0.08571, 0.00735,       35,        3,       32
VDY, 0.05128, 0.00263,       78,        4,       74
VD_, 0      , 0      ,        9,        0,        9
VEV, 0.05333, 0.00284,       75,        4,       71
VEW, 0      , 0      ,       25,        0,       25
VEY, 0.09524, 0.00907,      105,       10,       95
VE_, 0      , 0      ,        9,        0,        9
VFV, 0.13793, 0.01902,       29,        4,       25
VFW, 0.1    , 0.01   ,       10,        1,        9
VFY, 0.09524, 0.00907,       42,        4,       38
VF_, 0.16667, 0.02778,        6,        1,        5
VGV, 0.05085, 0.00259,       59,        3,       56
VGW, 0.27273, 0.07438,       11,        3,        8
VGY, 0.05172, 0.00268,       58,        3,       55
VG_, 0      , 0      ,        4,        0,        4
VHV, 0.11765, 0.01384,       34,        4,       30
VHW, 0.14286, 0.02041,        7,        1,        6
VHY, 0.06667, 0.00444,       30,        2,       28
VH_, 0      , 0      ,        1,        0,        1
VIV, 0.02941, 0.00087,       34,        1,       33
VIW, 0.125  , 0.01562,        8,        1,        7
VIY, 0.11765, 0.01384,       34,        4,       30
VI_, 0      , 0      ,        4,        0,        4
VKV, 0.04167, 0.00174,       72,        3,       69
VKW, 0      , 0      ,       19,        0,       19
VKY, 0.05797, 0.00336,       69,        4,       65
VK_, 0      , 0      ,       10,        0,       10
VLV, 0.05882, 0.00346,       51,        3,       48
VLW, 0.04545, 0.00207,       22,        1,       21
VLY, 0.01695, 0.00029,       59,        1,       58
VL_, 0      , 0      ,        7,        0,        7
VMV, 0.10345, 0.0107 ,       29,        3,       26
VMW, 0.16667, 0.02778,        6,        1,        5
VMY, 0.25   , 0.0625 ,        8,        2,        6
VM_, 0.09091, 0.00826,       11,        1,       10
VNV, 0.11321, 0.01282,       53,        6,       47
VNW, 0.14286, 0.02041,       21,        3,       18
VNY, 0.04878, 0.00238,       41,        2,       39
VN_, 0.25   , 0.0625 ,        4,        1,        3
VPV, 0.06452, 0.00416,       62,        4,       58
VPW, 0      , 0      ,       10,        0,       10
VPY, 0.08475, 0.00718,       59,        5,       54
VP_, 0      , 0      ,       11,        0,       11
VQV, 0.0566 , 0.0032 ,       53,        3,       50
VQW, 0      , 0      ,       21,        0,       21
VQY, 0      , 0      ,       39,        0,       39
VQ_, 0      , 0      ,        5,        0,        5
VRV, 0.08772, 0.00769,       57,        5,       52
VRW, 0.03333, 0.00111,       30,        1,       29
VRY, 0.12162, 0.01479,       74,        9,       65
VR_, 0      , 0      ,        6,        0,        6
VSV, 0.04839, 0.00234,       62,        3,       59
VSW, 0.2381 , 0.05669,       21,        5,       16
VSY, 0.05952, 0.00354,       84,        5,       79
VS_, 0      , 0      ,       12,        0,       12
VTV, 0.0122 , 0.00015,       82,        1,       81
VTW, 0      , 0      ,       14,        0,       14
VTY, 0.0625 , 0.00391,       48,        3,       45
VT_, 0.14286, 0.02041,        7,        1,        6
VVV, 0.09434, 0.0089 ,       53,        5,       48
VVW, 0.07692, 0.00592,       13,        1,       12
VVY, 0.11111, 0.01235,       45,        5,       40
VV_, 0      , 0      ,        5,        0,        5
VWV, 0.28571, 0.08163,        7,        2,        5
VWW, 0      , 0      ,        3,        0,        3
VWY, 0.07692, 0.00592,       13,        1,       12
VW_, 0      , 0      ,        1,        0,        1
VYV, 0.06897, 0.00476,       29,        2,       27
VYW, 0      , 0      ,        6,        0,        6
VYY, 0.09375, 0.00879,       32,        3,       29
VY_, 0      , 0      ,        1,        0,        1
WAW, 0      , 0      ,        2,        0,        2
WAY, 0      , 0      ,        6,        0,        6
WA_, 0      , 0      ,        1,        0,        1
WC_, 0      , 0      ,        2,        0,        2
WDW, 0      , 0      ,        2,        0,        2
WDY, 0.10526, 0.01108,       19,        2,       17
WD_, 0      , 0      ,        2,        0,        2
WEW, 0      , 0      ,        2,        0,        2
WEY, 0.11538, 0.01331,       26,        3,       23
WE_, 0      , 0      ,        1,        0,        1
WFY, 0.33333, 0.11111,        6,        2,        4
WF_, 0      , 0      ,        1,        0,        1
WGW, 0      , 0      ,        1,        0,        1
WGY, 0.07692, 0.00592,       13,        1,       12
WG_, 0      , 0      ,        2,        0,        2
WHY, 0.11111, 0.01235,        9,        1,        8
WH_, 0      , 0      ,        1,        0,        1
WIW, 0      , 0      ,        1,        0,        1
WIY, 0      , 0      ,        9,        0,        9
WKW, 0      , 0      ,        3,        0,        3
WKY, 0      , 0      ,       10,        0,       10
WK_, 0      , 0      ,        3,        0,        3
WLW, 0      , 0      ,        2,        0,        2
WLY, 0.08333, 0.00694,       12,        1,       11
WL_, 0      , 0      ,        1,        0,        1
WMW, 0      , 0      ,        1,        0,        1
WMY, 0      , 0      ,        3,        0,        3
WNW, 0      , 0      ,        5,        0,        5
WNY, 0      , 0      ,       15,        0,       15
WN_, 0      , 0      ,        1,        0,        1
WPW, 0      , 0      ,        1,        0,        1
WPY, 0      , 0      ,       14,        0,       14
WP_, 0      , 0      ,        4,        0,        4
WQW, 1      , 1      ,        1,        1,        0
WQY, 0.2    , 0.04   ,        5,        1,        4
WQ_, 0      , 0      ,        1,        0,        1
WRW, 0      , 0      ,        2,        0,        2
WRY, 0      , 0      ,       14,        0,       14
WSW, 0      , 0      ,        5,        0,        5
WSY, 0.27778, 0.07716,       18,        5,       13
WS_, 0      , 0      ,        2,        0,        2
WTW, 0      , 0      ,        4,        0,        4
WTY, 0      , 0      ,       12,        0,       12
WVY, 0.2    , 0.04   ,        5,        1,        4
WWY, 0      , 0      ,        1,        0,        1
WYW, 0      , 0      ,        3,        0,        3
WYY, 0.14286, 0.02041,        7,        1,        6
YAY, 0.0625 , 0.00391,       16,        1,       15
YA_, 0      , 0      ,        2,        0,        2
YCY, 0.33333, 0.11111,        6,        2,        4
YDY, 0.08333, 0.00694,       36,        3,       33
YD_, 0      , 0      ,        7,        0,        7
YEY, 0.09091, 0.00826,       11,        1,       10
YE_, 0      , 0      ,        3,        0,        3
YFY, 0.14286, 0.02041,       14,        2,       12
YF_, 0      , 0      ,        1,        0,        1
YGY, 0.19048, 0.03628,       21,        4,       17
YG_, 0      , 0      ,        3,        0,        3
YHY, 0.2    , 0.04   ,        5,        1,        4
YH_, 0      , 0      ,        3,        0,        3
YIY, 0.1    , 0.01   ,       10,        1,        9
YI_, 0      , 0      ,        4,        0,        4
YKY, 0      , 0      ,       24,        0,       24
YK_, 0      , 0      ,        1,        0,        1
YLY, 0.05263, 0.00277,       19,        1,       18
YL_, 0      , 0      ,        4,        0,        4
YMY, 0.1    , 0.01   ,       10,        1,        9
YM_, 0      , 0      ,        2,        0,        2
YNY, 0.09524, 0.00907,       21,        2,       19
YN_, 0      , 0      ,        5,        0,        5
YPY, 0.15385, 0.02367,       13,        2,       11
YP_, 0      , 0      ,        4,        0,        4
YQY, 0.06667, 0.00444,       15,        1,       14
YRY, 0.23077, 0.05325,       13,        3,       10
YR_, 0      , 0      ,        1,        0,        1
YSY, 0.0625 , 0.00391,       16,        1,       15
YS_, 0      , 0      ,        8,        0,        8
YTY, 0      , 0      ,       16,        0,       16
YT_, 0      , 0      ,        2,        0,        2
YVY, 0.26667, 0.07111,       15,        4,       11
YV_, 0      , 0      ,        3,        0,        3
YWY, 0.33333, 0.11111,        3,        1,        2
YYY, 0.05263, 0.00277,       19,        1,       18
YY_, 0      , 0      ,        1,        0,        1
