key, pos_ratio, pos_ratio^2, count, pos, neg
AAA, 0.05102, 0.0026 ,       98,        5,       93
AAC, 0.03704, 0.00137,       27,        1,       26
AAD, 0.0087 , 0.00008,      115,        1,      114
AAE, 0.00637, 0.00004,      157,        1,      156
AAF, 0.08065, 0.0065 ,       62,        5,       57
AAG, 0.0463 , 0.00214,      108,        5,      103
AAH, 0.06667, 0.00444,       45,        3,       42
AAI, 0.01639, 0.00027,      122,        2,      120
AAK, 0.03704, 0.00137,      108,        4,      104
AAL, 0.01163, 0.00014,      172,        2,      170
AAM, 0.02632, 0.00069,       38,        1,       37
AAN, 0.02817, 0.00079,       71,        2,       69
AAP, 0.02857, 0.00082,       70,        2,       68
AAQ, 0.06383, 0.00407,       94,        6,       88
AAR, 0.04167, 0.00174,       96,        4,       92
AAS, 0.04065, 0.00165,      123,        5,      118
AAT, 0.06383, 0.00407,       94,        6,       88
AAV, 0.07639, 0.00584,      144,       11,      133
AAW, 0.04545, 0.00207,       22,        1,       21
AAY, 0.04918, 0.00242,       61,        3,       58
AA_, 0      , 0      ,        9,        0,        9
ACA, 0      , 0      ,        9,        0,        9
ACC, 0      , 0      ,        4,        0,        4
ACD, 0.04762, 0.00227,       21,        1,       20
ACE, 0.07143, 0.0051 ,       28,        2,       26
ACF, 0.05882, 0.00346,       17,        1,       16
ACG, 0.08333, 0.00694,       24,        2,       22
ACH, 0.05882, 0.00346,       17,        1,       16
ACI, 0      , 0      ,       19,        0,       19
ACK, 0      , 0      ,       23,        0,       23
ACL, 0      , 0      ,       34,        0,       34
ACM, 0.2    , 0.04   ,       10,        2,        8
ACN, 0      , 0      ,       15,        0,       15
ACP, 0      , 0      ,       11,        0,       11
ACQ, 0.10526, 0.01108,       19,        2,       17
ACR, 0.11765, 0.01384,       17,        2,       15
ACS, 0.125  , 0.01562,       24,        3,       21
ACT, 0.05556, 0.00309,       18,        1,       17
ACV, 0.17857, 0.03189,       28,        5,       23
ACW, 0      , 0      ,        9,        0,        9
ACY, 0      , 0      ,       14,        0,       14
ADA, 0      , 0      ,       45,        0,       45
ADC, 0.03846, 0.00148,       26,        1,       25
ADD, 0.04167, 0.00174,       72,        3,       69
ADE, 0.0098 , 0.0001 ,      102,        1,      101
ADF, 0.06349, 0.00403,       63,        4,       59
ADG, 0.04854, 0.00236,      103,        5,       98
ADH, 0.04545, 0.00207,       22,        1,       21
ADI, 0.01613, 0.00026,      124,        2,      122
ADK, 0.06863, 0.00471,      102,        7,       95
ADL, 0.04516, 0.00204,      155,        7,      148
ADM, 0.05556, 0.00309,       36,        2,       34
ADN, 0.09615, 0.00925,       52,        5,       47
ADP, 0.02857, 0.00082,       70,        2,       68
ADQ, 0.05263, 0.00277,       57,        3,       54
ADR, 0.01205, 0.00015,       83,        1,       82
ADS, 0.04444, 0.00198,       90,        4,       86
ADT, 0.06849, 0.00469,       73,        5,       68
ADV, 0.07857, 0.00617,      140,       11,      129
ADW, 0      , 0      ,       19,        0,       19
ADY, 0.02817, 0.00079,       71,        2,       69
AD_, 0      , 0      ,        4,        0,        4
AEA, 0.03191, 0.00102,       94,        3,       91
AEC, 0.04545, 0.00207,       22,        1,       21
AED, 0.09483, 0.00899,      116,       11,      105
AEE, 0.0679 , 0.00461,      162,       11,      151
AEF, 0.16667, 0.02778,       72,       12,       60
AEG, 0.05607, 0.00314,      107,        6,      101
AEH, 0.16667, 0.02778,       30,        5,       25
AEI, 0.06838, 0.00468,      117,        8,      109
AEK, 0.02564, 0.00066,      156,        4,      152
AEL, 0.03922, 0.00154,      204,        8,      196
AEM, 0.05405, 0.00292,       37,        2,       35
AEN, 0.04396, 0.00193,       91,        4,       87
AEP, 0.04819, 0.00232,       83,        4,       79
AEQ, 0.03261, 0.00106,       92,        3,       89
AER, 0.02857, 0.00082,      105,        3,      102
AES, 0.03797, 0.00144,       79,        3,       76
AET, 0.01149, 0.00013,       87,        1,       86
AEV, 0.02069, 0.00043,      145,        3,      142
AEW, 0.03448, 0.00119,       29,        1,       28
AEY, 0.04545, 0.00207,       66,        3,       63
AE_, 0.125  , 0.01562,        8,        1,        7
AFA, 0.09677, 0.00937,       31,        3,       28
AFC, 0.17647, 0.03114,       17,        3,       14
AFD, 0.12121, 0.01469,       66,        8,       58
AFE, 0.13043, 0.01701,       46,        6,       40
AFF, 0.06452, 0.00416,       31,        2,       29
AFG, 0.07937, 0.0063 ,       63,        5,       58
AFH, 0.11111, 0.01235,       18,        2,       16
AFI, 0.15789, 0.02493,       38,        6,       32
AFK, 0.16129, 0.02601,       62,       10,       52
AFL, 0.14865, 0.0221 ,       74,       11,       63
AFM, 0.15385, 0.02367,       13,        2,       11
AFN, 0.04167, 0.00174,       48,        2,       46
AFP, 0.10256, 0.01052,       39,        4,       35
AFQ, 0.10811, 0.01169,       37,        4,       33
AFR, 0.05263, 0.00277,       38,        2,       36
AFS, 0.05882, 0.00346,       68,        4,       64
AFT, 0.15909, 0.02531,       44,        7,       37
AFV, 0.0678 , 0.0046 ,       59,        4,       55
AFW, 0      , 0      ,       11,        0,       11
AFY, 0.08   , 0.0064 ,       25,        2,       23
AF_, 0      , 0      ,        2,        0,        2
AGA, 0.08   , 0.0064 ,       50,        4,       46
AGC, 0      , 0      ,       29,        0,       29
AGD, 0.01031, 0.00011,       97,        1,       96
AGE, 0.03093, 0.00096,       97,        3,       94
AGF, 0.04   , 0.0016 ,       50,        2,       48
AGG, 0.06452, 0.00416,      124,        8,      116
AGH, 0.10526, 0.01108,       38,        4,       34
AGI, 0.1039 , 0.01079,       77,        8,       69
AGK, 0.04348, 0.00189,       92,        4,       88
AGL, 0.032  , 0.00102,      125,        4,      121
AGM, 0      , 0      ,       23,        0,       23
AGN, 0.05769, 0.00333,       52,        3,       49
AGP, 0.01923, 0.00037,       52,        1,       51
AGQ, 0.07353, 0.00541,       68,        5,       63
AGR, 0.06849, 0.00469,       73,        5,       68
AGS, 0.0463 , 0.00214,      108,        5,      103
AGT, 0.06383, 0.00407,       94,        6,       88
AGV, 0.03093, 0.00096,       97,        3,       94
AGW, 0.08333, 0.00694,       24,        2,       22
AGY, 0.07692, 0.00592,       65,        5,       60
AG_, 0      , 0      ,       14,        0,       14
AHA, 0.19048, 0.03628,       21,        4,       17
AHC, 0.27778, 0.07716,       18,        5,       13
AHD, 0.12121, 0.01469,       33,        4,       29
AHE, 0.14286, 0.02041,       35,        5,       30
AHF, 0.125  , 0.01562,       24,        3,       21
AHG, 0.21053, 0.04432,       38,        8,       30
AHH, 0.1    , 0.01   ,       10,        1,        9
AHI, 0.15625, 0.02441,       32,        5,       27
AHK, 0.13793, 0.01902,       29,        4,       25
AHL, 0.06   , 0.0036 ,       50,        3,       47
AHM, 0.25   , 0.0625 ,       20,        5,       15
AHN, 0.05263, 0.00277,       19,        1,       18
AHP, 0.11111, 0.01235,       27,        3,       24
AHQ, 0.12121, 0.01469,       33,        4,       29
AHR, 0.03226, 0.00104,       31,        1,       30
AHS, 0.11429, 0.01306,       35,        4,       31
AHT, 0.23333, 0.05444,       30,        7,       23
AHV, 0.15625, 0.02441,       32,        5,       27
AHW, 0.16667, 0.02778,        6,        1,        5
AHY, 0.14286, 0.02041,       21,        3,       18
AH_, 0      , 0      ,        2,        0,        2
AIA, 0.02985, 0.00089,       67,        2,       65
AIC, 0.09091, 0.00826,       22,        2,       20
AID, 0.05814, 0.00338,       86,        5,       81
AIE, 0.05051, 0.00255,       99,        5,       94
AIF, 0.02439, 0.00059,       41,        1,       40
AIG, 0.04348, 0.00189,       69,        3,       66
AIH, 0.11429, 0.01306,       35,        4,       31
AII, 0.0566 , 0.0032 ,       53,        3,       50
AIK, 0.04598, 0.00211,       87,        4,       83
AIL, 0.09709, 0.00943,      103,       10,       93
AIM, 0.13333, 0.01778,       30,        4,       26
AIN, 0.07018, 0.00492,       57,        4,       53
AIP, 0.06122, 0.00375,       49,        3,       46
AIQ, 0.02222, 0.00049,       45,        1,       44
AIR, 0.09195, 0.00846,       87,        8,       79
AIS, 0.05556, 0.00309,       72,        4,       68
AIT, 0.12048, 0.01452,       83,       10,       73
AIV, 0.05714, 0.00327,       70,        4,       66
AIW, 0      , 0      ,       11,        0,       11
AIY, 0.02381, 0.00057,       42,        1,       41
AI_, 0      , 0      ,        2,        0,        2
AKA, 0.06849, 0.00469,       73,        5,       68
AKC, 0.03571, 0.00128,       28,        1,       27
AKD, 0.0202 , 0.00041,       99,        2,       97
AKE, 0.03759, 0.00141,      133,        5,      128
AKF, 0.04918, 0.00242,       61,        3,       58
AKG, 0.06316, 0.00399,       95,        6,       89
AKH, 0.06061, 0.00367,       33,        2,       31
AKI, 0.11111, 0.01235,       90,       10,       80
AKK, 0.08696, 0.00756,      115,       10,      105
AKL, 0.08333, 0.00694,      192,       16,      176
AKM, 0.02326, 0.00054,       43,        1,       42
AKN, 0.01266, 0.00016,       79,        1,       78
AKP, 0      , 0      ,       60,        0,       60
AKQ, 0.05128, 0.00263,       78,        4,       74
AKR, 0.0411 , 0.00169,       73,        3,       70
AKS, 0.08046, 0.00647,       87,        7,       80
AKT, 0.06818, 0.00465,       88,        6,       82
AKV, 0.07965, 0.00634,      113,        9,      104
AKW, 0.14286, 0.02041,       21,        3,       18
AKY, 0.05172, 0.00268,       58,        3,       55
AK_, 0.09091, 0.00826,       11,        1,       10
ALA, 0.06316, 0.00399,       95,        6,       89
ALC, 0.10811, 0.01169,       37,        4,       33
ALD, 0.08088, 0.00654,      136,       11,      125
ALE, 0.05495, 0.00302,      182,       10,      172
ALF, 0.07042, 0.00496,       71,        5,       66
ALG, 0.04667, 0.00218,      150,        7,      143
ALH, 0.09091, 0.00826,       55,        5,       50
ALI, 0.0531 , 0.00282,      113,        6,      107
ALK, 0.08025, 0.00644,      162,       13,      149
ALL, 0.05116, 0.00262,      215,       11,      204
ALM, 0.03846, 0.00148,       52,        2,       50
ALN, 0.08696, 0.00756,       92,        8,       84
ALP, 0.03   , 0.0009 ,      100,        3,       97
ALQ, 0.06122, 0.00375,       98,        6,       92
ALR, 0.04196, 0.00176,      143,        6,      137
ALS, 0.05625, 0.00316,      160,        9,      151
ALT, 0.04505, 0.00203,      111,        5,      106
ALV, 0.08392, 0.00704,      143,       12,      131
ALW, 0.06667, 0.00444,       30,        2,       28
ALY, 0.03659, 0.00134,       82,        3,       79
AL_, 0      , 0      ,        7,        0,        7
AMA, 0.03846, 0.00148,       26,        1,       25
AMC, 0.125  , 0.01562,        8,        1,        7
AMD, 0.05   , 0.0025 ,       40,        2,       38
AME, 0.04348, 0.00189,       46,        2,       44
AMF, 0      , 0      ,       22,        0,       22
AMG, 0.21053, 0.04432,       38,        8,       30
AMH, 0.03846, 0.00148,       26,        1,       25
AMI, 0.17857, 0.03189,       28,        5,       23
AMK, 0      , 0      ,       36,        0,       36
AML, 0.14583, 0.02127,       48,        7,       41
AMM, 0.05882, 0.00346,       17,        1,       16
AMN, 0      , 0      ,       22,        0,       22
AMP, 0.05882, 0.00346,       17,        1,       16
AMQ, 0.19048, 0.03628,       21,        4,       17
AMR, 0.03846, 0.00148,       26,        1,       25
AMS, 0.10256, 0.01052,       39,        4,       35
AMT, 0.04   , 0.0016 ,       25,        1,       24
AMV, 0.08824, 0.00779,       34,        3,       31
AMW, 0      , 0      ,        8,        0,        8
AMY, 0.13333, 0.01778,       15,        2,       13
AM_, 0      , 0      ,        9,        0,        9
ANA, 0      , 0      ,       48,        0,       48
ANC, 0.13333, 0.01778,       15,        2,       13
AND, 0.05882, 0.00346,       51,        3,       48
ANE, 0.01724, 0.0003 ,       58,        1,       57
ANF, 0.04762, 0.00227,       63,        3,       60
ANG, 0.1    , 0.01   ,       90,        9,       81
ANH, 0.08   , 0.0064 ,       25,        2,       23
ANI, 0.09412, 0.00886,       85,        8,       77
ANK, 0.05797, 0.00336,       69,        4,       65
ANL, 0.08491, 0.00721,      106,        9,       97
ANM, 0.09524, 0.00907,       21,        2,       19
ANN, 0.05769, 0.00333,       52,        3,       49
ANP, 0.05556, 0.00309,       54,        3,       51
ANQ, 0.05769, 0.00333,       52,        3,       49
ANR, 0.02083, 0.00043,       48,        1,       47
ANS, 0.12069, 0.01457,       58,        7,       51
ANT, 0.09524, 0.00907,       42,        4,       38
ANV, 0.1    , 0.01   ,       70,        7,       63
ANW, 0      , 0      ,       13,        0,       13
ANY, 0.17073, 0.02915,       41,        7,       34
AN_, 0      , 0      ,        6,        0,        6
APA, 0      , 0      ,       32,        0,       32
APC, 0      , 0      ,       11,        0,       11
APD, 0.04706, 0.00221,       85,        4,       81
APE, 0.01235, 0.00015,       81,        1,       80
APF, 0.07692, 0.00592,       26,        2,       24
APG, 0.05263, 0.00277,       95,        5,       90
APH, 0      , 0      ,       26,        0,       26
API, 0.08451, 0.00714,       71,        6,       65
APK, 0.05769, 0.00333,       52,        3,       49
APL, 0.01786, 0.00032,      112,        2,      110
APM, 0.10526, 0.01108,       19,        2,       17
APN, 0.03922, 0.00154,       51,        2,       49
APP, 0.04918, 0.00242,       61,        3,       58
APQ, 0      , 0      ,       34,        0,       34
APR, 0.11364, 0.01291,       44,        5,       39
APS, 0.025  , 0.00063,       80,        2,       78
APT, 0      , 0      ,       74,        0,       74
APV, 0.03846, 0.00148,       78,        3,       75
APW, 0.05882, 0.00346,       17,        1,       16
APY, 0.03571, 0.00128,       28,        1,       27
AP_, 0      , 0      ,        8,        0,        8
AQA, 0.12963, 0.0168 ,       54,        7,       47
AQC, 0.18519, 0.03429,       27,        5,       22
AQD, 0.0678 , 0.0046 ,       59,        4,       55
AQE, 0.04412, 0.00195,       68,        3,       65
AQF, 0.06383, 0.00407,       47,        3,       44
AQG, 0.03797, 0.00144,       79,        3,       76
AQH, 0.07317, 0.00535,       41,        3,       38
AQI, 0.13699, 0.01877,       73,       10,       63
AQK, 0.04286, 0.00184,       70,        3,       67
AQL, 0.01626, 0.00026,      123,        2,      121
AQM, 0.17143, 0.02939,       35,        6,       29
AQN, 0.04444, 0.00198,       45,        2,       43
AQP, 0.05405, 0.00292,       37,        2,       35
AQQ, 0.06977, 0.00487,       86,        6,       80
AQR, 0.0411 , 0.00169,       73,        3,       70
AQS, 0.05357, 0.00287,       56,        3,       53
AQT, 0.10606, 0.01125,       66,        7,       59
AQV, 0.12   , 0.0144 ,       75,        9,       66
AQW, 0.09524, 0.00907,       21,        2,       19
AQY, 0.02174, 0.00047,       46,        1,       45
AQ_, 0      , 0      ,        3,        0,        3
ARA, 0.03636, 0.00132,       55,        2,       53
ARC, 0.0625 , 0.00391,       16,        1,       15
ARD, 0.08235, 0.00678,       85,        7,       78
ARE, 0.06422, 0.00412,      109,        7,      102
ARF, 0.08   , 0.0064 ,       50,        4,       46
ARG, 0.10588, 0.01121,       85,        9,       76
ARH, 0.03571, 0.00128,       28,        1,       27
ARI, 0.12195, 0.01487,       82,       10,       72
ARK, 0.09859, 0.00972,       71,        7,       64
ARL, 0.06849, 0.00469,      146,       10,      136
ARM, 0.16667, 0.02778,       24,        4,       20
ARN, 0.07937, 0.0063 ,       63,        5,       58
ARP, 0.12245, 0.01499,       49,        6,       43
ARQ, 0.09231, 0.00852,       65,        6,       59
ARR, 0.03614, 0.00131,       83,        3,       80
ARS, 0.04286, 0.00184,       70,        3,       67
ART, 0.07576, 0.00574,       66,        5,       61
ARV, 0.05217, 0.00272,      115,        6,      109
ARW, 0.05882, 0.00346,       17,        1,       16
ARY, 0.0566 , 0.0032 ,       53,        3,       50
AR_, 0      , 0      ,        2,        0,        2
ASA, 0.09231, 0.00852,       65,        6,       59
ASC, 0.09091, 0.00826,       22,        2,       20
ASD, 0.01471, 0.00022,       68,        1,       67
ASE, 0.06579, 0.00433,       76,        5,       71
ASF, 0.04225, 0.00179,       71,        3,       68
ASG, 0.05983, 0.00358,      117,        7,      110
ASH, 0.11111, 0.01235,       36,        4,       32
ASI, 0.02353, 0.00055,       85,        2,       83
ASK, 0      , 0      ,       80,        0,       80
ASL, 0.06757, 0.00457,      148,       10,      138
ASM, 0.02326, 0.00054,       43,        1,       42
ASN, 0.06122, 0.00375,       49,        3,       46
ASP, 0.02299, 0.00053,       87,        2,       85
ASQ, 0.08621, 0.00743,       58,        5,       53
ASR, 0.04412, 0.00195,       68,        3,       65
ASS, 0.04918, 0.00242,      122,        6,      116
AST, 0.04348, 0.00189,       69,        3,       66
ASV, 0.07627, 0.00582,      118,        9,      109
ASW, 0      , 0      ,       23,        0,       23
ASY, 0.04918, 0.00242,       61,        3,       58
AS_, 0      , 0      ,       11,        0,       11
ATA, 0.07937, 0.0063 ,       63,        5,       58
ATC, 0.03448, 0.00119,       29,        1,       28
ATD, 0.05263, 0.00277,       76,        4,       72
ATE, 0.04651, 0.00216,       86,        4,       82
ATF, 0.08   , 0.0064 ,       50,        4,       46
ATG, 0.03061, 0.00094,       98,        3,       95
ATH, 0      , 0      ,       27,        0,       27
ATI, 0.01266, 0.00016,       79,        1,       78
ATK, 0.12281, 0.01508,       57,        7,       50
ATL, 0.06757, 0.00457,      148,       10,      138
ATM, 0.04348, 0.00189,       23,        1,       22
ATN, 0.09836, 0.00967,       61,        6,       55
ATP, 0.05172, 0.00268,       58,        3,       55
ATQ, 0.06667, 0.00444,       60,        4,       56
ATR, 0.04762, 0.00227,       63,        3,       60
ATS, 0.04615, 0.00213,       65,        3,       62
ATT, 0.07143, 0.0051 ,       56,        4,       52
ATV, 0.01869, 0.00035,      107,        2,      105
ATW, 0      , 0      ,       16,        0,       16
ATY, 0.05357, 0.00287,       56,        3,       53
AT_, 0      , 0      ,        1,        0,        1
AVA, 0.01449, 0.00021,       69,        1,       68
AVC, 0.03333, 0.00111,       30,        1,       29
AVD, 0.04255, 0.00181,       94,        4,       90
AVE, 0.10784, 0.01163,      102,       11,       91
AVF, 0.05769, 0.00333,       52,        3,       49
AVG, 0.04808, 0.00231,      104,        5,       99
AVH, 0.11429, 0.01306,       35,        4,       31
AVI, 0.07317, 0.00535,       82,        6,       76
AVK, 0.05102, 0.0026 ,       98,        5,       93
AVL, 0.09559, 0.00914,      136,       13,      123
AVM, 0.06667, 0.00444,       30,        2,       28
AVN, 0.0411 , 0.00169,       73,        3,       70
AVP, 0.10294, 0.0106 ,       68,        7,       61
AVQ, 0.04348, 0.00189,       69,        3,       66
AVR, 0.07368, 0.00543,       95,        7,       88
AVS, 0.08696, 0.00756,       92,        8,       84
AVT, 0.09709, 0.00943,      103,       10,       93
AVV, 0.04124, 0.0017 ,       97,        4,       93
AVW, 0.15789, 0.02493,       19,        3,       16
AVY, 0.06897, 0.00476,       58,        4,       54
AV_, 0      , 0      ,        3,        0,        3
AWA, 0.14286, 0.02041,        7,        1,        6
AWC, 0.375  , 0.14062,        8,        3,        5
AWD, 0.05   , 0.0025 ,       20,        1,       19
AWE, 0      , 0      ,       11,        0,       11
AWF, 0.08333, 0.00694,       12,        1,       11
AWG, 0.33333, 0.11111,       12,        4,        8
AWH, 0.25   , 0.0625 ,        8,        2,        6
AWI, 0.08333, 0.00694,       12,        1,       11
AWK, 0.17391, 0.03025,       23,        4,       19
AWL, 0.07692, 0.00592,       26,        2,       24
AWM, 0.16667, 0.02778,       12,        2,       10
AWN, 0.21429, 0.04592,       14,        3,       11
AWP, 0.04348, 0.00189,       23,        1,       22
AWQ, 0      , 0      ,       11,        0,       11
AWR, 0.21053, 0.04432,       19,        4,       15
AWS, 0.04167, 0.00174,       24,        1,       23
AWT, 0.15385, 0.02367,       13,        2,       11
AWV, 0.27273, 0.07438,       11,        3,        8
AWW, 0      , 0      ,        3,        0,        3
AWY, 0.08333, 0.00694,       12,        1,       11
AW_, 0      , 0      ,        2,        0,        2
AYA, 0.05556, 0.00309,       36,        2,       34
AYC, 0.125  , 0.01562,       16,        2,       14
AYD, 0.0625 , 0.00391,       48,        3,       45
AYE, 0.16071, 0.02583,       56,        9,       47
AYF, 0.10526, 0.01108,       38,        4,       34
AYG, 0.09375, 0.00879,       64,        6,       58
AYH, 0.05   , 0.0025 ,       20,        1,       19
AYI, 0.08333, 0.00694,       48,        4,       44
AYK, 0.09524, 0.00907,       42,        4,       38
AYL, 0.13043, 0.01701,       69,        9,       60
AYM, 0.07692, 0.00592,       13,        1,       12
AYN, 0.1    , 0.01   ,       30,        3,       27
AYP, 0.08333, 0.00694,       36,        3,       33
AYQ, 0.10526, 0.01108,       38,        4,       34
AYR, 0.075  , 0.00562,       40,        3,       37
AYS, 0.09615, 0.00925,       52,        5,       47
AYT, 0.24528, 0.06016,       53,       13,       40
AYV, 0.05882, 0.00346,       68,        4,       64
AYW, 0.1    , 0.01   ,       10,        1,        9
AYY, 0.17647, 0.03114,       34,        6,       28
AY_, 0      , 0      ,        4,        0,        4
CAC, 0      , 0      ,        4,        0,        4
CAD, 0.13333, 0.01778,       30,        4,       26
CAE, 0.125  , 0.01562,       16,        2,       14
CAF, 0      , 0      ,       11,        0,       11
CAG, 0.08333, 0.00694,       24,        2,       22
CAH, 0      , 0      ,        7,        0,        7
CAI, 0.13333, 0.01778,       15,        2,       13
CAK, 0      , 0      ,       18,        0,       18
CAL, 0      , 0      ,       27,        0,       27
CAM, 0.2    , 0.04   ,        5,        1,        4
CAN, 0.05   , 0.0025 ,       20,        1,       19
CAP, 0.05556, 0.00309,       18,        1,       17
CAQ, 0      , 0      ,       20,        0,       20
CAR, 0.05263, 0.00277,       19,        1,       18
CAS, 0.03226, 0.00104,       31,        1,       30
CAT, 0      , 0      ,       19,        0,       19
CAV, 0.06667, 0.00444,       30,        2,       28
CAW, 0      , 0      ,        5,        0,        5
CAY, 0      , 0      ,       10,        0,       10
CA_, 0      , 0      ,        1,        0,        1
CCD, 0.13333, 0.01778,       15,        2,       13
CCE, 0      , 0      ,        7,        0,        7
CCF, 0.125  , 0.01562,        8,        1,        7
CCG, 0      , 0      ,        7,        0,        7
CCH, 0.33333, 0.11111,        3,        1,        2
CCI, 0.6    , 0.36   ,       10,        6,        4
CCK, 0      , 0      ,        4,        0,        4
CCL, 0.125  , 0.01562,       16,        2,       14
CCM, 0      , 0      ,        1,        0,        1
CCN, 0      , 0      ,        5,        0,        5
CCP, 0.14286, 0.02041,        7,        1,        6
CCQ, 0.33333, 0.11111,        3,        1,        2
CCR, 0      , 0      ,        5,        0,        5
CCS, 0.06667, 0.00444,       15,        1,       14
CCT, 0      , 0      ,        6,        0,        6
CCV, 0      , 0      ,        2,        0,        2
CCY, 0      , 0      ,        8,        0,        8
CDC, 0.25   , 0.0625 ,        8,        2,        6
CDD, 0.07143, 0.0051 ,       28,        2,       26
CDE, 0.17241, 0.02973,       29,        5,       24
CDF, 0.17391, 0.03025,       23,        4,       19
CDG, 0.15   , 0.0225 ,       20,        3,       17
CDH, 0.25   , 0.0625 ,        8,        2,        6
CDI, 0      , 0      ,       20,        0,       20
CDK, 0.06897, 0.00476,       29,        2,       27
CDL, 0.11111, 0.01235,       36,        4,       32
CDM, 0.22222, 0.04938,        9,        2,        7
CDN, 0.06667, 0.00444,       15,        1,       14
CDP, 0      , 0      ,       19,        0,       19
CDQ, 0      , 0      ,        8,        0,        8
CDR, 0.2    , 0.04   ,       20,        4,       16
CDS, 0.13333, 0.01778,       30,        4,       26
CDT, 0.05   , 0.0025 ,       20,        1,       19
CDV, 0      , 0      ,       24,        0,       24
CDW, 0      , 0      ,        3,        0,        3
CDY, 0.17647, 0.03114,       17,        3,       14
CD_, 0      , 0      ,        1,        0,        1
CEC, 0      , 0      ,        8,        0,        8
CED, 0.07407, 0.00549,       27,        2,       25
CEE, 0.10811, 0.01169,       37,        4,       33
CEF, 0.09091, 0.00826,       11,        1,       10
CEG, 0.07143, 0.0051 ,       28,        2,       26
CEH, 0.07692, 0.00592,       13,        1,       12
CEI, 0.16129, 0.02601,       31,        5,       26
CEK, 0.06897, 0.00476,       29,        2,       27
CEL, 0.12195, 0.01487,       41,        5,       36
CEM, 0.07692, 0.00592,       13,        1,       12
CEN, 0      , 0      ,       19,        0,       19
CEP, 0.05   , 0.0025 ,       20,        1,       19
CEQ, 0      , 0      ,       15,        0,       15
CER, 0.14286, 0.02041,       21,        3,       18
CES, 0.09524, 0.00907,       21,        2,       19
CET, 0.05263, 0.00277,       19,        1,       18
CEV, 0.04348, 0.00189,       23,        1,       22
CEW, 0.2    , 0.04   ,        5,        1,        4
CEY, 0      , 0      ,       21,        0,       21
CFC, 0      , 0      ,        3,        0,        3
CFD, 0.25   , 0.0625 ,       16,        4,       12
CFE, 0.07692, 0.00592,       13,        1,       12
CFF, 0.07692, 0.00592,       13,        1,       12
CFG, 0.14286, 0.02041,       21,        3,       18
CFH, 0.14286, 0.02041,        7,        1,        6
CFI, 0      , 0      ,        6,        0,        6
CFK, 0.08333, 0.00694,       12,        1,       11
CFL, 0.31818, 0.10124,       22,        7,       15
CFM, 0.11111, 0.01235,        9,        1,        8
CFN, 0.22222, 0.04938,        9,        2,        7
CFP, 0      , 0      ,        6,        0,        6
CFQ, 0.25   , 0.0625 ,       12,        3,        9
CFR, 0.07143, 0.0051 ,       14,        1,       13
CFS, 0.1875 , 0.03516,       16,        3,       13
CFT, 0.28571, 0.08163,       14,        4,       10
CFV, 0      , 0      ,       19,        0,       19
CFW, 0      , 0      ,        8,        0,        8
CFY, 0.2    , 0.04   ,       15,        3,       12
CGC, 0      , 0      ,        5,        0,        5
CGD, 0.04762, 0.00227,       21,        1,       20
CGE, 0.15152, 0.02296,       33,        5,       28
CGF, 0      , 0      ,       10,        0,       10
CGG, 0.05882, 0.00346,       34,        2,       32
CGH, 0.16667, 0.02778,       12,        2,       10
CGI, 0.29412, 0.08651,       17,        5,       12
CGK, 0      , 0      ,       19,        0,       19
CGL, 0.05263, 0.00277,       19,        1,       18
CGM, 0      , 0      ,        5,        0,        5
CGN, 0      , 0      ,       16,        0,       16
CGP, 0      , 0      ,       15,        0,       15
CGQ, 0      , 0      ,       25,        0,       25
CGR, 0.04167, 0.00174,       24,        1,       23
CGS, 0.11111, 0.01235,       36,        4,       32
CGT, 0.13333, 0.01778,       30,        4,       26
CGV, 0.17391, 0.03025,       23,        4,       19
CGW, 0.2    , 0.04   ,        5,        1,        4
CGY, 0      , 0      ,       10,        0,       10
CG_, 0.33333, 0.11111,        3,        1,        2
CHD, 0      , 0      ,        8,        0,        8
CHE, 0.3    , 0.09   ,       10,        3,        7
CHF, 0      , 0      ,        7,        0,        7
CHG, 0.16667, 0.02778,       18,        3,       15
CHH, 0      , 0      ,        7,        0,        7
CHI, 0.1    , 0.01   ,       10,        1,        9
CHK, 0.08333, 0.00694,       12,        1,       11
CHL, 0      , 0      ,       27,        0,       27
CHM, 0      , 0      ,        6,        0,        6
CHN, 0      , 0      ,        8,        0,        8
CHP, 0.07143, 0.0051 ,       14,        1,       13
CHQ, 0.16667, 0.02778,        6,        1,        5
CHR, 0      , 0      ,        7,        0,        7
CHS, 0.15385, 0.02367,       13,        2,       11
CHT, 0      , 0      ,        8,        0,        8
CHV, 0.1    , 0.01   ,       10,        1,        9
CHW, 0.33333, 0.11111,        3,        1,        2
CHY, 0      , 0      ,        5,        0,        5
CIC, 0      , 0      ,        4,        0,        4
CID, 0      , 0      ,       17,        0,       17
CIE, 0.14286, 0.02041,       21,        3,       18
CIF, 0      , 0      ,        5,        0,        5
CIG, 0.2    , 0.04   ,       20,        4,       16
CIH, 0      , 0      ,        7,        0,        7
CII, 0.11111, 0.01235,       18,        2,       16
CIK, 0.05556, 0.00309,       18,        1,       17
CIL, 0.15789, 0.02493,       38,        6,       32
CIM, 0.14286, 0.02041,        7,        1,        6
CIN, 0.05556, 0.00309,       18,        1,       17
CIP, 0      , 0      ,       12,        0,       12
CIQ, 0      , 0      ,       15,        0,       15
CIR, 0.07692, 0.00592,       13,        1,       12
CIS, 0.05263, 0.00277,       19,        1,       18
CIT, 0      , 0      ,        7,        0,        7
CIV, 0.07407, 0.00549,       27,        2,       25
CIW, 0      , 0      ,        6,        0,        6
CIY, 0.13333, 0.01778,       15,        2,       13
CKC, 1      , 1      ,        1,        1,        0
CKD, 0.05263, 0.00277,       38,        2,       36
CKE, 0.09677, 0.00937,       31,        3,       28
CKF, 0.05556, 0.00309,       18,        1,       17
CKG, 0.03704, 0.00137,       27,        1,       26
CKH, 0      , 0      ,        6,        0,        6
CKI, 0.05556, 0.00309,       18,        1,       17
CKK, 0.05556, 0.00309,       36,        2,       34
CKL, 0.07407, 0.00549,       27,        2,       25
CKM, 0      , 0      ,        6,        0,        6
CKN, 0.15   , 0.0225 ,       20,        3,       17
CKP, 0      , 0      ,       20,        0,       20
CKQ, 0      , 0      ,       12,        0,       12
CKR, 0.1    , 0.01   ,       10,        1,        9
CKS, 0      , 0      ,       24,        0,       24
CKT, 0.05556, 0.00309,       18,        1,       17
CKV, 0.04167, 0.00174,       24,        1,       23
CKW, 0.11111, 0.01235,        9,        1,        8
CKY, 0      , 0      ,       13,        0,       13
CK_, 0      , 0      ,        4,        0,        4
CLC, 0      , 0      ,        8,        0,        8
CLD, 0.17241, 0.02973,       29,        5,       24
CLE, 0.12903, 0.01665,       31,        4,       27
CLF, 0.04   , 0.0016 ,       25,        1,       24
CLG, 0.23333, 0.05444,       30,        7,       23
CLH, 0.14286, 0.02041,       14,        2,       12
CLI, 0.09091, 0.00826,       22,        2,       20
CLK, 0.10345, 0.0107 ,       29,        3,       26
CLL, 0.09524, 0.00907,       42,        4,       38
CLM, 0.14286, 0.02041,        7,        1,        6
CLN, 0      , 0      ,       21,        0,       21
CLP, 0      , 0      ,       26,        0,       26
CLQ, 0.06667, 0.00444,       30,        2,       28
CLR, 0.13514, 0.01826,       37,        5,       32
CLS, 0.15152, 0.02296,       33,        5,       28
CLT, 0.13333, 0.01778,       30,        4,       26
CLV, 0.06452, 0.00416,       31,        2,       29
CLW, 0      , 0      ,        4,        0,        4
CLY, 0.22222, 0.04938,       27,        6,       21
CL_, 0      , 0      ,        3,        0,        3
CMC, 0      , 0      ,        1,        0,        1
CMD, 0      , 0      ,        8,        0,        8
CME, 0      , 0      ,       12,        0,       12
CMF, 0      , 0      ,        3,        0,        3
CMG, 0.11111, 0.01235,        9,        1,        8
CMH, 0      , 0      ,        3,        0,        3
CMI, 0      , 0      ,        3,        0,        3
CMK, 0      , 0      ,       17,        0,       17
CML, 0.57143, 0.32653,        7,        4,        3
CMM, 1      , 1      ,        1,        1,        0
CMN, 0      , 0      ,        9,        0,        9
CMP, 0      , 0      ,        7,        0,        7
CMQ, 0.33333, 0.11111,        3,        1,        2
CMR, 0      , 0      ,        1,        0,        1
CMS, 0      , 0      ,       15,        0,       15
CMT, 0.25   , 0.0625 ,        4,        1,        3
CMV, 0.15385, 0.02367,       13,        2,       11
CMW, 0      , 0      ,        1,        0,        1
CMY, 0      , 0      ,        3,        0,        3
CM_, 0.33333, 0.11111,        3,        1,        2
CNC, 0      , 0      ,       10,        0,       10
CND, 0.05263, 0.00277,       19,        1,       18
CNE, 0.09524, 0.00907,       21,        2,       19
CNF, 0      , 0      ,        9,        0,        9
CNG, 0      , 0      ,       22,        0,       22
CNH, 0      , 0      ,        6,        0,        6
CNI, 0.0625 , 0.00391,       16,        1,       15
CNK, 0      , 0      ,       18,        0,       18
CNL, 0      , 0      ,       27,        0,       27
CNM, 0      , 0      ,        4,        0,        4
CNN, 0.14286, 0.02041,       14,        2,       12
CNP, 0      , 0      ,       19,        0,       19
CNQ, 0      , 0      ,       15,        0,       15
CNR, 0.0625 , 0.00391,       16,        1,       15
CNS, 0.04348, 0.00189,       23,        1,       22
CNT, 0      , 0      ,       19,        0,       19
CNV, 0.05263, 0.00277,       19,        1,       18
CNW, 0      , 0      ,        2,        0,        2
CNY, 0      , 0      ,        9,        0,        9
CPC, 0      , 0      ,        2,        0,        2
CPD, 0.1    , 0.01   ,       20,        2,       18
CPE, 0.03846, 0.00148,       26,        1,       25
CPF, 0      , 0      ,        9,        0,        9
CPG, 0.0625 , 0.00391,       16,        1,       15
CPH, 0      , 0      ,       10,        0,       10
CPI, 0      , 0      ,       16,        0,       16
CPK, 0      , 0      ,       22,        0,       22
CPL, 0.04   , 0.0016 ,       25,        1,       24
CPM, 0      , 0      ,        4,        0,        4
CPN, 0      , 0      ,       16,        0,       16
CPP, 0      , 0      ,       21,        0,       21
CPQ, 0      , 0      ,       14,        0,       14
CPR, 0.1    , 0.01   ,       20,        2,       18
CPS, 0.125  , 0.01562,       16,        2,       14
CPT, 0      , 0      ,       16,        0,       16
CPV, 0.04545, 0.00207,       22,        1,       21
CPW, 0      , 0      ,        6,        0,        6
CPY, 0.25   , 0.0625 ,       16,        4,       12
CQC, 0.33333, 0.11111,        3,        1,        2
CQD, 0.11111, 0.01235,       27,        3,       24
CQE, 0.1    , 0.01   ,       20,        2,       18
CQF, 0      , 0      ,        8,        0,        8
CQG, 0.07407, 0.00549,       27,        2,       25
CQH, 0.09091, 0.00826,       11,        1,       10
CQI, 0      , 0      ,       13,        0,       13
CQK, 0      , 0      ,       26,        0,       26
CQL, 0.04167, 0.00174,       24,        1,       23
CQM, 0.28571, 0.08163,        7,        2,        5
CQN, 0.23077, 0.05325,       13,        3,       10
CQP, 0      , 0      ,       10,        0,       10
CQQ, 0      , 0      ,       12,        0,       12
CQR, 0.14286, 0.02041,       14,        2,       12
CQS, 0.1    , 0.01   ,       20,        2,       18
CQT, 0.1    , 0.01   ,       20,        2,       18
CQV, 0.23077, 0.05325,       13,        3,       10
CQW, 0      , 0      ,        4,        0,        4
CQY, 0      , 0      ,       16,        0,       16
CRC, 0      , 0      ,        3,        0,        3
CRD, 0.03125, 0.00098,       32,        1,       31
CRE, 0.03571, 0.00128,       28,        1,       27
CRF, 0.16667, 0.02778,       12,        2,       10
CRG, 0.14815, 0.02195,       27,        4,       23
CRH, 0      , 0      ,        8,        0,        8
CRI, 0      , 0      ,       19,        0,       19
CRK, 0.25   , 0.0625 ,       20,        5,       15
CRL, 0.03448, 0.00119,       29,        1,       28
CRM, 0.09091, 0.00826,       11,        1,       10
CRN, 0.11765, 0.01384,       17,        2,       15
CRP, 0.03846, 0.00148,       26,        1,       25
CRQ, 0      , 0      ,       17,        0,       17
CRR, 0.125  , 0.01562,       32,        4,       28
CRS, 0.13333, 0.01778,       15,        2,       13
CRT, 0.05882, 0.00346,       17,        1,       16
CRV, 0.10811, 0.01169,       37,        4,       33
CRW, 0      , 0      ,       12,        0,       12
CRY, 0.07692, 0.00592,       13,        1,       12
CR_, 0      , 0      ,        5,        0,        5
CSC, 0      , 0      ,       10,        0,       10
CSD, 0.18182, 0.03306,       22,        4,       18
CSE, 0      , 0      ,       27,        0,       27
CSF, 0.11538, 0.01331,       26,        3,       23
CSG, 0.02941, 0.00087,       34,        1,       33
CSH, 0      , 0      ,       12,        0,       12
CSI, 0.07143, 0.0051 ,       28,        2,       26
CSK, 0      , 0      ,       26,        0,       26
CSL, 0      , 0      ,       39,        0,       39
CSM, 0      , 0      ,        6,        0,        6
CSN, 0      , 0      ,       13,        0,       13
CSP, 0.04167, 0.00174,       24,        1,       23
CSQ, 0      , 0      ,       16,        0,       16
CSR, 0      , 0      ,       19,        0,       19
CSS, 0.02273, 0.00052,       44,        1,       43
CST, 0      , 0      ,       13,        0,       13
CSV, 0.02857, 0.00082,       35,        1,       34
CSW, 0.16667, 0.02778,        6,        1,        5
CSY, 0      , 0      ,       18,        0,       18
CS_, 0.25   , 0.0625 ,        4,        1,        3
CTC, 0      , 0      ,        6,        0,        6
CTD, 0.125  , 0.01562,       24,        3,       21
CTE, 0.06667, 0.00444,       15,        1,       14
CTF, 0      , 0      ,       15,        0,       15
CTG, 0.11111, 0.01235,       18,        2,       16
CTH, 0      , 0      ,       10,        0,       10
CTI, 0      , 0      ,        9,        0,        9
CTK, 0.04167, 0.00174,       24,        1,       23
CTL, 0.04545, 0.00207,       22,        1,       21
CTM, 0      , 0      ,        6,        0,        6
CTN, 0      , 0      ,       14,        0,       14
CTP, 0.125  , 0.01562,       16,        2,       14
CTQ, 0.08333, 0.00694,       12,        1,       11
CTR, 0.125  , 0.01562,        8,        1,        7
CTS, 0.05   , 0.0025 ,       20,        1,       19
CTT, 0.125  , 0.01562,       24,        3,       21
CTV, 0.03704, 0.00137,       27,        1,       26
CTY, 0      , 0      ,       16,        0,       16
CVC, 0      , 0      ,       11,        0,       11
CVD, 0.05882, 0.00346,       17,        1,       16
CVE, 0      , 0      ,       24,        0,       24
CVF, 0.27273, 0.07438,       11,        3,        8
CVG, 0.08824, 0.00779,       34,        3,       31
CVH, 0.1    , 0.01   ,       10,        1,        9
CVI, 0.04762, 0.00227,       21,        1,       20
CVK, 0.06667, 0.00444,       15,        1,       14
CVL, 0.13333, 0.01778,       30,        4,       26
CVM, 0      , 0      ,        5,        0,        5
CVN, 0      , 0      ,       16,        0,       16
CVP, 0      , 0      ,       21,        0,       21
CVQ, 0      , 0      ,       11,        0,       11
CVR, 0.04545, 0.00207,       22,        1,       21
CVS, 0.15789, 0.02493,       19,        3,       16
CVT, 0      , 0      ,       10,        0,       10
CVV, 0.03448, 0.00119,       29,        1,       28
CVW, 0      , 0      ,        1,        0,        1
CVY, 0.08333, 0.00694,       12,        1,       11
CWD, 0.33333, 0.11111,        6,        2,        4
CWE, 0      , 0      ,        8,        0,        8
CWF, 0      , 0      ,        3,        0,        3
CWG, 0      , 0      ,        8,        0,        8
CWH, 0      , 0      ,        1,        0,        1
CWI, 0      , 0      ,        4,        0,        4
CWL, 0      , 0      ,        6,        0,        6
CWM, 0      , 0      ,        2,        0,        2
CWN, 0      , 0      ,        4,        0,        4
CWP, 0.33333, 0.11111,        6,        2,        4
CWQ, 0.2    , 0.04   ,        5,        1,        4
CWR, 0.14286, 0.02041,        7,        1,        6
CWS, 0.33333, 0.11111,        9,        3,        6
CWT, 0.25   , 0.0625 ,        4,        1,        3
CWV, 0      , 0      ,        1,        0,        1
CWW, 0      , 0      ,        1,        0,        1
CWY, 0      , 0      ,        4,        0,        4
CYC, 0.375  , 0.14062,        8,        3,        5
CYD, 0.16667, 0.02778,       18,        3,       15
CYE, 0.1875 , 0.03516,       16,        3,       13
CYF, 0      , 0      ,        6,        0,        6
CYG, 0.15385, 0.02367,       26,        4,       22
CYH, 0      , 0      ,        6,        0,        6
CYI, 0.16667, 0.02778,       12,        2,       10
CYK, 0      , 0      ,       16,        0,       16
CYL, 0.21053, 0.04432,       19,        4,       15
CYM, 0.16667, 0.02778,        6,        1,        5
CYN, 0.26667, 0.07111,       15,        4,       11
CYP, 0.23077, 0.05325,       13,        3,       10
CYQ, 0.07143, 0.0051 ,       14,        1,       13
CYR, 0.14286, 0.02041,       14,        2,       12
CYS, 0.45   , 0.2025 ,       20,        9,       11
CYT, 0.125  , 0.01562,       16,        2,       14
CYV, 0.13636, 0.0186 ,       22,        3,       19
CYW, 0      , 0      ,        9,        0,        9
CYY, 0      , 0      ,       14,        0,       14
CY_, 0      , 0      ,        1,        0,        1
DAD, 0      , 0      ,       39,        0,       39
DAE, 0.04878, 0.00238,       82,        4,       78
DAF, 0.05556, 0.00309,       54,        3,       51
DAG, 0.06742, 0.00454,       89,        6,       83
DAH, 0.06452, 0.00416,       31,        2,       29
DAI, 0.05556, 0.00309,       90,        5,       85
DAK, 0.01515, 0.00023,       66,        1,       65
DAL, 0.05469, 0.00299,      128,        7,      121
DAM, 0      , 0      ,       32,        0,       32
DAN, 0.04762, 0.00227,       63,        3,       60
DAP, 0.03333, 0.00111,       60,        2,       58
DAQ, 0.04878, 0.00238,       41,        2,       39
DAR, 0.03774, 0.00142,       53,        2,       51
DAS, 0.02439, 0.00059,       82,        2,       80
DAT, 0.06757, 0.00457,       74,        5,       69
DAV, 0.01031, 0.00011,       97,        1,       96
DAW, 0.06667, 0.00444,       15,        1,       14
DAY, 0.01887, 0.00036,       53,        1,       52
DA_, 0      , 0      ,        7,        0,        7
DCD, 0.2    , 0.04   ,       10,        2,        8
DCE, 0      , 0      ,       20,        0,       20
DCF, 0.10526, 0.01108,       19,        2,       17
DCG, 0.15152, 0.02296,       33,        5,       28
DCH, 0      , 0      ,        3,        0,        3
DCI, 0.1    , 0.01   ,       10,        1,        9
DCK, 0.11765, 0.01384,       17,        2,       15
DCL, 0      , 0      ,       34,        0,       34
DCM, 0      , 0      ,       13,        0,       13
DCN, 0.11111, 0.01235,        9,        1,        8
DCP, 0.10526, 0.01108,       19,        2,       17
DCQ, 0.18182, 0.03306,       11,        2,        9
DCR, 0      , 0      ,       16,        0,       16
DCS, 0.03846, 0.00148,       26,        1,       25
DCT, 0.07143, 0.0051 ,       14,        1,       13
DCV, 0.06452, 0.00416,       31,        2,       29
DCW, 0      , 0      ,        6,        0,        6
DCY, 0      , 0      ,       10,        0,       10
DC_, 0      , 0      ,        1,        0,        1
DDD, 0.16   , 0.0256 ,       50,        8,       42
DDE, 0.07407, 0.00549,       81,        6,       75
DDF, 0.06452, 0.00416,       62,        4,       58
DDG, 0.08434, 0.00711,       83,        7,       76
DDH, 0.14286, 0.02041,       21,        3,       18
DDI, 0.10976, 0.01205,       82,        9,       73
DDK, 0.04918, 0.00242,       61,        3,       58
DDL, 0.01515, 0.00023,      132,        2,      130
DDM, 0.1    , 0.01   ,       30,        3,       27
DDN, 0.05714, 0.00327,       35,        2,       33
DDP, 0.04688, 0.0022 ,       64,        3,       61
DDQ, 0.04444, 0.00198,       45,        2,       43
DDR, 0.04255, 0.00181,       47,        2,       45
DDS, 0.0814 , 0.00663,       86,        7,       79
DDT, 0.03226, 0.00104,       62,        2,       60
DDV, 0.05882, 0.00346,       85,        5,       80
DDW, 0.05263, 0.00277,       19,        1,       18
DDY, 0.17021, 0.02897,       47,        8,       39
DD_, 0      , 0      ,        4,        0,        4
DED, 0.03333, 0.00111,       30,        1,       29
DEE, 0.02632, 0.00069,      114,        3,      111
DEF, 0.10448, 0.01092,       67,        7,       60
DEG, 0.06897, 0.00476,       87,        6,       81
DEH, 0.18182, 0.03306,       33,        6,       27
DEI, 0.10345, 0.0107 ,       87,        9,       78
DEK, 0.04494, 0.00202,       89,        4,       85
DEL, 0.06849, 0.00469,      146,       10,      136
DEM, 0.02857, 0.00082,       35,        1,       34
DEN, 0.07692, 0.00592,       78,        6,       72
DEP, 0.04301, 0.00185,       93,        4,       89
DEQ, 0.09091, 0.00826,       55,        5,       50
DER, 0.03077, 0.00095,       65,        2,       63
DES, 0.06897, 0.00476,       87,        6,       81
DET, 0.05376, 0.00289,       93,        5,       88
DEV, 0.05109, 0.00261,      137,        7,      130
DEW, 0.14815, 0.02195,       27,        4,       23
DEY, 0.09091, 0.00826,       66,        6,       60
DE_, 0.1    , 0.01   ,       10,        1,        9
DFD, 0      , 0      ,       29,        0,       29
DFE, 0.08163, 0.00666,       49,        4,       45
DFF, 0.02273, 0.00052,       44,        1,       43
DFG, 0.14493, 0.021  ,       69,       10,       59
DFH, 0.15   , 0.0225 ,       20,        3,       17
DFI, 0.04   , 0.0016 ,       50,        2,       48
DFK, 0.09091, 0.00826,       55,        5,       50
DFL, 0.1413 , 0.01997,       92,       13,       79
DFM, 0.13043, 0.01701,       23,        3,       20
DFN, 0.19149, 0.03667,       47,        9,       38
DFP, 0.02041, 0.00042,       49,        1,       48
DFQ, 0.08571, 0.00735,       35,        3,       32
DFR, 0.02632, 0.00069,       38,        1,       37
DFS, 0.09524, 0.00907,       63,        6,       57
DFT, 0.07692, 0.00592,       52,        4,       48
DFV, 0.10909, 0.0119 ,       55,        6,       49
DFW, 0.11111, 0.01235,       18,        2,       16
DFY, 0.19231, 0.03698,       26,        5,       21
DF_, 0.25   , 0.0625 ,        4,        1,        3
DGD, 0.04545, 0.00207,       44,        2,       42
DGE, 0.03261, 0.00106,       92,        3,       89
DGF, 0.06061, 0.00367,       66,        4,       62
DGG, 0.12   , 0.0144 ,       75,        9,       66
DGH, 0      , 0      ,       35,        0,       35
DGI, 0.03409, 0.00116,       88,        3,       85
DGK, 0      , 0      ,      117,        0,      117
DGL, 0.05085, 0.00259,      118,        6,      112
DGM, 0.03125, 0.00098,       32,        1,       31
DGN, 0.02857, 0.00082,       70,        2,       68
DGP, 0.02151, 0.00046,       93,        2,       91
DGQ, 0.02381, 0.00057,       84,        2,       82
DGR, 0.0202 , 0.00041,       99,        2,       97
DGS, 0.04651, 0.00216,      129,        6,      123
DGT, 0.00971, 0.00009,      103,        1,      102
DGV, 0.03371, 0.00114,       89,        3,       86
DGW, 0.22727, 0.05165,       22,        5,       17
DGY, 0.08333, 0.00694,       60,        5,       55
DG_, 0      , 0      ,        1,        0,        1
DHD, 0.09091, 0.00826,       11,        1,       10
DHE, 0.03448, 0.00119,       29,        1,       28
DHF, 0.13043, 0.01701,       23,        3,       20
DHG, 0.07407, 0.00549,       27,        2,       25
DHH, 0.11111, 0.01235,        9,        1,        8
DHI, 0.03571, 0.00128,       28,        1,       27
DHK, 0.09524, 0.00907,       21,        2,       19
DHL, 0.01852, 0.00034,       54,        1,       53
DHM, 0.125  , 0.01562,        8,        1,        7
DHN, 0.33333, 0.11111,       15,        5,       10
DHP, 0.11111, 0.01235,       18,        2,       16
DHQ, 0.14286, 0.02041,       14,        2,       12
DHR, 0.13636, 0.0186 ,       22,        3,       19
DHS, 0.04545, 0.00207,       22,        1,       21
DHT, 0.10526, 0.01108,       19,        2,       17
DHV, 0.21212, 0.045  ,       33,        7,       26
DHW, 0      , 0      ,        8,        0,        8
DHY, 0      , 0      ,       22,        0,       22
DH_, 0      , 0      ,        1,        0,        1
DID, 0.06977, 0.00487,       43,        3,       40
DIE, 0.08861, 0.00785,       79,        7,       72
DIF, 0.06557, 0.0043 ,       61,        4,       57
DIG, 0.01408, 0.0002 ,       71,        1,       70
DIH, 0.05714, 0.00327,       35,        2,       33
DII, 0.04054, 0.00164,       74,        3,       71
DIK, 0.09259, 0.00857,       54,        5,       49
DIL, 0.05882, 0.00346,      153,        9,      144
DIM, 0.0303 , 0.00092,       33,        1,       32
DIN, 0.01389, 0.00019,       72,        1,       71
DIP, 0.125  , 0.01562,       48,        6,       42
DIQ, 0.02564, 0.00066,       39,        1,       38
DIR, 0.07692, 0.00592,       52,        4,       48
DIS, 0.06173, 0.00381,       81,        5,       76
DIT, 0.12308, 0.01515,       65,        8,       57
DIV, 0.06522, 0.00425,       92,        6,       86
DIW, 0.16667, 0.02778,       18,        3,       15
DIY, 0.09756, 0.00952,       41,        4,       37
DI_, 0      , 0      ,        1,        0,        1
DKD, 0      , 0      ,       37,        0,       37
DKE, 0.02564, 0.00066,      117,        3,      114
DKF, 0.04444, 0.00198,       90,        4,       86
DKG, 0.05435, 0.00295,       92,        5,       87
DKH, 0      , 0      ,       28,        0,       28
DKI, 0.05357, 0.00287,      112,        6,      106
DKK, 0.0375 , 0.00141,       80,        3,       77
DKL, 0.06173, 0.00381,      162,       10,      152
DKM, 0.03333, 0.00111,       30,        1,       29
DKN, 0      , 0      ,       63,        0,       63
DKP, 0.02597, 0.00067,       77,        2,       75
DKQ, 0.04444, 0.00198,       45,        2,       43
DKR, 0.08197, 0.00672,       61,        5,       56
DKS, 0.04   , 0.0016 ,      100,        4,       96
DKT, 0.06849, 0.00469,       73,        5,       68
DKV, 0.06723, 0.00452,      119,        8,      111
DKW, 0.06452, 0.00416,       31,        2,       29
DKY, 0.02941, 0.00087,       68,        2,       66
DK_, 0      , 0      ,        7,        0,        7
DLD, 0.05357, 0.00287,       56,        3,       53
DLE, 0.03571, 0.00128,      140,        5,      135
DLF, 0.06061, 0.00367,       66,        4,       62
DLG, 0.09091, 0.00826,      110,       10,      100
DLH, 0.075  , 0.00562,       40,        3,       37
DLI, 0.07273, 0.00529,      110,        8,      102
DLK, 0.05469, 0.00299,      128,        7,      121
DLL, 0.06404, 0.0041 ,      203,       13,      190
DLM, 0.05405, 0.00292,       37,        2,       35
DLN, 0.09375, 0.00879,       96,        9,       87
DLP, 0.01075, 0.00012,       93,        1,       92
DLQ, 0.04286, 0.00184,       70,        3,       67
DLR, 0.0303 , 0.00092,       99,        3,       96
DLS, 0.02308, 0.00053,      130,        3,      127
DLT, 0.09774, 0.00955,      133,       13,      120
DLV, 0.0411 , 0.00169,      146,        6,      140
DLW, 0      , 0      ,       26,        0,       26
DLY, 0.09722, 0.00945,       72,        7,       65
DL_, 0      , 0      ,       10,        0,       10
DMD, 0.06667, 0.00444,       15,        1,       14
DME, 0      , 0      ,       24,        0,       24
DMF, 0.06452, 0.00416,       31,        2,       29
DMG, 0.09091, 0.00826,       22,        2,       20
DMH, 0      , 0      ,       12,        0,       12
DMI, 0.08824, 0.00779,       34,        3,       31
DMK, 0.08333, 0.00694,       24,        2,       22
DML, 0.09756, 0.00952,       41,        4,       37
DMM, 0.09091, 0.00826,       11,        1,       10
DMN, 0.03846, 0.00148,       26,        1,       25
DMP, 0      , 0      ,       14,        0,       14
DMQ, 0.13333, 0.01778,       15,        2,       13
DMR, 0.1875 , 0.03516,       16,        3,       13
DMS, 0.13889, 0.01929,       36,        5,       31
DMT, 0.10714, 0.01148,       28,        3,       25
DMV, 0.04878, 0.00238,       41,        2,       39
DMW, 0.11111, 0.01235,        9,        1,        8
DMY, 0.21053, 0.04432,       19,        4,       15
DM_, 0      , 0      ,       13,        0,       13
DND, 0.03571, 0.00128,       28,        1,       27
DNE, 0.08333, 0.00694,       60,        5,       55
DNF, 0.02128, 0.00045,       47,        1,       46
DNG, 0.06154, 0.00379,       65,        4,       61
DNH, 0.11765, 0.01384,       17,        2,       15
DNI, 0.04762, 0.00227,       63,        3,       60
DNK, 0.06   , 0.0036 ,       50,        3,       47
DNL, 0.05714, 0.00327,      105,        6,       99
DNM, 0.04545, 0.00207,       22,        1,       21
DNN, 0      , 0      ,       27,        0,       27
DNP, 0.025  , 0.00063,       40,        1,       39
DNQ, 0      , 0      ,       23,        0,       23
DNR, 0.025  , 0.00063,       40,        1,       39
DNS, 0.06522, 0.00425,       46,        3,       43
DNT, 0.01695, 0.00029,       59,        1,       58
DNV, 0.03947, 0.00156,       76,        3,       73
DNW, 0.0625 , 0.00391,       16,        1,       15
DNY, 0.0625 , 0.00391,       32,        2,       30
DN_, 0      , 0      ,        5,        0,        5
DPD, 0.10256, 0.01052,       39,        4,       35
DPE, 0.01316, 0.00017,       76,        1,       75
DPF, 0.05357, 0.00287,       56,        3,       53
DPG, 0      , 0      ,       46,        0,       46
DPH, 0      , 0      ,       36,        0,       36
DPI, 0.05   , 0.0025 ,       60,        3,       57
DPK, 0.01667, 0.00028,       60,        1,       59
DPL, 0.0404 , 0.00163,       99,        4,       95
DPM, 0.1    , 0.01   ,       20,        2,       18
DPN, 0.04762, 0.00227,       84,        4,       80
DPP, 0.03704, 0.00137,       54,        2,       52
DPQ, 0.04651, 0.00216,       43,        2,       41
DPR, 0      , 0      ,       83,        0,       83
DPS, 0.02247, 0.0005 ,       89,        2,       87
DPT, 0.06897, 0.00476,       58,        4,       54
DPV, 0.05479, 0.003  ,       73,        4,       69
DPW, 0      , 0      ,       15,        0,       15
DPY, 0.01887, 0.00036,       53,        1,       52
DP_, 0      , 0      ,        5,        0,        5
DQD, 0.26316, 0.06925,       19,        5,       14
DQE, 0.07143, 0.0051 ,       56,        4,       52
DQF, 0      , 0      ,       30,        0,       30
DQG, 0.05172, 0.00268,       58,        3,       55
DQH, 0      , 0      ,       12,        0,       12
DQI, 0.07246, 0.00525,       69,        5,       64
DQK, 0.05556, 0.00309,       36,        2,       34
DQL, 0.0354 , 0.00125,      113,        4,      109
DQM, 0.08333, 0.00694,       24,        2,       22
DQN, 0.0625 , 0.00391,       32,        2,       30
DQP, 0.04167, 0.00174,       48,        2,       46
DQQ, 0.0303 , 0.00092,       33,        1,       32
DQR, 0      , 0      ,       40,        0,       40
DQS, 0.02222, 0.00049,       45,        1,       44
DQT, 0.075  , 0.00562,       40,        3,       37
DQV, 0.09589, 0.00919,       73,        7,       66
DQW, 0.05556, 0.00309,       18,        1,       17
DQY, 0.03226, 0.00104,       31,        1,       30
DQ_, 0      , 0      ,        4,        0,        4
DRD, 0.02778, 0.00077,       36,        1,       35
DRE, 0.04   , 0.0016 ,       75,        3,       72
DRF, 0.04348, 0.00189,       46,        2,       44
DRG, 0.08219, 0.00676,       73,        6,       67
DRH, 0.11765, 0.01384,       34,        4,       30
DRI, 0.09091, 0.00826,       88,        8,       80
DRK, 0.12963, 0.0168 ,       54,        7,       47
DRL, 0.03306, 0.00109,      121,        4,      117
DRM, 0      , 0      ,       19,        0,       19
DRN, 0.125  , 0.01562,       48,        6,       42
DRP, 0.01852, 0.00034,       54,        1,       53
DRQ, 0      , 0      ,       32,        0,       32
DRR, 0.03333, 0.00111,       30,        1,       29
DRS, 0.09231, 0.00852,       65,        6,       59
DRT, 0.03704, 0.00137,       54,        2,       52
DRV, 0.11957, 0.0143 ,       92,       11,       81
DRW, 0.23529, 0.05536,       17,        4,       13
DRY, 0.13636, 0.0186 ,       44,        6,       38
DR_, 0      , 0      ,        3,        0,        3
DSD, 0.02778, 0.00077,       36,        1,       35
DSE, 0.0274 , 0.00075,       73,        2,       71
DSF, 0.06154, 0.00379,       65,        4,       61
DSG, 0.04348, 0.00189,      115,        5,      110
DSH, 0      , 0      ,       20,        0,       20
DSI, 0.07447, 0.00555,       94,        7,       87
DSK, 0.01299, 0.00017,       77,        1,       76
DSL, 0.02907, 0.00085,      172,        5,      167
DSM, 0.12   , 0.0144 ,       25,        3,       22
DSN, 0.01754, 0.00031,       57,        1,       56
DSP, 0.03077, 0.00095,       65,        2,       63
DSQ, 0.07843, 0.00615,       51,        4,       47
DSR, 0.04918, 0.00242,       61,        3,       58
DSS, 0.11881, 0.01412,      101,       12,       89
DST, 0.05063, 0.00256,       79,        4,       75
DSV, 0.07692, 0.00592,       91,        7,       84
DSW, 0.08   , 0.0064 ,       25,        2,       23
DSY, 0.02222, 0.00049,       45,        1,       44
DS_, 0.08333, 0.00694,       12,        1,       11
DTD, 0      , 0      ,       27,        0,       27
DTE, 0.01613, 0.00026,       62,        1,       61
DTF, 0.04762, 0.00227,       63,        3,       60
DTG, 0.05263, 0.00277,       76,        4,       72
DTH, 0.04545, 0.00207,       22,        1,       21
DTI, 0.06173, 0.00381,       81,        5,       76
DTK, 0.02   , 0.0004 ,       50,        1,       49
DTL, 0.03425, 0.00117,      146,        5,      141
DTM, 0.03448, 0.00119,       29,        1,       28
DTN, 0.06522, 0.00425,       46,        3,       43
DTP, 0.02326, 0.00054,       43,        1,       42
DTQ, 0.06452, 0.00416,       31,        2,       29
DTR, 0      , 0      ,       39,        0,       39
DTS, 0.06024, 0.00363,       83,        5,       78
DTT, 0.01235, 0.00015,       81,        1,       80
DTV, 0.02247, 0.0005 ,       89,        2,       87
DTW, 0.05882, 0.00346,       17,        1,       16
DTY, 0.1087 , 0.01181,       46,        5,       41
DT_, 0      , 0      ,        1,        0,        1
DVD, 0.05263, 0.00277,       38,        2,       36
DVE, 0.06452, 0.00416,       93,        6,       87
DVF, 0.11111, 0.01235,       54,        6,       48
DVG, 0.07595, 0.00577,       79,        6,       73
DVH, 0.07895, 0.00623,       38,        3,       35
DVI, 0.03774, 0.00142,      106,        4,      102
DVK, 0.09333, 0.00871,       75,        7,       68
DVL, 0.04348, 0.00189,      115,        5,      110
DVM, 0.14286, 0.02041,       28,        4,       24
DVN, 0.09231, 0.00852,       65,        6,       59
DVP, 0.04   , 0.0016 ,       75,        3,       72
DVQ, 0.05882, 0.00346,       51,        3,       48
DVR, 0.01887, 0.00036,       53,        1,       52
DVS, 0.03125, 0.00098,       96,        3,       93
DVT, 0.05063, 0.00256,       79,        4,       75
DVV, 0.03448, 0.00119,      116,        4,      112
DVW, 0.16667, 0.02778,       12,        2,       10
DVY, 0.07273, 0.00529,       55,        4,       51
DV_, 0      , 0      ,        5,        0,        5
DWD, 0.05263, 0.00277,       19,        1,       18
DWE, 0.17391, 0.03025,       23,        4,       19
DWF, 0.14286, 0.02041,        7,        1,        6
DWG, 0.19048, 0.03628,       21,        4,       17
DWH, 0      , 0      ,        4,        0,        4
DWI, 0.10526, 0.01108,       19,        2,       17
DWK, 0.13333, 0.01778,       15,        2,       13
DWL, 0.15625, 0.02441,       32,        5,       27
DWM, 0      , 0      ,        8,        0,        8
DWN, 0.13636, 0.0186 ,       22,        3,       19
DWP, 0.2    , 0.04   ,       10,        2,        8
DWQ, 0.08333, 0.00694,       12,        1,       11
DWR, 0      , 0      ,       13,        0,       13
DWS, 0.14286, 0.02041,       21,        3,       18
DWT, 0      , 0      ,       16,        0,       16
DWV, 0.12903, 0.01665,       31,        4,       27
DWW, 0.57143, 0.32653,        7,        4,        3
DWY, 0.11111, 0.01235,        9,        1,        8
DW_, 1      , 1      ,        1,        1,        0
DYD, 0.08   , 0.0064 ,       25,        2,       23
DYE, 0.12308, 0.01515,       65,        8,       57
DYF, 0.08108, 0.00657,       37,        3,       34
DYG, 0.28571, 0.08163,       56,       16,       40
DYH, 0.19231, 0.03698,       26,        5,       21
DYI, 0.13636, 0.0186 ,       66,        9,       57
DYK, 0.15556, 0.0242 ,       45,        7,       38
DYL, 0.17172, 0.02949,       99,       17,       82
DYM, 0.05882, 0.00346,       17,        1,       16
DYN, 0.17949, 0.03222,       39,        7,       32
DYP, 0.23077, 0.05325,       39,        9,       30
DYQ, 0.02564, 0.00066,       39,        1,       38
DYR, 0.06452, 0.00416,       31,        2,       29
DYS, 0.08772, 0.00769,       57,        5,       52
DYT, 0.11538, 0.01331,       52,        6,       46
DYV, 0.06452, 0.00416,       62,        4,       58
DYW, 0.11111, 0.01235,       18,        2,       16
DYY, 0.1875 , 0.03516,       32,        6,       26
DY_, 0      , 0      ,        6,        0,        6
EAE, 0.05797, 0.00336,       69,        4,       65
EAF, 0.10204, 0.01041,       49,        5,       44
EAG, 0.06098, 0.00372,       82,        5,       77
EAH, 0.04348, 0.00189,       23,        1,       22
EAI, 0.03571, 0.00128,       84,        3,       81
EAK, 0.06522, 0.00425,       92,        6,       86
EAL, 0.02294, 0.00053,      218,        5,      213
EAM, 0.05   , 0.0025 ,       40,        2,       38
EAN, 0.02597, 0.00067,       77,        2,       75
EAP, 0.03226, 0.00104,       62,        2,       60
EAQ, 0.06944, 0.00482,       72,        5,       67
EAR, 0.05319, 0.00283,       94,        5,       89
EAS, 0.02532, 0.00064,       79,        2,       77
EAT, 0.03297, 0.00109,       91,        3,       88
EAV, 0.03788, 0.00143,      132,        5,      127
EAW, 0.125  , 0.01562,       16,        2,       14
EAY, 0.06383, 0.00407,       47,        3,       44
EA_, 0      , 0      ,        8,        0,        8
ECE, 0.11111, 0.01235,        9,        1,        8
ECF, 0      , 0      ,       18,        0,       18
ECG, 0      , 0      ,       24,        0,       24
ECH, 0.13333, 0.01778,       15,        2,       13
ECI, 0.05556, 0.00309,       18,        1,       17
ECK, 0      , 0      ,       20,        0,       20
ECL, 0.02778, 0.00077,       36,        1,       35
ECM, 0      , 0      ,        8,        0,        8
ECN, 0.06667, 0.00444,       15,        1,       14
ECP, 0      , 0      ,       15,        0,       15
ECQ, 0      , 0      ,       15,        0,       15
ECR, 0.05   , 0.0025 ,       20,        1,       19
ECS, 0      , 0      ,       24,        0,       24
ECT, 0.07143, 0.0051 ,       14,        1,       13
ECV, 0.06897, 0.00476,       29,        2,       27
ECW, 0      , 0      ,        3,        0,        3
ECY, 0.16667, 0.02778,       12,        2,       10
EC_, 0      , 0      ,        1,        0,        1
EDE, 0.20833, 0.0434 ,       48,       10,       38
EDF, 0.1    , 0.01   ,       60,        6,       54
EDG, 0.05738, 0.00329,      122,        7,      115
EDH, 0.02632, 0.00069,       38,        1,       37
EDI, 0.12397, 0.01537,      121,       15,      106
EDK, 0.03846, 0.00148,       78,        3,       75
EDL, 0.05114, 0.00261,      176,        9,      167
EDM, 0.06667, 0.00444,       45,        3,       42
EDN, 0.125  , 0.01562,       56,        7,       49
EDP, 0.09333, 0.00871,       75,        7,       68
EDQ, 0.16327, 0.02666,       49,        8,       41
EDR, 0      , 0      ,       63,        0,       63
EDS, 0.07059, 0.00498,       85,        6,       79
EDT, 0.06024, 0.00363,       83,        5,       78
EDV, 0.08036, 0.00646,      112,        9,      103
EDW, 0.04762, 0.00227,       21,        1,       20
EDY, 0.07246, 0.00525,       69,        5,       64
ED_, 0.25   , 0.0625 ,        4,        1,        3
EEE, 0.07595, 0.00577,       79,        6,       73
EEF, 0.05495, 0.00302,       91,        5,       86
EEG, 0.04478, 0.002  ,      134,        6,      128
EEH, 0.05263, 0.00277,       38,        2,       36
EEI, 0.06993, 0.00489,      143,       10,      133
EEK, 0.02564, 0.00066,      117,        3,      114
EEL, 0.04231, 0.00179,      260,       11,      249
EEM, 0.01754, 0.00031,       57,        1,       56
EEN, 0.02778, 0.00077,       72,        2,       70
EEP, 0.03509, 0.00123,      114,        4,      110
EEQ, 0.05333, 0.00284,       75,        4,       71
EER, 0.00926, 0.00009,      108,        1,      107
EES, 0.02778, 0.00077,      108,        3,      105
EET, 0.03226, 0.00104,      124,        4,      120
EEV, 0.06338, 0.00402,      142,        9,      133
EEW, 0.10345, 0.0107 ,       29,        3,       26
EEY, 0.08   , 0.0064 ,       75,        6,       69
EE_, 0.1    , 0.01   ,       10,        1,        9
EFE, 0.09375, 0.00879,       32,        3,       29
EFF, 0.09524, 0.00907,       42,        4,       38
EFG, 0.075  , 0.00562,       40,        3,       37
EFH, 0.07692, 0.00592,       13,        1,       12
EFI, 0.08511, 0.00724,       47,        4,       43
EFK, 0.12698, 0.01612,       63,        8,       55
EFL, 0.09524, 0.00907,       84,        8,       76
EFM, 0.0625 , 0.00391,       16,        1,       15
EFN, 0.13636, 0.0186 ,       44,        6,       38
EFP, 0.05263, 0.00277,       38,        2,       36
EFQ, 0.14706, 0.02163,       34,        5,       29
EFR, 0.08   , 0.0064 ,       50,        4,       46
EFS, 0.10976, 0.01205,       82,        9,       73
EFT, 0.06557, 0.0043 ,       61,        4,       57
EFV, 0.125  , 0.01562,       80,       10,       70
EFW, 0.11765, 0.01384,       17,        2,       15
EFY, 0.11538, 0.01331,       26,        3,       23
EF_, 0      , 0      ,        1,        0,        1
EGE, 0      , 0      ,       52,        0,       52
EGF, 0.01667, 0.00028,       60,        1,       59
EGG, 0.05941, 0.00353,      101,        6,       95
EGH, 0.06061, 0.00367,       33,        2,       31
EGI, 0.04   , 0.0016 ,       75,        3,       72
EGK, 0.02632, 0.00069,      114,        3,      111
EGL, 0.03636, 0.00132,      165,        6,      159
EGM, 0.02632, 0.00069,       38,        1,       37
EGN, 0.03704, 0.00137,       81,        3,       78
EGP, 0.03797, 0.00144,       79,        3,       76
EGQ, 0.05634, 0.00317,       71,        4,       67
EGR, 0      , 0      ,       85,        0,       85
EGS, 0.05263, 0.00277,       95,        5,       90
EGT, 0.03297, 0.00109,       91,        3,       88
EGV, 0.02381, 0.00057,       84,        2,       82
EGW, 0.08333, 0.00694,       24,        2,       22
EGY, 0.03571, 0.00128,       56,        2,       54
EG_, 0      , 0      ,        5,        0,        5
EHE, 0      , 0      ,       14,        0,       14
EHF, 0.08696, 0.00756,       23,        2,       21
EHG, 0.02632, 0.00069,       38,        1,       37
EHH, 0.10526, 0.01108,       19,        2,       17
EHI, 0.09375, 0.00879,       32,        3,       29
EHK, 0.11765, 0.01384,       34,        4,       30
EHL, 0.07692, 0.00592,       52,        4,       48
EHM, 0.1875 , 0.03516,       16,        3,       13
EHN, 0.03333, 0.00111,       30,        1,       29
EHP, 0.12121, 0.01469,       33,        4,       29
EHQ, 0.14286, 0.02041,       21,        3,       18
EHR, 0.13636, 0.0186 ,       22,        3,       19
EHS, 0.16667, 0.02778,       24,        4,       20
EHT, 0.28   , 0.0784 ,       25,        7,       18
EHV, 0.05   , 0.0025 ,       40,        2,       38
EHW, 0      , 0      ,        6,        0,        6
EHY, 0.09524, 0.00907,       21,        2,       19
EH_, 0      , 0      ,        2,        0,        2
EIE, 0.04255, 0.00181,       47,        2,       45
EIF, 0.10526, 0.01108,       38,        4,       34
EIG, 0.06522, 0.00425,       92,        6,       86
EIH, 0.03704, 0.00137,       27,        1,       26
EII, 0.05556, 0.00309,       72,        4,       68
EIK, 0.07407, 0.00549,       81,        6,       75
EIL, 0.05645, 0.00319,      124,        7,      117
EIM, 0.12   , 0.0144 ,       25,        3,       22
EIN, 0.06349, 0.00403,       63,        4,       59
EIP, 0.10448, 0.01092,       67,        7,       60
EIQ, 0.10204, 0.01041,       49,        5,       44
EIR, 0.04615, 0.00213,       65,        3,       62
EIS, 0.08989, 0.00808,       89,        8,       81
EIT, 0.02532, 0.00064,       79,        2,       77
EIV, 0.03846, 0.00148,       78,        3,       75
EIW, 0      , 0      ,       15,        0,       15
EIY, 0.04762, 0.00227,       42,        2,       40
EI_, 0.25   , 0.0625 ,        4,        1,        3
EKE, 0.02632, 0.00069,       76,        2,       74
EKF, 0.07229, 0.00523,       83,        6,       77
EKG, 0.01681, 0.00028,      119,        2,      117
EKH, 0.02941, 0.00087,       34,        1,       33
EKI, 0.06667, 0.00444,      135,        9,      126
EKK, 0.09901, 0.0098 ,      101,       10,       91
EKL, 0.05159, 0.00266,      252,       13,      239
EKM, 0.1    , 0.01   ,       70,        7,       63
EKN, 0.04225, 0.00179,       71,        3,       68
EKP, 0.02247, 0.0005 ,       89,        2,       87
EKQ, 0.03571, 0.00128,       56,        2,       54
EKR, 0.03614, 0.00131,       83,        3,       80
EKS, 0.05405, 0.00292,       74,        4,       70
EKT, 0.02273, 0.00052,       88,        2,       86
EKV, 0.05512, 0.00304,      127,        7,      120
EKW, 0.08696, 0.00756,       23,        2,       21
EKY, 0.0641 , 0.00411,       78,        5,       73
EK_, 0      , 0      ,        7,        0,        7
ELE, 0.08696, 0.00756,       69,        6,       63
ELF, 0.10345, 0.0107 ,       87,        9,       78
ELG, 0.10448, 0.01092,      134,       14,      120
ELH, 0.03509, 0.00123,       57,        2,       55
ELI, 0.05625, 0.00316,      160,        9,      151
ELK, 0.05224, 0.00273,      134,        7,      127
ELL, 0.0449 , 0.00202,      245,       11,      234
ELM, 0.02778, 0.00077,       72,        2,       70
ELN, 0.06024, 0.00363,       83,        5,       78
ELP, 0.05556, 0.00309,       90,        5,       85
ELQ, 0.05769, 0.00333,      104,        6,       98
ELR, 0.04762, 0.00227,      105,        5,      100
ELS, 0.06569, 0.00432,      137,        9,      128
ELT, 0.05217, 0.00272,      115,        6,      109
ELV, 0.0479 , 0.00229,      167,        8,      159
ELW, 0      , 0      ,       19,        0,       19
ELY, 0.05128, 0.00263,       78,        4,       74
EL_, 0      , 0      ,        6,        0,        6
EME, 0.04545, 0.00207,       22,        1,       21
EMF, 0.04   , 0.0016 ,       25,        1,       24
EMG, 0.09302, 0.00865,       43,        4,       39
EMH, 0.1875 , 0.03516,       16,        3,       13
EMI, 0.21212, 0.045  ,       33,        7,       26
EMK, 0.03226, 0.00104,       31,        1,       30
EML, 0.05455, 0.00298,       55,        3,       52
EMM, 0      , 0      ,        9,        0,        9
EMN, 0.08   , 0.0064 ,       25,        2,       23
EMP, 0.11765, 0.01384,       17,        2,       15
EMQ, 0.03846, 0.00148,       26,        1,       25
EMR, 0.14286, 0.02041,       21,        3,       18
EMS, 0.03333, 0.00111,       30,        1,       29
EMT, 0.07143, 0.0051 ,       28,        2,       26
EMV, 0.02564, 0.00066,       39,        1,       38
EMW, 0      , 0      ,        5,        0,        5
EMY, 0.07143, 0.0051 ,       14,        1,       13
EM_, 0.15385, 0.02367,       13,        2,       11
ENE, 0.02128, 0.00045,       47,        1,       46
ENF, 0.01449, 0.00021,       69,        1,       68
ENG, 0.03883, 0.00151,      103,        4,       99
ENH, 0      , 0      ,       14,        0,       14
ENI, 0.04386, 0.00192,      114,        5,      109
ENK, 0.04348, 0.00189,       69,        3,       66
ENL, 0.04762, 0.00227,      126,        6,      120
ENM, 0.09375, 0.00879,       32,        3,       29
ENN, 0.02564, 0.00066,       39,        1,       38
ENP, 0.03704, 0.00137,       54,        2,       52
ENQ, 0.05714, 0.00327,       35,        2,       33
ENR, 0.01887, 0.00036,       53,        1,       52
ENS, 0.03226, 0.00104,       62,        2,       60
ENT, 0.03448, 0.00119,       58,        2,       56
ENV, 0.05556, 0.00309,       90,        5,       85
ENW, 0.05556, 0.00309,       18,        1,       17
ENY, 0.025  , 0.00063,       40,        1,       39
EN_, 0.14286, 0.02041,        7,        1,        6
EPE, 0      , 0      ,       34,        0,       34
EPF, 0.09259, 0.00857,       54,        5,       49
EPG, 0.01266, 0.00016,       79,        1,       78
EPH, 0.02941, 0.00087,       34,        1,       33
EPI, 0.08571, 0.00735,       70,        6,       64
EPK, 0.04286, 0.00184,       70,        3,       67
EPL, 0.04545, 0.00207,      132,        6,      126
EPM, 0.1    , 0.01   ,       20,        2,       18
EPN, 0      , 0      ,       65,        0,       65
EPP, 0.06061, 0.00367,       66,        4,       62
EPQ, 0      , 0      ,       56,        0,       56
EPR, 0.01538, 0.00024,       65,        1,       64
EPS, 0.02247, 0.0005 ,       89,        2,       87
EPT, 0.025  , 0.00063,       80,        2,       78
EPV, 0.07527, 0.00567,       93,        7,       86
EPW, 0.08333, 0.00694,       24,        2,       22
EPY, 0.04444, 0.00198,       45,        2,       43
EP_, 0      , 0      ,        8,        0,        8
EQE, 0.03333, 0.00111,       30,        1,       29
EQF, 0.07273, 0.00529,       55,        4,       51
EQG, 0.04918, 0.00242,       61,        3,       58
EQH, 0.09091, 0.00826,       22,        2,       20
EQI, 0.02899, 0.00084,       69,        2,       67
EQK, 0.02857, 0.00082,       70,        2,       68
EQL, 0.05952, 0.00354,      168,       10,      158
EQM, 0.05405, 0.00292,       37,        2,       35
EQN, 0.04762, 0.00227,       42,        2,       40
EQP, 0.08163, 0.00666,       49,        4,       45
EQQ, 0.14634, 0.02142,       41,        6,       35
EQR, 0.03448, 0.00119,       58,        2,       56
EQS, 0.1087 , 0.01181,       46,        5,       41
EQT, 0      , 0      ,       33,        0,       33
EQV, 0.07595, 0.00577,       79,        6,       73
EQW, 0.14286, 0.02041,       21,        3,       18
EQY, 0.06522, 0.00425,       46,        3,       43
EQ_, 0.09091, 0.00826,       11,        1,       10
ERE, 0.05769, 0.00333,       52,        3,       49
ERF, 0.0303 , 0.00092,       66,        2,       64
ERG, 0.13043, 0.01701,       69,        9,       60
ERH, 0      , 0      ,       28,        0,       28
ERI, 0.15044, 0.02263,      113,       17,       96
ERK, 0.01408, 0.0002 ,       71,        1,       70
ERL, 0.06395, 0.00409,      172,       11,      161
ERM, 0      , 0      ,       29,        0,       29
ERN, 0.06122, 0.00375,       49,        3,       46
ERP, 0.06452, 0.00416,       62,        4,       58
ERQ, 0.05882, 0.00346,       51,        3,       48
ERR, 0.09375, 0.00879,       64,        6,       58
ERS, 0.12195, 0.01487,       82,       10,       72
ERT, 0.0597 , 0.00356,       67,        4,       63
ERV, 0.09016, 0.00813,      122,       11,      111
ERW, 0      , 0      ,       20,        0,       20
ERY, 0.02083, 0.00043,       48,        1,       47
ER_, 0      , 0      ,        2,        0,        2
ESE, 0.08571, 0.00735,       35,        3,       32
ESF, 0.08696, 0.00756,       69,        6,       63
ESG, 0.01176, 0.00014,       85,        1,       84
ESH, 0.15385, 0.02367,       26,        4,       22
ESI, 0.03947, 0.00156,       76,        3,       73
ESK, 0.0375 , 0.00141,       80,        3,       77
ESL, 0.01546, 0.00024,      194,        3,      191
ESM, 0.12903, 0.01665,       31,        4,       27
ESN, 0.04918, 0.00242,       61,        3,       58
ESP, 0.03279, 0.00107,       61,        2,       59
ESQ, 0      , 0      ,       52,        0,       52
ESR, 0.01493, 0.00022,       67,        1,       66
ESS, 0.07955, 0.00633,       88,        7,       81
EST, 0.09434, 0.0089 ,       53,        5,       48
ESV, 0.01111, 0.00012,       90,        1,       89
ESW, 0.03846, 0.00148,       26,        1,       25
ESY, 0.06522, 0.00425,       46,        3,       43
ES_, 0.11765, 0.01384,       17,        2,       15
ETE, 0      , 0      ,       36,        0,       36
ETF, 0.03846, 0.00148,       52,        2,       50
ETG, 0      , 0      ,       99,        0,       99
ETH, 0      , 0      ,       22,        0,       22
ETI, 0.11   , 0.0121 ,      100,       11,       89
ETK, 0.08219, 0.00676,       73,        6,       67
ETL, 0.04217, 0.00178,      166,        7,      159
ETM, 0.05882, 0.00346,       34,        2,       32
ETN, 0.05556, 0.00309,       54,        3,       51
ETP, 0.01818, 0.00033,       55,        1,       54
ETQ, 0      , 0      ,       41,        0,       41
ETR, 0.05556, 0.00309,       54,        3,       51
ETS, 0.04412, 0.00195,       68,        3,       65
ETT, 0.01667, 0.00028,       60,        1,       59
ETV, 0.02752, 0.00076,      109,        3,      106
ETW, 0.17391, 0.03025,       23,        4,       19
ETY, 0.05128, 0.00263,       39,        2,       37
ET_, 0.16667, 0.02778,        6,        1,        5
EVE, 0.07042, 0.00496,       71,        5,       66
EVF, 0.03947, 0.00156,       76,        3,       73
EVG, 0.05495, 0.00302,       91,        5,       86
EVH, 0.04167, 0.00174,       24,        1,       23
EVI, 0.02752, 0.00076,      109,        3,      106
EVK, 0.03614, 0.00131,       83,        3,       80
EVL, 0.02548, 0.00065,      157,        4,      153
EVM, 0.0303 , 0.00092,       33,        1,       32
EVN, 0.01449, 0.00021,       69,        1,       68
EVP, 0.04762, 0.00227,       84,        4,       80
EVQ, 0.01613, 0.00026,       62,        1,       61
EVR, 0.02469, 0.00061,       81,        2,       79
EVS, 0.10417, 0.01085,       96,       10,       86
EVT, 0.0495 , 0.00245,      101,        5,       96
EVV, 0.06977, 0.00487,      129,        9,      120
EVW, 0      , 0      ,       14,        0,       14
EVY, 0.10638, 0.01132,       47,        5,       42
EV_, 0      , 0      ,        4,        0,        4
EWE, 0      , 0      ,        6,        0,        6
EWF, 0.375  , 0.14062,       16,        6,       10
EWG, 0.09091, 0.00826,       33,        3,       30
EWH, 0.125  , 0.01562,        8,        1,        7
EWI, 0.13043, 0.01701,       23,        3,       20
EWK, 0.12903, 0.01665,       31,        4,       27
EWL, 0.03704, 0.00137,       27,        1,       26
EWM, 0.22222, 0.04938,        9,        2,        7
EWN, 0.25   , 0.0625 ,       12,        3,        9
EWP, 0.06667, 0.00444,       15,        1,       14
EWQ, 0.4    , 0.16   ,       15,        6,        9
EWR, 0.16667, 0.02778,       24,        4,       20
EWS, 0.11765, 0.01384,       17,        2,       15
EWT, 0.13333, 0.01778,       30,        4,       26
EWV, 0.10714, 0.01148,       28,        3,       25
EWW, 0.42857, 0.18367,        7,        3,        4
EWY, 0.16667, 0.02778,       18,        3,       15
EYE, 0.03226, 0.00104,       31,        1,       30
EYF, 0.13953, 0.01947,       43,        6,       37
EYG, 0.12069, 0.01457,       58,        7,       51
EYH, 0.08333, 0.00694,       24,        2,       22
EYI, 0.05357, 0.00287,       56,        3,       53
EYK, 0.15517, 0.02408,       58,        9,       49
EYL, 0.08696, 0.00756,       92,        8,       84
EYM, 0.15789, 0.02493,       19,        3,       16
EYN, 0.02439, 0.00059,       41,        1,       40
EYP, 0.17143, 0.02939,       35,        6,       29
EYQ, 0.08   , 0.0064 ,       25,        2,       23
EYR, 0.075  , 0.00562,       40,        3,       37
EYS, 0.04348, 0.00189,       46,        2,       44
EYT, 0.18519, 0.03429,       54,       10,       44
EYV, 0.12281, 0.01508,       57,        7,       50
EYW, 0.10526, 0.01108,       19,        2,       17
EYY, 0.23077, 0.05325,       39,        9,       30
EY_, 0      , 0      ,        4,        0,        4
FAF, 0.35714, 0.12755,       14,        5,        9
FAG, 0.08065, 0.0065 ,       62,        5,       57
FAH, 0.11765, 0.01384,       17,        2,       15
FAI, 0.07692, 0.00592,       39,        3,       36
FAK, 0.0303 , 0.00092,       66,        2,       64
FAL, 0.06   , 0.0036 ,       50,        3,       47
FAM, 0.1    , 0.01   ,       20,        2,       18
FAN, 0.13043, 0.01701,       46,        6,       40
FAP, 0      , 0      ,       50,        0,       50
FAQ, 0.02564, 0.00066,       39,        1,       38
FAR, 0.04651, 0.00216,       43,        2,       41
FAS, 0.0678 , 0.0046 ,       59,        4,       55
FAT, 0.05128, 0.00263,       39,        2,       37
FAV, 0.10638, 0.01132,       47,        5,       42
FAW, 0.4    , 0.16   ,        5,        2,        3
FAY, 0.09524, 0.00907,       21,        2,       19
FA_, 0      , 0      ,        5,        0,        5
FCF, 0.5    , 0.25   ,        2,        1,        1
FCG, 0.05556, 0.00309,       18,        1,       17
FCH, 0.125  , 0.01562,        8,        1,        7
FCI, 0      , 0      ,        7,        0,        7
FCK, 0      , 0      ,       16,        0,       16
FCL, 0      , 0      ,       15,        0,       15
FCM, 0      , 0      ,        4,        0,        4
FCN, 0      , 0      ,       17,        0,       17
FCP, 0.05556, 0.00309,       18,        1,       17
FCQ, 0      , 0      ,        6,        0,        6
FCR, 0      , 0      ,       12,        0,       12
FCS, 0      , 0      ,       22,        0,       22
FCT, 0.125  , 0.01562,        8,        1,        7
FCV, 0.25   , 0.0625 ,        8,        2,        6
FCW, 0      , 0      ,        3,        0,        3
FCY, 0.13333, 0.01778,       15,        2,       13
FDF, 0.10345, 0.0107 ,       29,        3,       26
FDG, 0.03797, 0.00144,       79,        3,       76
FDH, 0.04762, 0.00227,       21,        1,       20
FDI, 0      , 0      ,       49,        0,       49
FDK, 0.05128, 0.00263,       78,        4,       74
FDL, 0.1    , 0.01   ,       90,        9,       81
FDM, 0      , 0      ,       17,        0,       17
FDN, 0.04444, 0.00198,       45,        2,       43
FDP, 0.04255, 0.00181,       47,        2,       45
FDQ, 0.05882, 0.00346,       34,        2,       32
FDR, 0.025  , 0.00063,       40,        1,       39
FDS, 0.0597 , 0.00356,       67,        4,       63
FDT, 0.04   , 0.0016 ,       75,        3,       72
FDV, 0.06667, 0.00444,       75,        5,       70
FDW, 0.11111, 0.01235,       18,        2,       16
FDY, 0      , 0      ,       28,        0,       28
FD_, 0      , 0      ,        9,        0,        9
FEF, 0.09524, 0.00907,       21,        2,       19
FEG, 0.0411 , 0.00169,       73,        3,       70
FEH, 0.04545, 0.00207,       22,        1,       21
FEI, 0.11321, 0.01282,       53,        6,       47
FEK, 0.07843, 0.00615,      102,        8,       94
FEL, 0.05063, 0.00256,       79,        4,       75
FEM, 0.17391, 0.03025,       23,        4,       19
FEN, 0.02778, 0.00077,       36,        1,       35
FEP, 0.03704, 0.00137,       54,        2,       52
FEQ, 0.02273, 0.00052,       44,        1,       43
FER, 0.03175, 0.00101,       63,        2,       61
FES, 0.07407, 0.00549,       54,        4,       50
FET, 0.03636, 0.00132,       55,        2,       53
FEV, 0.06154, 0.00379,       65,        4,       61
FEW, 0.11111, 0.01235,        9,        1,        8
FEY, 0.09091, 0.00826,       33,        3,       30
FE_, 0      , 0      ,        2,        0,        2
FFF, 0.11111, 0.01235,        9,        1,        8
FFG, 0.02778, 0.00077,       36,        1,       35
FFH, 0.22222, 0.04938,       18,        4,       14
FFI, 0.06897, 0.00476,       29,        2,       27
FFK, 0.11429, 0.01306,       35,        4,       31
FFL, 0.13793, 0.01902,       29,        4,       25
FFM, 0.18182, 0.03306,       11,        2,        9
FFN, 0.03333, 0.00111,       30,        1,       29
FFP, 0.14815, 0.02195,       27,        4,       23
FFQ, 0.11765, 0.01384,       17,        2,       15
FFR, 0.15385, 0.02367,       39,        6,       33
FFS, 0.07692, 0.00592,       39,        3,       36
FFT, 0.09677, 0.00937,       31,        3,       28
FFV, 0.12   , 0.0144 ,       25,        3,       22
FFW, 0      , 0      ,        6,        0,        6
FFY, 0.05882, 0.00346,       17,        1,       16
FGF, 0.12   , 0.0144 ,       25,        3,       22
FGG, 0.13208, 0.01744,       53,        7,       46
FGH, 0.04348, 0.00189,       23,        1,       22
FGI, 0.04878, 0.00238,       41,        2,       39
FGK, 0.04545, 0.00207,       66,        3,       63
FGL, 0.15116, 0.02285,       86,       13,       73
FGM, 0      , 0      ,       17,        0,       17
FGN, 0.02564, 0.00066,       39,        1,       38
FGP, 0.02041, 0.00042,       49,        1,       48
FGQ, 0.025  , 0.00063,       40,        1,       39
FGR, 0.13636, 0.0186 ,       44,        6,       38
FGS, 0.06579, 0.00433,       76,        5,       71
FGT, 0.05769, 0.00333,       52,        3,       49
FGV, 0.08889, 0.0079 ,       45,        4,       41
FGW, 0.2    , 0.04   ,       10,        2,        8
FGY, 0.14634, 0.02142,       41,        6,       35
FG_, 0      , 0      ,        3,        0,        3
FHF, 0      , 0      ,       10,        0,       10
FHG, 0.06897, 0.00476,       29,        2,       27
FHH, 0      , 0      ,        5,        0,        5
FHI, 0.12   , 0.0144 ,       25,        3,       22
FHK, 0.04545, 0.00207,       22,        1,       21
FHL, 0.07317, 0.00535,       41,        3,       38
FHM, 0      , 0      ,       10,        0,       10
FHN, 0.125  , 0.01562,       16,        2,       14
FHP, 0.07692, 0.00592,       26,        2,       24
FHQ, 0.08   , 0.0064 ,       25,        2,       23
FHR, 0.04348, 0.00189,       23,        1,       22
FHS, 0.07143, 0.0051 ,       42,        3,       39
FHT, 0.04762, 0.00227,       21,        1,       20
FHV, 0.125  , 0.01562,       24,        3,       21
FHY, 0      , 0      ,       16,        0,       16
FIF, 0.11765, 0.01384,       17,        2,       15
FIG, 0.13725, 0.01884,       51,        7,       44
FIH, 0      , 0      ,       21,        0,       21
FII, 0.02778, 0.00077,       36,        1,       35
FIK, 0.04082, 0.00167,       49,        2,       47
FIL, 0.05455, 0.00298,       55,        3,       52
FIM, 0.06667, 0.00444,       15,        1,       14
FIN, 0.11538, 0.01331,       52,        6,       46
FIP, 0.0303 , 0.00092,       33,        1,       32
FIQ, 0.03125, 0.00098,       32,        1,       31
FIR, 0      , 0      ,       32,        0,       32
FIS, 0      , 0      ,       46,        0,       46
FIT, 0      , 0      ,       47,        0,       47
FIV, 0.07317, 0.00535,       41,        3,       38
FIW, 0      , 0      ,        2,        0,        2
FIY, 0.04167, 0.00174,       24,        1,       23
FI_, 0      , 0      ,        1,        0,        1
FKF, 0.1875 , 0.03516,       16,        3,       13
FKG, 0.05714, 0.00327,       70,        4,       66
FKH, 0.11765, 0.01384,       17,        2,       15
FKI, 0.02899, 0.00084,       69,        2,       67
FKK, 0.06061, 0.00367,       66,        4,       62
FKL, 0.06329, 0.00401,       79,        5,       74
FKM, 0.1    , 0.01   ,       10,        1,        9
FKN, 0.07547, 0.0057 ,       53,        4,       49
FKP, 0.09091, 0.00826,       33,        3,       30
FKQ, 0.06   , 0.0036 ,       50,        3,       47
FKR, 0.04082, 0.00167,       49,        2,       47
FKS, 0.07843, 0.00615,       51,        4,       47
FKT, 0.07317, 0.00535,       41,        3,       38
FKV, 0.13333, 0.01778,       90,       12,       78
FKW, 0      , 0      ,       11,        0,       11
FKY, 0.02703, 0.00073,       37,        1,       36
FK_, 0      , 0      ,        3,        0,        3
FLF, 0.0625 , 0.00391,       16,        1,       15
FLG, 0.06024, 0.00363,       83,        5,       78
FLH, 0.06061, 0.00367,       33,        2,       31
FLI, 0      , 0      ,       38,        0,       38
FLK, 0.08537, 0.00729,       82,        7,       75
FLL, 0.16456, 0.02708,       79,       13,       66
FLM, 0.17647, 0.03114,       17,        3,       14
FLN, 0.11667, 0.01361,       60,        7,       53
FLP, 0.03774, 0.00142,       53,        2,       51
FLQ, 0.03636, 0.00132,       55,        2,       53
FLR, 0.03614, 0.00131,       83,        3,       80
FLS, 0.12329, 0.0152 ,       73,        9,       64
FLT, 0.04054, 0.00164,       74,        3,       71
FLV, 0.08451, 0.00714,       71,        6,       65
FLW, 0.07692, 0.00592,       13,        1,       12
FLY, 0.08   , 0.0064 ,       25,        2,       23
FL_, 0      , 0      ,        2,        0,        2
FMF, 0      , 0      ,        4,        0,        4
FMG, 0.08333, 0.00694,       12,        1,       11
FMH, 0.18182, 0.03306,       11,        2,        9
FMI, 0.125  , 0.01562,        8,        1,        7
FMK, 0.05263, 0.00277,       19,        1,       18
FML, 0.09091, 0.00826,       22,        2,       20
FMM, 0      , 0      ,        3,        0,        3
FMN, 0.16667, 0.02778,       12,        2,       10
FMP, 0.15385, 0.02367,       13,        2,       11
FMQ, 0      , 0      ,       15,        0,       15
FMR, 0.14286, 0.02041,        7,        1,        6
FMS, 0.18182, 0.03306,       11,        2,        9
FMT, 0.125  , 0.01562,       16,        2,       14
FMV, 0.17647, 0.03114,       17,        3,       14
FMW, 0      , 0      ,        4,        0,        4
FMY, 0.125  , 0.01562,        8,        1,        7
FM_, 0      , 0      ,        3,        0,        3
FNF, 0      , 0      ,       10,        0,       10
FNG, 0.10909, 0.0119 ,       55,        6,       49
FNH, 0      , 0      ,       19,        0,       19
FNI, 0.11111, 0.01235,       36,        4,       32
FNK, 0.03333, 0.00111,       60,        2,       58
FNL, 0.14286, 0.02041,       56,        8,       48
FNM, 0      , 0      ,       22,        0,       22
FNN, 0.02564, 0.00066,       39,        1,       38
FNP, 0.05128, 0.00263,       39,        2,       37
FNQ, 0      , 0      ,       40,        0,       40
FNR, 0.06977, 0.00487,       43,        3,       40
FNS, 0.03774, 0.00142,       53,        2,       51
FNT, 0.13636, 0.0186 ,       44,        6,       38
FNV, 0.11364, 0.01291,       44,        5,       39
FNW, 0.1    , 0.01   ,       10,        1,        9
FNY, 0.05714, 0.00327,       35,        2,       33
FN_, 0      , 0      ,        3,        0,        3
FPF, 0      , 0      ,       15,        0,       15
FPG, 0.0339 , 0.00115,       59,        2,       57
FPH, 0      , 0      ,       19,        0,       19
FPI, 0.05556, 0.00309,       36,        2,       34
FPK, 0.04762, 0.00227,       42,        2,       40
FPL, 0.05634, 0.00317,       71,        4,       67
FPM, 0.1    , 0.01   ,       10,        1,        9
FPN, 0.08571, 0.00735,       35,        3,       32
FPP, 0.06061, 0.00367,       33,        2,       31
FPQ, 0.03448, 0.00119,       29,        1,       28
FPR, 0.03125, 0.00098,       32,        1,       31
FPS, 0.15556, 0.0242 ,       45,        7,       38
FPT, 0      , 0      ,       37,        0,       37
FPV, 0.07692, 0.00592,       52,        4,       48
FPW, 0.07143, 0.0051 ,       14,        1,       13
FPY, 0.08   , 0.0064 ,       25,        2,       23
FP_, 0      , 0      ,        5,        0,        5
FQF, 0      , 0      ,       17,        0,       17
FQG, 0.04255, 0.00181,       47,        2,       45
FQH, 0.23529, 0.05536,       17,        4,       13
FQI, 0.10526, 0.01108,       38,        4,       34
FQK, 0.04762, 0.00227,       42,        2,       40
FQL, 0.07317, 0.00535,       41,        3,       38
FQM, 0      , 0      ,       21,        0,       21
FQN, 0.05263, 0.00277,       38,        2,       36
FQP, 0      , 0      ,       31,        0,       31
FQQ, 0.05556, 0.00309,       36,        2,       34
FQR, 0.03125, 0.00098,       32,        1,       31
FQS, 0.09091, 0.00826,       44,        4,       40
FQT, 0.03125, 0.00098,       32,        1,       31
FQV, 0      , 0      ,       47,        0,       47
FQW, 0.1    , 0.01   ,       10,        1,        9
FQY, 0.09375, 0.00879,       32,        3,       29
FQ_, 0      , 0      ,        3,        0,        3
FRF, 0.0625 , 0.00391,       16,        1,       15
FRG, 0.01562, 0.00024,       64,        1,       63
FRH, 0.1    , 0.01   ,       20,        2,       18
FRI, 0.07143, 0.0051 ,       42,        3,       39
FRK, 0.14286, 0.02041,       49,        7,       42
FRL, 0.0241 , 0.00058,       83,        2,       81
FRM, 0.13333, 0.01778,       15,        2,       13
FRN, 0.02857, 0.00082,       35,        1,       34
FRP, 0.05128, 0.00263,       39,        2,       37
FRQ, 0.025  , 0.00063,       40,        1,       39
FRR, 0.12821, 0.01644,       39,        5,       34
FRS, 0.06061, 0.00367,       66,        4,       62
FRT, 0.07895, 0.00623,       38,        3,       35
FRV, 0.08642, 0.00747,       81,        7,       74
FRW, 0.25   , 0.0625 ,        4,        1,        3
FRY, 0.11429, 0.01306,       35,        4,       31
FSF, 0.20833, 0.0434 ,       24,        5,       19
FSG, 0.05797, 0.00336,       69,        4,       65
FSH, 0.04   , 0.0016 ,       25,        1,       24
FSI, 0.16393, 0.02687,       61,       10,       51
FSK, 0.0814 , 0.00663,       86,        7,       79
FSL, 0.06   , 0.0036 ,      100,        6,       94
FSM, 0.04762, 0.00227,       21,        1,       20
FSN, 0.06   , 0.0036 ,       50,        3,       47
FSP, 0.01754, 0.00031,       57,        1,       56
FSQ, 0.06522, 0.00425,       46,        3,       43
FSR, 0.05357, 0.00287,       56,        3,       53
FSS, 0.03846, 0.00148,       52,        2,       50
FST, 0.06154, 0.00379,       65,        4,       61
FSV, 0.09639, 0.00929,       83,        8,       75
FSW, 0.09091, 0.00826,       11,        1,       10
FSY, 0.0625 , 0.00391,       32,        2,       30
FS_, 0.125  , 0.01562,        8,        1,        7
FTF, 0      , 0      ,       22,        0,       22
FTG, 0.0566 , 0.0032 ,       53,        3,       50
FTH, 0.04167, 0.00174,       24,        1,       23
FTI, 0.04082, 0.00167,       49,        2,       47
FTK, 0.03448, 0.00119,       58,        2,       56
FTL, 0.09195, 0.00846,       87,        8,       79
FTM, 0.1    , 0.01   ,       20,        2,       18
FTN, 0.06818, 0.00465,       44,        3,       41
FTP, 0.03636, 0.00132,       55,        2,       53
FTQ, 0.02041, 0.00042,       49,        1,       48
FTR, 0.05882, 0.00346,       51,        3,       48
FTS, 0.15385, 0.02367,       65,       10,       55
FTT, 0.03774, 0.00142,       53,        2,       51
FTV, 0.05634, 0.00317,       71,        4,       67
FTW, 0      , 0      ,       18,        0,       18
FTY, 0      , 0      ,       28,        0,       28
FT_, 0      , 0      ,        2,        0,        2
FVF, 0      , 0      ,        8,        0,        8
FVG, 0.07692, 0.00592,       65,        5,       60
FVH, 0.1    , 0.01   ,       20,        2,       18
FVI, 0.075  , 0.00562,       40,        3,       37
FVK, 0.03846, 0.00148,       52,        2,       50
FVL, 0.0678 , 0.0046 ,       59,        4,       55
FVM, 0      , 0      ,       17,        0,       17
FVN, 0.0566 , 0.0032 ,       53,        3,       50
FVP, 0.08511, 0.00724,       47,        4,       43
FVQ, 0.07317, 0.00535,       41,        3,       38
FVR, 0.1    , 0.01   ,       60,        6,       54
FVS, 0.07143, 0.0051 ,       56,        4,       52
FVT, 0.05   , 0.0025 ,       40,        2,       38
FVV, 0      , 0      ,       46,        0,       46
FVW, 0      , 0      ,        9,        0,        9
FVY, 0.10526, 0.01108,       19,        2,       17
FV_, 0      , 0      ,        2,        0,        2
FWF, 0      , 0      ,        3,        0,        3
FWG, 0.25   , 0.0625 ,       12,        3,        9
FWH, 0      , 0      ,        1,        0,        1
FWI, 0      , 0      ,       13,        0,       13
FWK, 0.05882, 0.00346,       17,        1,       16
FWL, 0.0625 , 0.00391,       16,        1,       15
FWM, 0      , 0      ,        5,        0,        5
FWN, 0.25   , 0.0625 ,        8,        2,        6
FWP, 0.35714, 0.12755,       14,        5,        9
FWQ, 0.44444, 0.19753,        9,        4,        5
FWR, 0.15385, 0.02367,       13,        2,       11
FWS, 0.2    , 0.04   ,       10,        2,        8
FWT, 0      , 0      ,        8,        0,        8
FWV, 0      , 0      ,       12,        0,       12
FWW, 0      , 0      ,        5,        0,        5
FWY, 0.15385, 0.02367,       13,        2,       11
FW_, 0      , 0      ,        1,        0,        1
FYF, 0.0625 , 0.00391,       16,        1,       15
FYG, 0.21053, 0.04432,       38,        8,       30
FYH, 0.18182, 0.03306,       11,        2,        9
FYI, 0.16129, 0.02601,       31,        5,       26
FYK, 0.11111, 0.01235,       36,        4,       32
FYL, 0.125  , 0.01562,       40,        5,       35
FYM, 0.1    , 0.01   ,       10,        1,        9
FYN, 0.14286, 0.02041,       28,        4,       24
FYP, 0.09375, 0.00879,       32,        3,       29
FYQ, 0      , 0      ,       25,        0,       25
FYR, 0.225  , 0.05063,       40,        9,       31
FYS, 0.09302, 0.00865,       43,        4,       39
FYT, 0.18919, 0.03579,       37,        7,       30
FYV, 0.25   , 0.0625 ,       36,        9,       27
FYW, 0.22222, 0.04938,        9,        2,        7
FYY, 0.17241, 0.02973,       29,        5,       24
FY_, 0      , 0      ,        1,        0,        1
GAG, 0.03571, 0.00128,       56,        2,       54
GAH, 0.04   , 0.0016 ,       25,        1,       24
GAI, 0.06579, 0.00433,       76,        5,       71
GAK, 0.04167, 0.00174,       96,        4,       92
GAL, 0.05263, 0.00277,      133,        7,      126
GAM, 0.02632, 0.00069,       38,        1,       37
GAN, 0.07692, 0.00592,       65,        5,       60
GAP, 0.03846, 0.00148,       78,        3,       75
GAQ, 0.09091, 0.00826,       55,        5,       50
GAR, 0.02439, 0.00059,       82,        2,       80
GAS, 0.12371, 0.0153 ,       97,       12,       85
GAT, 0.03   , 0.0009 ,      100,        3,       97
GAV, 0.07207, 0.00519,      111,        8,      103
GAW, 0.14286, 0.02041,       14,        2,       12
GAY, 0.05882, 0.00346,       34,        2,       32
GA_, 0.125  , 0.01562,        8,        1,        7
GCG, 0.07692, 0.00592,       13,        1,       12
GCH, 0.16667, 0.02778,        6,        1,        5
GCI, 0      , 0      ,       18,        0,       18
GCK, 0.05263, 0.00277,       19,        1,       18
GCL, 0.06667, 0.00444,       30,        2,       28
GCM, 0.2    , 0.04   ,        5,        1,        4
GCN, 0.06667, 0.00444,       15,        1,       14
GCP, 0.13636, 0.0186 ,       22,        3,       19
GCQ, 0.10526, 0.01108,       19,        2,       17
GCR, 0.14286, 0.02041,       28,        4,       24
GCS, 0.21739, 0.04726,       23,        5,       18
GCT, 0.09091, 0.00826,       22,        2,       20
GCV, 0.12121, 0.01469,       33,        4,       29
GCW, 0.75   , 0.5625 ,        4,        3,        1
GCY, 0.24   , 0.0576 ,       25,        6,       19
GC_, 0      , 0      ,        1,        0,        1
GDG, 0.06452, 0.00416,       62,        4,       58
GDH, 0.0625 , 0.00391,       32,        2,       30
GDI, 0.04167, 0.00174,       96,        4,       92
GDK, 0.05036, 0.00254,      139,        7,      132
GDL, 0.02817, 0.00079,      142,        4,      138
GDM, 0.09375, 0.00879,       32,        3,       29
GDN, 0      , 0      ,       47,        0,       47
GDP, 0.03774, 0.00142,      106,        4,      102
GDQ, 0.11111, 0.01235,       54,        6,       48
GDR, 0.07619, 0.0058 ,      105,        8,       97
GDS, 0.01835, 0.00034,      109,        2,      107
GDT, 0.09756, 0.00952,       82,        8,       74
GDV, 0.04032, 0.00163,      124,        5,      119
GDW, 0.125  , 0.01562,       24,        3,       21
GDY, 0.02703, 0.00073,       74,        2,       72
GD_, 0      , 0      ,        5,        0,        5
GEG, 0.03448, 0.00119,       58,        2,       56
GEH, 0.03333, 0.00111,       30,        1,       29
GEI, 0.05   , 0.0025 ,      100,        5,       95
GEK, 0.04065, 0.00165,      123,        5,      118
GEL, 0.08163, 0.00666,      147,       12,      135
GEM, 0.075  , 0.00562,       40,        3,       37
GEN, 0.05333, 0.00284,       75,        4,       71
GEP, 0.05556, 0.00309,      108,        6,      102
GEQ, 0.05357, 0.00287,       56,        3,       53
GER, 0.07527, 0.00567,       93,        7,       86
GES, 0.05495, 0.00302,       91,        5,       86
GET, 0.03261, 0.00106,       92,        3,       89
GEV, 0.03876, 0.0015 ,      129,        5,      124
GEW, 0.04545, 0.00207,       22,        1,       21
GEY, 0.01852, 0.00034,       54,        1,       53
GE_, 0      , 0      ,        8,        0,        8
GFG, 0.2093 , 0.04381,       43,        9,       34
GFH, 0.07692, 0.00592,       26,        2,       24
GFI, 0.10526, 0.01108,       57,        6,       51
GFK, 0.12245, 0.01499,       49,        6,       43
GFL, 0.12329, 0.0152 ,       73,        9,       64
GFM, 0.15385, 0.02367,       13,        2,       11
GFN, 0.26   , 0.0676 ,       50,       13,       37
GFP, 0.04348, 0.00189,       46,        2,       44
GFQ, 0.08824, 0.00779,       34,        3,       31
GFR, 0.04   , 0.0016 ,       50,        2,       48
GFS, 0.17949, 0.03222,       78,       14,       64
GFT, 0.15556, 0.0242 ,       45,        7,       38
GFV, 0.09589, 0.00919,       73,        7,       66
GFW, 0.26316, 0.06925,       19,        5,       14
GFY, 0.11364, 0.01291,       44,        5,       39
GGG, 0.10526, 0.01108,       57,        6,       51
GGH, 0.04167, 0.00174,       24,        1,       23
GGI, 0.06742, 0.00454,       89,        6,       83
GGK, 0      , 0      ,       78,        0,       78
GGL, 0.05303, 0.00281,      132,        7,      125
GGM, 0.1    , 0.01   ,       30,        3,       27
GGN, 0.09231, 0.00852,       65,        6,       59
GGP, 0.01333, 0.00018,       75,        1,       74
GGQ, 0.02857, 0.00082,       70,        2,       68
GGR, 0.06742, 0.00454,       89,        6,       83
GGS, 0.08036, 0.00646,      112,        9,      103
GGT, 0.06977, 0.00487,       86,        6,       80
GGV, 0.07339, 0.00539,      109,        8,      101
GGW, 0.06667, 0.00444,       30,        2,       28
GGY, 0.09524, 0.00907,       63,        6,       57
GG_, 0      , 0      ,       10,        0,       10
GHG, 0.28571, 0.08163,       21,        6,       15
GHH, 0      , 0      ,       19,        0,       19
GHI, 0.08333, 0.00694,       36,        3,       33
GHK, 0.03226, 0.00104,       31,        1,       30
GHL, 0.08511, 0.00724,       47,        4,       43
GHM, 0.14286, 0.02041,       14,        2,       12
GHN, 0.05882, 0.00346,       17,        1,       16
GHP, 0.04348, 0.00189,       23,        1,       22
GHQ, 0.08333, 0.00694,       12,        1,       11
GHR, 0.07407, 0.00549,       27,        2,       25
GHS, 0.14286, 0.02041,       42,        6,       36
GHT, 0.05128, 0.00263,       39,        2,       37
GHV, 0.18421, 0.03393,       38,        7,       31
GHW, 0.4    , 0.16   ,        5,        2,        3
GHY, 0.15152, 0.02296,       33,        5,       28
GH_, 0      , 0      ,        3,        0,        3
GIG, 0.17073, 0.02915,       41,        7,       34
GIH, 0      , 0      ,       27,        0,       27
GII, 0.13235, 0.01752,       68,        9,       59
GIK, 0.04819, 0.00232,       83,        4,       79
GIL, 0.05102, 0.0026 ,       98,        5,       93
GIM, 0.18519, 0.03429,       27,        5,       22
GIN, 0.05455, 0.00298,       55,        3,       52
GIP, 0.09375, 0.00879,       64,        6,       58
GIQ, 0.08333, 0.00694,       48,        4,       44
GIR, 0.03175, 0.00101,       63,        2,       61
GIS, 0.10938, 0.01196,       64,        7,       57
GIT, 0.09756, 0.00952,       82,        8,       74
GIV, 0.04598, 0.00211,       87,        4,       83
GIW, 0.11111, 0.01235,       18,        2,       16
GIY, 0.11111, 0.01235,       36,        4,       32
GI_, 0      , 0      ,        3,        0,        3
GKG, 0.02941, 0.00087,       34,        1,       33
GKH, 0      , 0      ,       31,        0,       31
GKI, 0.05263, 0.00277,      114,        6,      108
GKK, 0.05618, 0.00316,       89,        5,       84
GKL, 0.08025, 0.00644,      162,       13,      149
GKM, 0.05882, 0.00346,       34,        2,       32
GKN, 0.06944, 0.00482,       72,        5,       67
GKP, 0.04706, 0.00221,       85,        4,       81
GKQ, 0.02083, 0.00043,       48,        1,       47
GKR, 0.05479, 0.003  ,       73,        4,       69
GKS, 0.0375 , 0.00141,       80,        3,       77
GKT, 0.05155, 0.00266,       97,        5,       92
GKV, 0.09804, 0.00961,      102,       10,       92
GKW, 0.03571, 0.00128,       28,        1,       27
GKY, 0      , 0      ,       58,        0,       58
GK_, 0      , 0      ,        4,        0,        4
GLG, 0.17241, 0.02973,       58,       10,       48
GLH, 0.02564, 0.00066,       39,        1,       38
GLI, 0.12295, 0.01512,      122,       15,      107
GLK, 0.07092, 0.00503,      141,       10,      131
GLL, 0.04639, 0.00215,      194,        9,      185
GLM, 0.05405, 0.00292,       37,        2,       35
GLN, 0.01449, 0.00021,       69,        1,       68
GLP, 0.07317, 0.00535,      123,        9,      114
GLQ, 0.01515, 0.00023,       66,        1,       65
GLR, 0.06306, 0.00398,      111,        7,      104
GLS, 0.06957, 0.00484,      115,        8,      107
GLT, 0.10526, 0.01108,      114,       12,      102
GLV, 0.06757, 0.00457,      148,       10,      138
GLW, 0      , 0      ,       29,        0,       29
GLY, 0.07547, 0.0057 ,       53,        4,       49
GL_, 0.14286, 0.02041,        7,        1,        6
GMG, 0      , 0      ,       12,        0,       12
GMH, 0.07143, 0.0051 ,       14,        1,       13
GMI, 0.11765, 0.01384,       34,        4,       30
GMK, 0.03226, 0.00104,       31,        1,       30
GML, 0.14815, 0.02195,       54,        8,       46
GMM, 0      , 0      ,        6,        0,        6
GMN, 0.13636, 0.0186 ,       22,        3,       19
GMP, 0.07407, 0.00549,       27,        2,       25
GMQ, 0.14815, 0.02195,       27,        4,       23
GMR, 0      , 0      ,       16,        0,       16
GMS, 0.07692, 0.00592,       26,        2,       24
GMT, 0.1875 , 0.03516,       32,        6,       26
GMV, 0      , 0      ,       36,        0,       36
GMW, 0.09091, 0.00826,       11,        1,       10
GMY, 0.0625 , 0.00391,       16,        1,       15
GM_, 0.14286, 0.02041,        7,        1,        6
GNG, 0.17073, 0.02915,       41,        7,       34
GNH, 0.12   , 0.0144 ,       25,        3,       22
GNI, 0.04762, 0.00227,      105,        5,      100
GNK, 0.06452, 0.00416,       62,        4,       58
GNL, 0.10417, 0.01085,       96,       10,       86
GNM, 0.05   , 0.0025 ,       20,        1,       19
GNN, 0.11111, 0.01235,       54,        6,       48
GNP, 0.08537, 0.00729,       82,        7,       75
GNQ, 0.06   , 0.0036 ,       50,        3,       47
GNR, 0.09091, 0.00826,       55,        5,       50
GNS, 0.08642, 0.00747,       81,        7,       74
GNT, 0.09091, 0.00826,       66,        6,       60
GNV, 0.03883, 0.00151,      103,        4,       99
GNW, 0      , 0      ,       19,        0,       19
GNY, 0.03704, 0.00137,       54,        2,       52
GN_, 0.14286, 0.02041,        7,        1,        6
GPG, 0.02273, 0.00052,       44,        1,       43
GPH, 0.04   , 0.0016 ,       25,        1,       24
GPI, 0.04615, 0.00213,       65,        3,       62
GPK, 0.03947, 0.00156,       76,        3,       73
GPL, 0.05882, 0.00346,      102,        6,       96
GPM, 0.08333, 0.00694,       24,        2,       22
GPN, 0.07143, 0.0051 ,       42,        3,       39
GPP, 0.01613, 0.00026,       62,        1,       61
GPQ, 0      , 0      ,       45,        0,       45
GPR, 0.04839, 0.00234,       62,        3,       59
GPS, 0.07143, 0.0051 ,       56,        4,       52
GPT, 0.07812, 0.0061 ,       64,        5,       59
GPV, 0.05263, 0.00277,       76,        4,       72
GPW, 0      , 0      ,       15,        0,       15
GPY, 0.02564, 0.00066,       39,        1,       38
GP_, 0      , 0      ,        2,        0,        2
GQG, 0      , 0      ,       30,        0,       30
GQH, 0.1    , 0.01   ,       20,        2,       18
GQI, 0.07692, 0.00592,       65,        5,       60
GQK, 0.08772, 0.00769,       57,        5,       52
GQL, 0.09412, 0.00886,       85,        8,       77
GQM, 0.03333, 0.00111,       30,        1,       29
GQN, 0.11628, 0.01352,       43,        5,       38
GQP, 0.03636, 0.00132,       55,        2,       53
GQQ, 0.06   , 0.0036 ,       50,        3,       47
GQR, 0.09231, 0.00852,       65,        6,       59
GQS, 0.03333, 0.00111,       60,        2,       58
GQT, 0.07143, 0.0051 ,       56,        4,       52
GQV, 0.07447, 0.00555,       94,        7,       87
GQW, 0      , 0      ,       17,        0,       17
GQY, 0.13889, 0.01929,       36,        5,       31
GQ_, 0      , 0      ,        2,        0,        2
GRG, 0.14583, 0.02127,       48,        7,       41
GRH, 0.04348, 0.00189,       23,        1,       22
GRI, 0.08889, 0.0079 ,       90,        8,       82
GRK, 0.08   , 0.0064 ,       75,        6,       69
GRL, 0.06707, 0.0045 ,      164,       11,      153
GRM, 0.34615, 0.11982,       26,        9,       17
GRN, 0.07273, 0.00529,       55,        4,       51
GRP, 0.01493, 0.00022,       67,        1,       66
GRQ, 0.05263, 0.00277,       57,        3,       54
GRR, 0.12222, 0.01494,       90,       11,       79
GRS, 0.09524, 0.00907,       84,        8,       76
GRT, 0.18072, 0.03266,       83,       15,       68
GRV, 0.13592, 0.01847,      103,       14,       89
GRW, 0.18519, 0.03429,       27,        5,       22
GRY, 0.04348, 0.00189,       46,        2,       44
GR_, 0      , 0      ,        2,        0,        2
GSG, 0      , 0      ,       79,        0,       79
GSH, 0.01818, 0.00033,       55,        1,       54
GSI, 0.12941, 0.01675,       85,       11,       74
GSK, 0.05319, 0.00283,       94,        5,       89
GSL, 0.04545, 0.00207,      132,        6,      126
GSM, 0.0303 , 0.00092,       33,        1,       32
GSN, 0.04615, 0.00213,       65,        3,       62
GSP, 0.05682, 0.00323,       88,        5,       83
GSQ, 0.04167, 0.00174,       72,        3,       69
GSR, 0.10526, 0.01108,       76,        8,       68
GSS, 0.07947, 0.00632,      151,       12,      139
GST, 0.07547, 0.0057 ,      106,        8,       98
GSV, 0.03731, 0.00139,      134,        5,      129
GSW, 0.17241, 0.02973,       29,        5,       24
GSY, 0.04819, 0.00232,       83,        4,       79
GS_, 0      , 0      ,       15,        0,       15
GTG, 0.11475, 0.01317,       61,        7,       54
GTH, 0.05714, 0.00327,       35,        2,       33
GTI, 0.06481, 0.0042 ,      108,        7,      101
GTK, 0.0641 , 0.00411,       78,        5,       73
GTL, 0.02703, 0.00073,      111,        3,      108
GTM, 0      , 0      ,       22,        0,       22
GTN, 0.05556, 0.00309,       54,        3,       51
GTP, 0.06757, 0.00457,       74,        5,       69
GTQ, 0.06   , 0.0036 ,       50,        3,       47
GTR, 0.1194 , 0.01426,       67,        8,       59
GTS, 0.04902, 0.0024 ,      102,        5,       97
GTT, 0.11111, 0.01235,       90,       10,       80
GTV, 0.0367 , 0.00135,      109,        4,      105
GTW, 0.04   , 0.0016 ,       25,        1,       24
GTY, 0.0625 , 0.00391,       64,        4,       60
GT_, 0      , 0      ,        7,        0,        7
GVG, 0.11538, 0.01331,       52,        6,       46
GVH, 0.08824, 0.00779,       34,        3,       31
GVI, 0.05479, 0.003  ,       73,        4,       69
GVK, 0.04348, 0.00189,       92,        4,       88
GVL, 0.10084, 0.01017,      119,       12,      107
GVM, 0      , 0      ,       20,        0,       20
GVN, 0.03333, 0.00111,       60,        2,       58
GVP, 0.11111, 0.01235,       81,        9,       72
GVQ, 0.03571, 0.00128,       56,        2,       54
GVR, 0.1    , 0.01   ,       60,        6,       54
GVS, 0.125  , 0.01562,      104,       13,       91
GVT, 0.03488, 0.00122,       86,        3,       83
GVV, 0.07576, 0.00574,      132,       10,      122
GVW, 0.09091, 0.00826,       22,        2,       20
GVY, 0.03774, 0.00142,       53,        2,       51
GV_, 0      , 0      ,        4,        0,        4
GWG, 0.21739, 0.04726,       23,        5,       18
GWH, 0.33333, 0.11111,        6,        2,        4
GWI, 0.05263, 0.00277,       19,        1,       18
GWK, 0.11111, 0.01235,       27,        3,       24
GWL, 0.27273, 0.07438,       22,        6,       16
GWM, 0.16667, 0.02778,        6,        1,        5
GWN, 0.21053, 0.04432,       19,        4,       15
GWP, 0.18182, 0.03306,       11,        2,        9
GWQ, 0.14286, 0.02041,        7,        1,        6
GWR, 0.11111, 0.01235,       18,        2,       16
GWS, 0.34615, 0.11982,       26,        9,       17
GWT, 0.19231, 0.03698,       26,        5,       21
GWV, 0.28571, 0.08163,       21,        6,       15
GWW, 0.6    , 0.36   ,        5,        3,        2
GWY, 0.10526, 0.01108,       19,        2,       17
GYG, 0.18919, 0.03579,       37,        7,       30
GYH, 0.07692, 0.00592,       26,        2,       24
GYI, 0.14286, 0.02041,       56,        8,       48
GYK, 0.06061, 0.00367,       66,        4,       62
GYL, 0.16279, 0.0265 ,       86,       14,       72
GYM, 0.26316, 0.06925,       19,        5,       14
GYN, 0.07843, 0.00615,       51,        4,       47
GYP, 0.15686, 0.02461,       51,        8,       43
GYQ, 0.16   , 0.0256 ,       25,        4,       21
GYR, 0.23636, 0.05587,       55,       13,       42
GYS, 0.14286, 0.02041,       77,       11,       66
GYT, 0.1746 , 0.03049,       63,       11,       52
GYV, 0.21311, 0.04542,       61,       13,       48
GYW, 0.2    , 0.04   ,       15,        3,       12
GYY, 0.075  , 0.00562,       40,        3,       37
HAH, 0.2    , 0.04   ,        5,        1,        4
HAI, 0.06667, 0.00444,       30,        2,       28
HAK, 0      , 0      ,       25,        0,       25
HAL, 0.07143, 0.0051 ,       42,        3,       39
HAM, 0      , 0      ,        9,        0,        9
HAN, 0      , 0      ,       15,        0,       15
HAP, 0.06667, 0.00444,       15,        1,       14
HAQ, 0      , 0      ,       23,        0,       23
HAR, 0.07407, 0.00549,       27,        2,       25
HAS, 0.07407, 0.00549,       27,        2,       25
HAT, 0      , 0      ,       23,        0,       23
HAV, 0.11765, 0.01384,       34,        4,       30
HAW, 0.14286, 0.02041,        7,        1,        6
HAY, 0      , 0      ,        8,        0,        8
HA_, 0      , 0      ,        3,        0,        3
HCI, 0.07692, 0.00592,       13,        1,       12
HCK, 0.1    , 0.01   ,       10,        1,        9
HCL, 0.07692, 0.00592,       13,        1,       12
HCM, 0      , 0      ,        3,        0,        3
HCN, 0      , 0      ,        7,        0,        7
HCP, 0.125  , 0.01562,        8,        1,        7
HCQ, 0      , 0      ,        8,        0,        8
HCR, 0.11111, 0.01235,        9,        1,        8
HCS, 0      , 0      ,        9,        0,        9
HCT, 0      , 0      ,        5,        0,        5
HCV, 0.14286, 0.02041,       14,        2,       12
HCW, 0      , 0      ,        1,        0,        1
HCY, 0      , 0      ,        8,        0,        8
HDH, 0      , 0      ,        2,        0,        2
HDI, 0.06897, 0.00476,       29,        2,       27
HDK, 0      , 0      ,       29,        0,       29
HDL, 0.04255, 0.00181,       47,        2,       45
HDM, 0      , 0      ,        8,        0,        8
HDN, 0      , 0      ,       16,        0,       16
HDP, 0.03846, 0.00148,       26,        1,       25
HDQ, 0      , 0      ,       28,        0,       28
HDR, 0.09524, 0.00907,       21,        2,       19
HDS, 0.04545, 0.00207,       22,        1,       21
HDT, 0.15385, 0.02367,       13,        2,       11
HDV, 0.11429, 0.01306,       35,        4,       31
HDW, 0      , 0      ,        3,        0,        3
HDY, 0.21429, 0.04592,       14,        3,       11
HD_, 1      , 1      ,        1,        1,        0
HEH, 0      , 0      ,        9,        0,        9
HEI, 0.07143, 0.0051 ,       42,        3,       39
HEK, 0.03704, 0.00137,       27,        1,       26
HEL, 0.14035, 0.0197 ,       57,        8,       49
HEM, 0.11111, 0.01235,       18,        2,       16
HEN, 0      , 0      ,       21,        0,       21
HEP, 0.08   , 0.0064 ,       25,        2,       23
HEQ, 0.04167, 0.00174,       24,        1,       23
HER, 0.08333, 0.00694,       24,        2,       22
HES, 0.125  , 0.01562,       24,        3,       21
HET, 0.09375, 0.00879,       32,        3,       29
HEV, 0.02632, 0.00069,       38,        1,       37
HEW, 0      , 0      ,       10,        0,       10
HEY, 0.22222, 0.04938,       18,        4,       14
HE_, 0      , 0      ,        2,        0,        2
HFH, 0.16667, 0.02778,        6,        1,        5
HFI, 0.125  , 0.01562,       24,        3,       21
HFK, 0.17241, 0.02973,       29,        5,       24
HFL, 0.06667, 0.00444,       30,        2,       28
HFM, 0.1    , 0.01   ,       10,        1,        9
HFN, 0.33333, 0.11111,       12,        4,        8
HFP, 0.2    , 0.04   ,       20,        4,       16
HFQ, 0      , 0      ,       15,        0,       15
HFR, 0.06667, 0.00444,       15,        1,       14
HFS, 0.07143, 0.0051 ,       28,        2,       26
HFT, 0.07407, 0.00549,       27,        2,       25
HFV, 0.08333, 0.00694,       36,        3,       33
HFW, 0      , 0      ,       14,        0,       14
HFY, 0.16667, 0.02778,        6,        1,        5
HF_, 0.5    , 0.25   ,        2,        1,        1
HGH, 0      , 0      ,        3,        0,        3
HGI, 0.09091, 0.00826,       33,        3,       30
HGK, 0      , 0      ,       33,        0,       33
HGL, 0.04878, 0.00238,       41,        2,       39
HGM, 0      , 0      ,        9,        0,        9
HGN, 0      , 0      ,       33,        0,       33
HGP, 0      , 0      ,       27,        0,       27
HGQ, 0.04348, 0.00189,       23,        1,       22
HGR, 0.04167, 0.00174,       24,        1,       23
HGS, 0.03571, 0.00128,       28,        1,       27
HGT, 0      , 0      ,       28,        0,       28
HGV, 0.0625 , 0.00391,       32,        2,       30
HGW, 0.2    , 0.04   ,        5,        1,        4
HGY, 0      , 0      ,       24,        0,       24
HG_, 0      , 0      ,        6,        0,        6
HHH, 0      , 0      ,       46,        0,       46
HHI, 0.06667, 0.00444,       15,        1,       14
HHK, 0      , 0      ,        9,        0,        9
HHL, 0.04762, 0.00227,       21,        1,       20
HHM, 0.23077, 0.05325,       13,        3,       10
HHN, 0      , 0      ,        8,        0,        8
HHP, 0      , 0      ,       12,        0,       12
HHQ, 0.25   , 0.0625 ,        4,        1,        3
HHR, 0      , 0      ,        9,        0,        9
HHS, 0.07692, 0.00592,       13,        1,       12
HHT, 0.07143, 0.0051 ,       14,        1,       13
HHV, 0.05263, 0.00277,       19,        1,       18
HHW, 0      , 0      ,        6,        0,        6
HHY, 0      , 0      ,        6,        0,        6
HH_, 0      , 0      ,       13,        0,       13
HIH, 0      , 0      ,        6,        0,        6
HII, 0.05556, 0.00309,       18,        1,       17
HIK, 0.07692, 0.00592,       26,        2,       24
HIL, 0.075  , 0.00562,       40,        3,       37
HIM, 0      , 0      ,        6,        0,        6
HIN, 0      , 0      ,       22,        0,       22
HIP, 0.07692, 0.00592,       26,        2,       24
HIQ, 0      , 0      ,       20,        0,       20
HIR, 0.08696, 0.00756,       23,        2,       21
HIS, 0.03448, 0.00119,       29,        1,       28
HIT, 0.05882, 0.00346,       17,        1,       16
HIV, 0.10526, 0.01108,       19,        2,       17
HIW, 0      , 0      ,        8,        0,        8
HIY, 0.07143, 0.0051 ,       14,        1,       13
HI_, 1      , 1      ,        1,        1,        0
HKH, 0      , 0      ,        4,        0,        4
HKI, 0.14286, 0.02041,       28,        4,       24
HKK, 0.10526, 0.01108,       38,        4,       34
HKL, 0.06667, 0.00444,       60,        4,       56
HKM, 0.05882, 0.00346,       17,        1,       16
HKN, 0.13793, 0.01902,       29,        4,       25
HKP, 0      , 0      ,       19,        0,       19
HKQ, 0      , 0      ,       20,        0,       20
HKR, 0      , 0      ,       21,        0,       21
HKS, 0.03125, 0.00098,       32,        1,       31
HKT, 0.11765, 0.01384,       17,        2,       15
HKV, 0.125  , 0.01562,       32,        4,       28
HKW, 0.11111, 0.01235,        9,        1,        8
HKY, 0.0625 , 0.00391,       16,        1,       15
HK_, 0      , 0      ,        2,        0,        2
HLH, 0.15385, 0.02367,       13,        2,       11
HLI, 0.075  , 0.00562,       40,        3,       37
HLK, 0.02439, 0.00059,       41,        1,       40
HLL, 0.0137 , 0.00019,       73,        1,       72
HLM, 0.09091, 0.00826,       11,        1,       10
HLN, 0.04   , 0.0016 ,       25,        1,       24
HLP, 0.10526, 0.01108,       38,        4,       34
HLQ, 0.05   , 0.0025 ,       40,        2,       38
HLR, 0.06818, 0.00465,       44,        3,       41
HLS, 0.06818, 0.00465,       44,        3,       41
HLT, 0.05405, 0.00292,       37,        2,       35
HLV, 0.10345, 0.0107 ,       58,        6,       52
HLW, 0      , 0      ,        4,        0,        4
HLY, 0.11111, 0.01235,       18,        2,       16
HL_, 1      , 1      ,        1,        1,        0
HMH, 0      , 0      ,        2,        0,        2
HMI, 0.09091, 0.00826,       11,        1,       10
HMK, 0      , 0      ,       13,        0,       13
HML, 0.16   , 0.0256 ,       25,        4,       21
HMM, 0.2    , 0.04   ,        5,        1,        4
HMN, 0      , 0      ,       10,        0,       10
HMP, 0      , 0      ,       10,        0,       10
HMQ, 0      , 0      ,       15,        0,       15
HMR, 0      , 0      ,        8,        0,        8
HMS, 0.09091, 0.00826,       11,        1,       10
HMT, 0.09091, 0.00826,       11,        1,       10
HMV, 0.08333, 0.00694,       12,        1,       11
HMW, 0      , 0      ,        3,        0,        3
HMY, 0.66667, 0.44444,        3,        2,        1
HM_, 0      , 0      ,        3,        0,        3
HNH, 0      , 0      ,        3,        0,        3
HNI, 0.07143, 0.0051 ,       28,        2,       26
HNK, 0.1    , 0.01   ,       20,        2,       18
HNL, 0.05556, 0.00309,       36,        2,       34
HNM, 0.1    , 0.01   ,       10,        1,        9
HNN, 0.04762, 0.00227,       21,        1,       20
HNP, 0.04545, 0.00207,       22,        1,       21
HNQ, 0      , 0      ,       18,        0,       18
HNR, 0.07143, 0.0051 ,       14,        1,       13
HNS, 0      , 0      ,       14,        0,       14
HNT, 0.05   , 0.0025 ,       20,        1,       19
HNV, 0.07407, 0.00549,       27,        2,       25
HNW, 0      , 0      ,        3,        0,        3
HNY, 0.2    , 0.04   ,       10,        2,        8
HN_, 0.5    , 0.25   ,        2,        1,        1
HPH, 0      , 0      ,        3,        0,        3
HPI, 0      , 0      ,       25,        0,       25
HPK, 0      , 0      ,       31,        0,       31
HPL, 0      , 0      ,       31,        0,       31
HPM, 0      , 0      ,       12,        0,       12
HPN, 0.05   , 0.0025 ,       20,        1,       19
HPP, 0      , 0      ,       21,        0,       21
HPQ, 0      , 0      ,       12,        0,       12
HPR, 0.07143, 0.0051 ,       14,        1,       13
HPS, 0      , 0      ,       30,        0,       30
HPT, 0.09091, 0.00826,       22,        2,       20
HPV, 0.21739, 0.04726,       23,        5,       18
HPW, 0.1    , 0.01   ,       10,        1,        9
HPY, 0      , 0      ,       14,        0,       14
HP_, 0.5    , 0.25   ,        2,        1,        1
HQH, 0      , 0      ,        7,        0,        7
HQI, 0.2    , 0.04   ,       25,        5,       20
HQK, 0.05   , 0.0025 ,       20,        1,       19
HQL, 0.07843, 0.00615,       51,        4,       47
HQM, 0.33333, 0.11111,        3,        1,        2
HQN, 0.14286, 0.02041,        7,        1,        6
HQP, 0      , 0      ,       11,        0,       11
HQQ, 0      , 0      ,       19,        0,       19
HQR, 0.05263, 0.00277,       19,        1,       18
HQS, 0.1    , 0.01   ,       20,        2,       18
HQT, 0      , 0      ,       16,        0,       16
HQV, 0.2    , 0.04   ,       25,        5,       20
HQW, 0.25   , 0.0625 ,        4,        1,        3
HQY, 0.1    , 0.01   ,       10,        1,        9
HQ_, 0      , 0      ,        2,        0,        2
HRH, 0.125  , 0.01562,        8,        1,        7
HRI, 0.1    , 0.01   ,       30,        3,       27
HRK, 0.08696, 0.00756,       23,        2,       21
HRL, 0      , 0      ,       39,        0,       39
HRM, 0      , 0      ,        6,        0,        6
HRN, 0      , 0      ,       19,        0,       19
HRP, 0.13043, 0.01701,       23,        3,       20
HRQ, 0.07692, 0.00592,       13,        1,       12
HRR, 0.04167, 0.00174,       24,        1,       23
HRS, 0.14286, 0.02041,       28,        4,       24
HRT, 0.125  , 0.01562,       16,        2,       14
HRV, 0.12   , 0.0144 ,       25,        3,       22
HRW, 0.28571, 0.08163,        7,        2,        5
HRY, 0      , 0      ,       25,        0,       25
HR_, 0      , 0      ,        1,        0,        1
HSH, 0      , 0      ,        1,        0,        1
HSI, 0.10714, 0.01148,       28,        3,       25
HSK, 0      , 0      ,       25,        0,       25
HSL, 0.01667, 0.00028,       60,        1,       59
HSM, 0      , 0      ,       12,        0,       12
HSN, 0.04   , 0.0016 ,       25,        1,       24
HSP, 0      , 0      ,       31,        0,       31
HSQ, 0      , 0      ,       29,        0,       29
HSR, 0.03846, 0.00148,       26,        1,       25
HSS, 0.2    , 0.04   ,       35,        7,       28
HST, 0.04348, 0.00189,       23,        1,       22
HSV, 0.07143, 0.0051 ,       42,        3,       39
HSW, 0      , 0      ,        9,        0,        9
HSY, 0.25   , 0.0625 ,       20,        5,       15
HS_, 0      , 0      ,        9,        0,        9
HTH, 0      , 0      ,        8,        0,        8
HTI, 0.04167, 0.00174,       24,        1,       23
HTK, 0      , 0      ,       24,        0,       24
HTL, 0      , 0      ,       39,        0,       39
HTM, 0      , 0      ,        9,        0,        9
HTN, 0.06667, 0.00444,       15,        1,       14
HTP, 0      , 0      ,       18,        0,       18
HTQ, 0      , 0      ,       15,        0,       15
HTR, 0.06667, 0.00444,       15,        1,       14
HTS, 0      , 0      ,       19,        0,       19
HTT, 0.03333, 0.00111,       30,        1,       29
HTV, 0.03571, 0.00128,       28,        1,       27
HTW, 0      , 0      ,        8,        0,        8
HTY, 0.0625 , 0.00391,       16,        1,       15
HT_, 0      , 0      ,        2,        0,        2
HVH, 0      , 0      ,        2,        0,        2
HVI, 0      , 0      ,       25,        0,       25
HVK, 0      , 0      ,       23,        0,       23
HVL, 0.05128, 0.00263,       39,        2,       37
HVM, 0      , 0      ,       12,        0,       12
HVN, 0      , 0      ,       17,        0,       17
HVP, 0.19231, 0.03698,       26,        5,       21
HVQ, 0      , 0      ,       18,        0,       18
HVR, 0.03571, 0.00128,       28,        1,       27
HVS, 0.125  , 0.01562,       32,        4,       28
HVT, 0      , 0      ,       28,        0,       28
HVV, 0.05882, 0.00346,       34,        2,       32
HVW, 0.33333, 0.11111,        3,        1,        2
HVY, 0.125  , 0.01562,       16,        2,       14
HV_, 0      , 0      ,        2,        0,        2
HWH, 0      , 0      ,        4,        0,        4
HWI, 0      , 0      ,        6,        0,        6
HWK, 0.33333, 0.11111,        6,        2,        4
HWL, 0      , 0      ,        9,        0,        9
HWM, 0      , 0      ,        5,        0,        5
HWN, 0      , 0      ,        4,        0,        4
HWP, 0.125  , 0.01562,        8,        1,        7
HWQ, 0      , 0      ,        3,        0,        3
HWR, 0.5    , 0.25   ,        4,        2,        2
HWS, 0.66667, 0.44444,        3,        2,        1
HWT, 0.23077, 0.05325,       13,        3,       10
HWV, 1      , 1      ,        1,        1,        0
HWW, 0      , 0      ,        3,        0,        3
HWY, 0.16667, 0.02778,        6,        1,        5
HYH, 0      , 0      ,        3,        0,        3
HYI, 0.09091, 0.00826,       22,        2,       20
HYK, 0.10526, 0.01108,       19,        2,       17
HYL, 0.11429, 0.01306,       35,        4,       31
HYM, 0      , 0      ,        3,        0,        3
HYN, 0.2    , 0.04   ,       10,        2,        8
HYP, 0.06667, 0.00444,       15,        1,       14
HYQ, 0.13333, 0.01778,       15,        2,       13
HYR, 0.15385, 0.02367,       13,        2,       11
HYS, 0.04   , 0.0016 ,       25,        1,       24
HYT, 0.13333, 0.01778,       15,        2,       13
HYV, 0.05263, 0.00277,       19,        1,       18
HYW, 0      , 0      ,        8,        0,        8
HYY, 0.22222, 0.04938,       18,        4,       14
IAI, 0.07692, 0.00592,       26,        2,       24
IAK, 0      , 0      ,       86,        0,       86
IAL, 0.08333, 0.00694,       96,        8,       88
IAM, 0.08696, 0.00756,       23,        2,       21
IAN, 0.04545, 0.00207,       66,        3,       63
IAP, 0      , 0      ,       39,        0,       39
IAQ, 0.09375, 0.00879,       64,        6,       58
IAR, 0.01562, 0.00024,       64,        1,       63
IAS, 0.03409, 0.00116,       88,        3,       85
IAT, 0.07576, 0.00574,       66,        5,       61
IAV, 0.09091, 0.00826,       66,        6,       60
IAW, 0.11111, 0.01235,        9,        1,        8
IAY, 0.125  , 0.01562,       24,        3,       21
IA_, 0      , 0      ,        5,        0,        5
ICI, 0.4    , 0.16   ,        5,        2,        3
ICK, 0      , 0      ,       24,        0,       24
ICL, 0.09677, 0.00937,       31,        3,       28
ICM, 0.125  , 0.01562,        8,        1,        7
ICN, 0.05263, 0.00277,       19,        1,       18
ICP, 0.05556, 0.00309,       18,        1,       17
ICQ, 0.15789, 0.02493,       19,        3,       16
ICR, 0      , 0      ,       18,        0,       18
ICS, 0.05556, 0.00309,       18,        1,       17
ICT, 0      , 0      ,       14,        0,       14
ICV, 0.06667, 0.00444,       15,        1,       14
ICW, 0      , 0      ,        3,        0,        3
ICY, 0.2    , 0.04   ,       10,        2,        8
IC_, 0      , 0      ,        1,        0,        1
IDI, 0.03125, 0.00098,       32,        1,       31
IDK, 0.0463 , 0.00214,      108,        5,      103
IDL, 0.07299, 0.00533,      137,       10,      127
IDM, 0      , 0      ,       21,        0,       21
IDN, 0.0625 , 0.00391,       64,        4,       60
IDP, 0.02703, 0.00073,       74,        2,       72
IDQ, 0.06897, 0.00476,       58,        4,       54
IDR, 0.05634, 0.00317,       71,        4,       67
IDS, 0.10667, 0.01138,       75,        8,       67
IDT, 0.04225, 0.00179,       71,        3,       68
IDV, 0.04854, 0.00236,      103,        5,       98
IDW, 0.04545, 0.00207,       22,        1,       21
IDY, 0.06122, 0.00375,       49,        3,       46
ID_, 0      , 0      ,        3,        0,        3
IEI, 0.04762, 0.00227,       21,        1,       20
IEK, 0.06364, 0.00405,      110,        7,      103
IEL, 0.11538, 0.01331,      130,       15,      115
IEM, 0      , 0      ,       32,        0,       32
IEN, 0.04545, 0.00207,       66,        3,       63
IEP, 0.04762, 0.00227,       63,        3,       60
IEQ, 0.04348, 0.00189,       69,        3,       66
IER, 0.02   , 0.0004 ,      100,        2,       98
IES, 0.06186, 0.00383,       97,        6,       91
IET, 0.07273, 0.00529,       55,        4,       51
IEV, 0.0381 , 0.00145,      105,        4,      101
IEW, 0.12   , 0.0144 ,       25,        3,       22
IEY, 0.12766, 0.0163 ,       47,        6,       41
IE_, 0      , 0      ,        3,        0,        3
IFI, 0      , 0      ,       19,        0,       19
IFK, 0.09836, 0.00967,       61,        6,       55
IFL, 0.06061, 0.00367,       33,        2,       31
IFM, 0.14286, 0.02041,       14,        2,       12
IFN, 0.10256, 0.01052,       39,        4,       35
IFP, 0.05882, 0.00346,       34,        2,       32
IFQ, 0.12195, 0.01487,       41,        5,       36
IFR, 0.11364, 0.01291,       44,        5,       39
IFS, 0.07692, 0.00592,       65,        5,       60
IFT, 0.07018, 0.00492,       57,        4,       53
IFV, 0.06977, 0.00487,       43,        3,       40
IFW, 0      , 0      ,        6,        0,        6
IFY, 0.18182, 0.03306,       33,        6,       27
IF_, 0.2    , 0.04   ,        5,        1,        4
IGI, 0.08333, 0.00694,       24,        2,       22
IGK, 0.01316, 0.00017,       76,        1,       75
IGL, 0.07143, 0.0051 ,       98,        7,       91
IGM, 0.11111, 0.01235,       18,        2,       16
IGN, 0.06667, 0.00444,       60,        4,       56
IGP, 0      , 0      ,       37,        0,       37
IGQ, 0.05455, 0.00298,       55,        3,       52
IGR, 0.07895, 0.00623,       76,        6,       70
IGS, 0.05405, 0.00292,       74,        4,       70
IGT, 0.05333, 0.00284,       75,        4,       71
IGV, 0      , 0      ,       48,        0,       48
IGW, 0.07692, 0.00592,       13,        1,       12
IGY, 0.06452, 0.00416,       31,        2,       29
IG_, 0      , 0      ,        7,        0,        7
IHI, 0.0625 , 0.00391,       16,        1,       15
IHK, 0.075  , 0.00562,       40,        3,       37
IHL, 0.05   , 0.0025 ,       40,        2,       38
IHM, 0      , 0      ,        4,        0,        4
IHN, 0.04167, 0.00174,       24,        1,       23
IHP, 0.08   , 0.0064 ,       25,        2,       23
IHQ, 0.03448, 0.00119,       29,        1,       28
IHR, 0.03704, 0.00137,       27,        1,       26
IHS, 0.30769, 0.09467,       39,       12,       27
IHT, 0.125  , 0.01562,       32,        4,       28
IHV, 0.125  , 0.01562,       32,        4,       28
IHW, 0      , 0      ,        4,        0,        4
IHY, 0.05263, 0.00277,       19,        1,       18
IH_, 0      , 0      ,        2,        0,        2
III, 0      , 0      ,        7,        0,        7
IIK, 0.07059, 0.00498,       85,        6,       79
IIL, 0.03509, 0.00123,       57,        2,       55
IIM, 0.05   , 0.0025 ,       20,        1,       19
IIN, 0.10169, 0.01034,       59,        6,       53
IIP, 0.08511, 0.00724,       47,        4,       43
IIQ, 0.0625 , 0.00391,       48,        3,       45
IIR, 0.0566 , 0.0032 ,       53,        3,       50
IIS, 0.11111, 0.01235,       63,        7,       56
IIT, 0.11628, 0.01352,       43,        5,       38
IIV, 0.04762, 0.00227,       63,        3,       60
IIW, 0.09091, 0.00826,       11,        1,       10
IIY, 0.05556, 0.00309,       18,        1,       17
IKI, 0.05556, 0.00309,       36,        2,       34
IKK, 0.05932, 0.00352,      118,        7,      111
IKL, 0.03636, 0.00132,      110,        4,      106
IKM, 0.09677, 0.00937,       31,        3,       28
IKN, 0.08434, 0.00711,       83,        7,       76
IKP, 0.03077, 0.00095,       65,        2,       63
IKQ, 0.04412, 0.00195,       68,        3,       65
IKR, 0.02985, 0.00089,       67,        2,       65
IKS, 0.06522, 0.00425,       92,        6,       86
IKT, 0.05556, 0.00309,       72,        4,       68
IKV, 0.09709, 0.00943,      103,       10,       93
IKW, 0.13043, 0.01701,       23,        3,       20
IKY, 0.05128, 0.00263,       39,        2,       37
IK_, 0      , 0      ,        6,        0,        6
ILI, 0.07692, 0.00592,       26,        2,       24
ILK, 0.06897, 0.00476,      116,        8,      108
ILL, 0.07368, 0.00543,       95,        7,       88
ILM, 0      , 0      ,       14,        0,       14
ILN, 0.04651, 0.00216,       86,        4,       82
ILP, 0.09524, 0.00907,       84,        8,       76
ILQ, 0.07042, 0.00496,       71,        5,       66
ILR, 0.09091, 0.00826,       88,        8,       80
ILS, 0.09322, 0.00869,      118,       11,      107
ILT, 0.05556, 0.00309,       90,        5,       85
ILV, 0.04167, 0.00174,       72,        3,       69
ILW, 0.05263, 0.00277,       19,        1,       18
ILY, 0.06667, 0.00444,       45,        3,       42
IL_, 0      , 0      ,        3,        0,        3
IMI, 0.1    , 0.01   ,       10,        1,        9
IMK, 0.14706, 0.02163,       34,        5,       29
IML, 0.05882, 0.00346,       17,        1,       16
IMM, 0.11111, 0.01235,        9,        1,        8
IMN, 0      , 0      ,       14,        0,       14
IMP, 0.10526, 0.01108,       19,        2,       17
IMQ, 0.27273, 0.07438,       22,        6,       16
IMR, 0.11111, 0.01235,       18,        2,       16
IMS, 0.05556, 0.00309,       18,        1,       17
IMT, 0      , 0      ,       16,        0,       16
IMV, 0.13333, 0.01778,       15,        2,       13
IMW, 0      , 0      ,        8,        0,        8
IMY, 0.14286, 0.02041,       14,        2,       12
IM_, 0      , 0      ,        5,        0,        5
INI, 0.13333, 0.01778,       30,        4,       26
INK, 0.0625 , 0.00391,       80,        5,       75
INL, 0.04396, 0.00193,       91,        4,       87
INM, 0.1    , 0.01   ,       30,        3,       27
INN, 0.05   , 0.0025 ,       60,        3,       57
INP, 0.08696, 0.00756,       46,        4,       42
INQ, 0.05263, 0.00277,       38,        2,       36
INR, 0.05882, 0.00346,       51,        3,       48
INS, 0.06061, 0.00367,       66,        4,       62
INT, 0.06667, 0.00444,       60,        4,       56
INV, 0.11842, 0.01402,       76,        9,       67
INW, 0.11111, 0.01235,       18,        2,       16
INY, 0.15217, 0.02316,       46,        7,       39
IPI, 0.05405, 0.00292,       37,        2,       35
IPK, 0.04839, 0.00234,       62,        3,       59
IPL, 0.03371, 0.00114,       89,        3,       86
IPM, 0.125  , 0.01562,       16,        2,       14
IPN, 0.02632, 0.00069,       38,        1,       37
IPP, 0      , 0      ,       53,        0,       53
IPQ, 0.03125, 0.00098,       32,        1,       31
IPR, 0.03571, 0.00128,       56,        2,       54
IPS, 0.12   , 0.0144 ,       75,        9,       66
IPT, 0.03704, 0.00137,       54,        2,       52
IPV, 0.13514, 0.01826,       74,       10,       64
IPW, 0.09091, 0.00826,       11,        1,       10
IPY, 0.05714, 0.00327,       35,        2,       33
IP_, 0      , 0      ,        4,        0,        4
IQI, 0.03704, 0.00137,       27,        1,       26
IQK, 0.05634, 0.00317,       71,        4,       67
IQL, 0.09859, 0.00972,       71,        7,       64
IQM, 0      , 0      ,       13,        0,       13
IQN, 0.01695, 0.00029,       59,        1,       58
IQP, 0.05714, 0.00327,       35,        2,       33
IQQ, 0.03226, 0.00104,       62,        2,       60
IQR, 0.075  , 0.00562,       40,        3,       37
IQS, 0.10667, 0.01138,       75,        8,       67
IQT, 0.11364, 0.01291,       44,        5,       39
IQV, 0.02326, 0.00054,       43,        1,       42
IQW, 0.11111, 0.01235,        9,        1,        8
IQY, 0.03704, 0.00137,       27,        1,       26
IQ_, 0      , 0      ,        1,        0,        1
IRI, 0.17241, 0.02973,       29,        5,       24
IRK, 0.09524, 0.00907,       84,        8,       76
IRL, 0.05376, 0.00289,       93,        5,       88
IRM, 0.06667, 0.00444,       30,        2,       28
IRN, 0.13208, 0.01744,       53,        7,       46
IRP, 0.09434, 0.0089 ,       53,        5,       48
IRQ, 0.08197, 0.00672,       61,        5,       56
IRR, 0.11111, 0.01235,       54,        6,       48
IRS, 0.08537, 0.00729,       82,        7,       75
IRT, 0.13043, 0.01701,       46,        6,       40
IRV, 0.02817, 0.00079,       71,        2,       69
IRW, 0.14286, 0.02041,        7,        1,        6
IRY, 0.16279, 0.0265 ,       43,        7,       36
IR_, 0      , 0      ,        2,        0,        2
ISI, 0.13158, 0.01731,       38,        5,       33
ISK, 0.04396, 0.00193,       91,        4,       87
ISL, 0.06931, 0.0048 ,      101,        7,       94
ISM, 0.10256, 0.01052,       39,        4,       35
ISN, 0.05882, 0.00346,       68,        4,       64
ISP, 0.06061, 0.00367,       66,        4,       62
ISQ, 0.06349, 0.00403,       63,        4,       59
ISR, 0.11538, 0.01331,       78,        9,       69
ISS, 0.06742, 0.00454,       89,        6,       83
IST, 0.05479, 0.003  ,       73,        4,       69
ISV, 0.07792, 0.00607,       77,        6,       71
ISW, 0      , 0      ,       13,        0,       13
ISY, 0.0597 , 0.00356,       67,        4,       63
IS_, 0.25   , 0.0625 ,        4,        1,        3
ITI, 0.02941, 0.00087,       34,        1,       33
ITK, 0.04396, 0.00193,       91,        4,       87
ITL, 0.07207, 0.00519,      111,        8,      103
ITM, 0.06667, 0.00444,       30,        2,       28
ITN, 0.01754, 0.00031,       57,        1,       56
ITP, 0.0597 , 0.00356,       67,        4,       63
ITQ, 0.04762, 0.00227,       42,        2,       40
ITR, 0.04348, 0.00189,       69,        3,       66
ITS, 0.05195, 0.0027 ,       77,        4,       73
ITT, 0.04225, 0.00179,       71,        3,       68
ITV, 0.06931, 0.0048 ,      101,        7,       94
ITW, 0.05556, 0.00309,       18,        1,       17
ITY, 0.05455, 0.00298,       55,        3,       52
IT_, 0      , 0      ,        1,        0,        1
IVI, 0.04762, 0.00227,       21,        1,       20
IVK, 0.05063, 0.00256,       79,        4,       75
IVL, 0.04286, 0.00184,       70,        3,       67
IVM, 0.09091, 0.00826,       22,        2,       20
IVN, 0.06154, 0.00379,       65,        4,       61
IVP, 0.04688, 0.0022 ,       64,        3,       61
IVQ, 0.05882, 0.00346,       51,        3,       48
IVR, 0.04054, 0.00164,       74,        3,       71
IVS, 0.05952, 0.00354,       84,        5,       79
IVT, 0.0274 , 0.00075,       73,        2,       71
IVV, 0.03509, 0.00123,       57,        2,       55
IVW, 0      , 0      ,        5,        0,        5
IVY, 0.14286, 0.02041,       21,        3,       18
IV_, 0      , 0      ,        3,        0,        3
IWI, 0.14286, 0.02041,        7,        1,        6
IWK, 0.05882, 0.00346,       17,        1,       16
IWL, 0.14286, 0.02041,       14,        2,       12
IWM, 0.11111, 0.01235,        9,        1,        8
IWN, 0      , 0      ,       13,        0,       13
IWP, 0.05556, 0.00309,       18,        1,       17
IWQ, 0.1    , 0.01   ,       10,        1,        9
IWR, 0      , 0      ,        9,        0,        9
IWS, 0      , 0      ,       11,        0,       11
IWT, 0.15385, 0.02367,       26,        4,       22
IWV, 0      , 0      ,       11,        0,       11
IWW, 0      , 0      ,        3,        0,        3
IWY, 0.28571, 0.08163,        7,        2,        5
IYI, 0.15385, 0.02367,       13,        2,       11
IYK, 0.13889, 0.01929,       36,        5,       31
IYL, 0.10638, 0.01132,       47,        5,       42
IYM, 0.0625 , 0.00391,       16,        1,       15
IYN, 0.16327, 0.02666,       49,        8,       41
IYP, 0.11429, 0.01306,       35,        4,       31
IYQ, 0.0303 , 0.00092,       33,        1,       32
IYR, 0.09524, 0.00907,       42,        4,       38
IYS, 0.11111, 0.01235,       54,        6,       48
IYT, 0.1875 , 0.03516,       32,        6,       26
IYV, 0.10256, 0.01052,       39,        4,       35
IYW, 0      , 0      ,        3,        0,        3
IYY, 0.13793, 0.01902,       29,        4,       25
IY_, 0      , 0      ,        3,        0,        3
KAK, 0      , 0      ,       46,        0,       46
KAL, 0.03797, 0.00144,      158,        6,      152
KAM, 0.02632, 0.00069,       38,        1,       37
KAN, 0.0339 , 0.00115,       59,        2,       57
KAP, 0.03333, 0.00111,       60,        2,       58
KAQ, 0      , 0      ,       50,        0,       50
KAR, 0.03077, 0.00095,       65,        2,       63
KAS, 0.04545, 0.00207,       66,        3,       63
KAT, 0.02532, 0.00064,       79,        2,       77
KAV, 0.06667, 0.00444,      105,        7,       98
KAW, 0      , 0      ,        6,        0,        6
KAY, 0.08108, 0.00657,       37,        3,       34
KA_, 0      , 0      ,        9,        0,        9
KCK, 0      , 0      ,       13,        0,       13
KCL, 0.0625 , 0.00391,       32,        2,       30
KCM, 0.09091, 0.00826,       11,        1,       10
KCN, 0      , 0      ,        6,        0,        6
KCP, 0      , 0      ,       22,        0,       22
KCQ, 0      , 0      ,       12,        0,       12
KCR, 0.04348, 0.00189,       23,        1,       22
KCS, 0      , 0      ,       21,        0,       21
KCT, 0      , 0      ,       13,        0,       13
KCV, 0.04167, 0.00174,       24,        1,       23
KCW, 0      , 0      ,        1,        0,        1
KCY, 0.11111, 0.01235,        9,        1,        8
KC_, 0      , 0      ,        2,        0,        2
KDK, 0.02128, 0.00045,       47,        1,       46
KDL, 0.01887, 0.00036,      159,        3,      156
KDM, 0.08824, 0.00779,       34,        3,       31
KDN, 0.0122 , 0.00015,       82,        1,       81
KDP, 0.05405, 0.00292,       74,        4,       70
KDQ, 0.04082, 0.00167,       49,        2,       47
KDR, 0.0597 , 0.00356,       67,        4,       63
KDS, 0.04167, 0.00174,       96,        4,       92
KDT, 0.02151, 0.00046,       93,        2,       91
KDV, 0.06383, 0.00407,       94,        6,       88
KDW, 0.12   , 0.0144 ,       25,        3,       22
KDY, 0.01639, 0.00027,       61,        1,       60
KD_, 0      , 0      ,        8,        0,        8
KEK, 0      , 0      ,       68,        0,       68
KEL, 0.02353, 0.00055,      255,        6,      249
KEM, 0      , 0      ,       53,        0,       53
KEN, 0.0122 , 0.00015,       82,        1,       81
KEP, 0      , 0      ,       60,        0,       60
KEQ, 0.01562, 0.00024,       64,        1,       63
KER, 0.02469, 0.00061,       81,        2,       79
KES, 0.01205, 0.00015,       83,        1,       82
KET, 0.05882, 0.00346,       85,        5,       80
KEV, 0.05128, 0.00263,      156,        8,      148
KEW, 0.03333, 0.00111,       30,        1,       29
KEY, 0.03125, 0.00098,       64,        2,       62
KE_, 0.1    , 0.01   ,       10,        1,        9
KFK, 0      , 0      ,       27,        0,       27
KFL, 0.09091, 0.00826,       77,        7,       70
KFM, 0.16667, 0.02778,       18,        3,       15
KFN, 0.08772, 0.00769,       57,        5,       52
KFP, 0.21053, 0.04432,       38,        8,       30
KFQ, 0.0625 , 0.00391,       32,        2,       30
KFR, 0.16667, 0.02778,       36,        6,       30
KFS, 0.08889, 0.0079 ,       45,        4,       41
KFT, 0.09302, 0.00865,       43,        4,       39
KFV, 0.07547, 0.0057 ,       53,        4,       49
KFW, 0      , 0      ,       10,        0,       10
KFY, 0.16667, 0.02778,       42,        7,       35
KF_, 0      , 0      ,        1,        0,        1
KGK, 0.0566 , 0.0032 ,       53,        3,       50
KGL, 0.0283 , 0.0008 ,      106,        3,      103
KGM, 0.11429, 0.01306,       35,        4,       31
KGN, 0.04878, 0.00238,       82,        4,       78
KGP, 0.02041, 0.00042,       49,        1,       48
KGQ, 0      , 0      ,       56,        0,       56
KGR, 0.05455, 0.00298,       55,        3,       52
KGS, 0.03488, 0.00122,       86,        3,       83
KGT, 0.02198, 0.00048,       91,        2,       89
KGV, 0.05556, 0.00309,       90,        5,       85
KGW, 0.07692, 0.00592,       13,        1,       12
KGY, 0.01724, 0.0003 ,       58,        1,       57
KG_, 0      , 0      ,        7,        0,        7
KHK, 0      , 0      ,       13,        0,       13
KHL, 0.11111, 0.01235,       54,        6,       48
KHM, 0      , 0      ,       17,        0,       17
KHN, 0.04167, 0.00174,       24,        1,       23
KHP, 0      , 0      ,       16,        0,       16
KHQ, 0.07143, 0.0051 ,       14,        1,       13
KHR, 0.04762, 0.00227,       21,        1,       20
KHS, 0.05882, 0.00346,       34,        2,       32
KHT, 0.07692, 0.00592,       13,        1,       12
KHV, 0.18919, 0.03579,       37,        7,       30
KHW, 0      , 0      ,        5,        0,        5
KHY, 0.125  , 0.01562,       24,        3,       21
KH_, 0      , 0      ,        2,        0,        2
KIK, 0.075  , 0.00562,       40,        3,       37
KIL, 0.075  , 0.00562,      120,        9,      111
KIM, 0.03571, 0.00128,       28,        1,       27
KIN, 0.10294, 0.0106 ,       68,        7,       61
KIP, 0.01754, 0.00031,       57,        1,       56
KIQ, 0.05   , 0.0025 ,       40,        2,       38
KIR, 0.01613, 0.00026,       62,        1,       61
KIS, 0.10145, 0.01029,       69,        7,       62
KIT, 0.0411 , 0.00169,       73,        3,       70
KIV, 0.02703, 0.00073,       74,        2,       72
KIW, 0.2    , 0.04   ,       15,        3,       12
KIY, 0.075  , 0.00562,       40,        3,       37
KI_, 0      , 0      ,        4,        0,        4
KKK, 0.06383, 0.00407,       47,        3,       44
KKL, 0.04926, 0.00243,      203,       10,      193
KKM, 0.075  , 0.00562,       40,        3,       37
KKN, 0.01562, 0.00024,       64,        1,       63
KKP, 0.04545, 0.00207,       44,        2,       42
KKQ, 0.04444, 0.00198,       45,        2,       43
KKR, 0.03226, 0.00104,       62,        2,       60
KKS, 0.02857, 0.00082,       70,        2,       68
KKT, 0.025  , 0.00063,       80,        2,       78
KKV, 0.01754, 0.00031,      114,        2,      112
KKW, 0.06061, 0.00367,       33,        2,       31
KKY, 0.03125, 0.00098,       64,        2,       62
KK_, 0.0625 , 0.00391,       16,        1,       15
KLK, 0.10294, 0.0106 ,       68,        7,       61
KLL, 0.10048, 0.0101 ,      209,       21,      188
KLM, 0.07143, 0.0051 ,       42,        3,       39
KLN, 0.05405, 0.00292,      111,        6,      105
KLP, 0.02469, 0.00061,       81,        2,       79
KLQ, 0.06316, 0.00399,       95,        6,       89
KLR, 0.01818, 0.00033,      110,        2,      108
KLS, 0.08065, 0.0065 ,      124,       10,      114
KLT, 0.07547, 0.0057 ,      106,        8,       98
KLV, 0.07143, 0.0051 ,      140,       10,      130
KLW, 0.17647, 0.03114,       17,        3,       14
KLY, 0.08537, 0.00729,       82,        7,       75
KL_, 0      , 0      ,       10,        0,       10
KMK, 0.33333, 0.11111,       18,        6,       12
KML, 0.04762, 0.00227,       42,        2,       40
KMM, 0.13333, 0.01778,       15,        2,       13
KMN, 0.17647, 0.03114,       17,        3,       14
KMP, 0      , 0      ,       12,        0,       12
KMQ, 0.1    , 0.01   ,       20,        2,       18
KMR, 0.08696, 0.00756,       23,        2,       21
KMS, 0.03571, 0.00128,       28,        1,       27
KMT, 0.07143, 0.0051 ,       28,        2,       26
KMV, 0      , 0      ,       26,        0,       26
KMW, 0      , 0      ,        4,        0,        4
KMY, 0.06667, 0.00444,       15,        1,       14
KM_, 0      , 0      ,       14,        0,       14
KNK, 0      , 0      ,       41,        0,       41
KNL, 0.01786, 0.00032,      112,        2,      110
KNM, 0.03448, 0.00119,       29,        1,       28
KNN, 0.08   , 0.0064 ,       50,        4,       46
KNP, 0.08   , 0.0064 ,       50,        4,       46
KNQ, 0      , 0      ,       42,        0,       42
KNR, 0.02041, 0.00042,       49,        1,       48
KNS, 0.05882, 0.00346,       68,        4,       64
KNT, 0.04167, 0.00174,       48,        2,       46
KNV, 0.0411 , 0.00169,       73,        3,       70
KNW, 0.05882, 0.00346,       17,        1,       16
KNY, 0.09524, 0.00907,       42,        4,       38
KN_, 0      , 0      ,        6,        0,        6
KPK, 0      , 0      ,       30,        0,       30
KPL, 0.04902, 0.0024 ,      102,        5,       97
KPM, 0.08   , 0.0064 ,       25,        2,       23
KPN, 0.04255, 0.00181,       47,        2,       45
KPP, 0.025  , 0.00063,       40,        1,       39
KPQ, 0.07143, 0.0051 ,       28,        2,       26
KPR, 0.06818, 0.00465,       44,        3,       41
KPS, 0.03333, 0.00111,       60,        2,       58
KPT, 0.08929, 0.00797,       56,        5,       51
KPV, 0.025  , 0.00063,       80,        2,       78
KPW, 0.11111, 0.01235,        9,        1,        8
KPY, 0      , 0      ,       38,        0,       38
KP_, 0      , 0      ,        7,        0,        7
KQK, 0.05263, 0.00277,       19,        1,       18
KQL, 0.07   , 0.0049 ,      100,        7,       93
KQM, 0.16   , 0.0256 ,       25,        4,       21
KQN, 0.03333, 0.00111,       30,        1,       29
KQP, 0.03571, 0.00128,       28,        1,       27
KQQ, 0.01887, 0.00036,       53,        1,       52
KQR, 0.03125, 0.00098,       32,        1,       31
KQS, 0.05455, 0.00298,       55,        3,       52
KQT, 0.05556, 0.00309,       36,        2,       34
KQV, 0.06557, 0.0043 ,       61,        4,       57
KQW, 0.0625 , 0.00391,       16,        1,       15
KQY, 0.07895, 0.00623,       38,        3,       35
KQ_, 0      , 0      ,        5,        0,        5
KRK, 0.04878, 0.00238,       41,        2,       39
KRL, 0.00855, 0.00007,      117,        1,      116
KRM, 0.02778, 0.00077,       36,        1,       35
KRN, 0.13889, 0.01929,       36,        5,       31
KRP, 0.05556, 0.00309,       36,        2,       34
KRQ, 0.1    , 0.01   ,       30,        3,       27
KRR, 0.04615, 0.00213,       65,        3,       62
KRS, 0.15873, 0.0252 ,       63,       10,       53
KRT, 0.08065, 0.0065 ,       62,        5,       57
KRV, 0.07353, 0.00541,       68,        5,       63
KRW, 0.13333, 0.01778,       30,        4,       26
KRY, 0.06522, 0.00425,       46,        3,       43
KR_, 0.15385, 0.02367,       13,        2,       11
KSK, 0.05263, 0.00277,       38,        2,       36
KSL, 0.016  , 0.00026,      125,        2,      123
KSM, 0.06667, 0.00444,       30,        2,       28
KSN, 0.0678 , 0.0046 ,       59,        4,       55
KSP, 0.01429, 0.0002 ,       70,        1,       69
KSQ, 0.025  , 0.00063,       40,        1,       39
KSR, 0.0339 , 0.00115,       59,        2,       57
KSS, 0.04545, 0.00207,       66,        3,       63
KST, 0.04   , 0.0016 ,       75,        3,       72
KSV, 0.01389, 0.00019,       72,        1,       71
KSW, 0      , 0      ,       20,        0,       20
KSY, 0.03636, 0.00132,       55,        2,       53
KS_, 0      , 0      ,       10,        0,       10
KTK, 0      , 0      ,       36,        0,       36
KTL, 0.05161, 0.00266,      155,        8,      147
KTM, 0      , 0      ,       24,        0,       24
KTN, 0.02273, 0.00052,       44,        1,       43
KTP, 0.01613, 0.00026,       62,        1,       61
KTQ, 0.06977, 0.00487,       43,        3,       40
KTR, 0.02273, 0.00052,       44,        1,       43
KTS, 0.04918, 0.00242,       61,        3,       58
KTT, 0.07895, 0.00623,       76,        6,       70
KTV, 0.06944, 0.00482,       72,        5,       67
KTW, 0      , 0      ,       19,        0,       19
KTY, 0.0678 , 0.0046 ,       59,        4,       55
KT_, 0      , 0      ,        3,        0,        3
KVK, 0.13953, 0.01947,       43,        6,       37
KVL, 0.06667, 0.00444,      165,       11,      154
KVM, 0.15625, 0.02441,       32,        5,       27
KVN, 0.0625 , 0.00391,       64,        4,       60
KVP, 0.03704, 0.00137,       54,        2,       52
KVQ, 0.04878, 0.00238,       41,        2,       39
KVR, 0.08621, 0.00743,       58,        5,       53
KVS, 0.06316, 0.00399,       95,        6,       89
KVT, 0.02632, 0.00069,       76,        2,       74
KVV, 0.09091, 0.00826,       99,        9,       90
KVW, 0.13636, 0.0186 ,       22,        3,       19
KVY, 0.06977, 0.00487,       43,        3,       40
KV_, 0      , 0      ,        2,        0,        2
KWK, 0.33333, 0.11111,       12,        4,        8
KWL, 0.05   , 0.0025 ,       20,        1,       19
KWM, 0.1    , 0.01   ,       10,        1,        9
KWN, 0.125  , 0.01562,       16,        2,       14
KWP, 0      , 0      ,        8,        0,        8
KWQ, 0.15789, 0.02493,       19,        3,       16
KWR, 0.4375 , 0.19141,       16,        7,        9
KWS, 0.05882, 0.00346,       17,        1,       16
KWT, 0.22222, 0.04938,        9,        2,        7
KWV, 0.22222, 0.04938,       27,        6,       21
KWW, 0.125  , 0.01562,        8,        1,        7
KWY, 0.125  , 0.01562,       16,        2,       14
KW_, 0      , 0      ,        1,        0,        1
KYK, 0.03125, 0.00098,       32,        1,       31
KYL, 0.07792, 0.00607,       77,        6,       71
KYM, 0      , 0      ,       14,        0,       14
KYN, 0.09756, 0.00952,       41,        4,       37
KYP, 0.03846, 0.00148,       26,        1,       25
KYQ, 0      , 0      ,       37,        0,       37
KYR, 0.2    , 0.04   ,       45,        9,       36
KYS, 0.01923, 0.00037,       52,        1,       51
KYT, 0.09302, 0.00865,       43,        4,       39
KYV, 0.04444, 0.00198,       45,        2,       43
KYW, 0      , 0      ,       14,        0,       14
KYY, 0.17647, 0.03114,       51,        9,       42
LAL, 0.06098, 0.00372,       82,        5,       77
LAM, 0.05128, 0.00263,       39,        2,       37
LAN, 0.04124, 0.0017 ,       97,        4,       93
LAP, 0.09483, 0.00899,      116,       11,      105
LAQ, 0.04828, 0.00233,      145,        7,      138
LAR, 0.02419, 0.00059,      124,        3,      121
LAS, 0.03974, 0.00158,      151,        6,      145
LAT, 0.056  , 0.00314,      125,        7,      118
LAV, 0.04274, 0.00183,      117,        5,      112
LAW, 0.03571, 0.00128,       28,        1,       27
LAY, 0.05882, 0.00346,       51,        3,       48
LA_, 0      , 0      ,        7,        0,        7
LCL, 0.07692, 0.00592,       26,        2,       24
LCM, 0      , 0      ,        7,        0,        7
LCN, 0.07143, 0.0051 ,       28,        2,       26
LCP, 0.15789, 0.02493,       19,        3,       16
LCQ, 0      , 0      ,       23,        0,       23
LCR, 0.02632, 0.00069,       38,        1,       37
LCS, 0.05405, 0.00292,       37,        2,       35
LCT, 0.08   , 0.0064 ,       25,        2,       23
LCV, 0.03448, 0.00119,       29,        1,       28
LCW, 0      , 0      ,        1,        0,        1
LCY, 0      , 0      ,       20,        0,       20
LDL, 0.05882, 0.00346,       68,        4,       64
LDM, 0.07692, 0.00592,       52,        4,       48
LDN, 0.02   , 0.0004 ,      100,        2,       98
LDP, 0.07087, 0.00502,      127,        9,      118
LDQ, 0.07292, 0.00532,       96,        7,       89
LDR, 0.05882, 0.00346,      136,        8,      128
LDS, 0.08497, 0.00722,      153,       13,      140
LDT, 0.0531 , 0.00282,      113,        6,      107
LDV, 0.05405, 0.00292,      148,        8,      140
LDW, 0.08   , 0.0064 ,       25,        2,       23
LDY, 0.04688, 0.0022 ,       64,        3,       61
LD_, 0      , 0      ,        6,        0,        6
LEL, 0.03448, 0.00119,      116,        4,      112
LEM, 0.01852, 0.00034,       54,        1,       53
LEN, 0.05517, 0.00304,      145,        8,      137
LEP, 0.06767, 0.00458,      133,        9,      124
LEQ, 0.09091, 0.00826,      143,       13,      130
LER, 0.05185, 0.00269,      135,        7,      128
LES, 0.05072, 0.00257,      138,        7,      131
LET, 0.03788, 0.00143,      132,        5,      127
LEV, 0.0375 , 0.00141,      160,        6,      154
LEW, 0.04545, 0.00207,       22,        1,       21
LEY, 0.01429, 0.0002 ,       70,        1,       69
LE_, 0.11765, 0.01384,       17,        2,       15
LFL, 0.12963, 0.0168 ,       54,        7,       47
LFM, 0.11111, 0.01235,       18,        2,       16
LFN, 0.09091, 0.00826,       55,        5,       50
LFP, 0.10169, 0.01034,       59,        6,       53
LFQ, 0.05085, 0.00259,       59,        3,       56
LFR, 0.06944, 0.00482,       72,        5,       67
LFS, 0.05495, 0.00302,       91,        5,       86
LFT, 0.03226, 0.00104,       62,        2,       60
LFV, 0.11594, 0.01344,       69,        8,       61
LFW, 0      , 0      ,        5,        0,        5
LFY, 0.14286, 0.02041,       49,        7,       42
LF_, 0.33333, 0.11111,        6,        2,        4
LGL, 0.08989, 0.00808,       89,        8,       81
LGM, 0.06977, 0.00487,       43,        3,       40
LGN, 0.04211, 0.00177,       95,        4,       91
LGP, 0.0122 , 0.00015,       82,        1,       81
LGQ, 0.02632, 0.00069,       76,        2,       74
LGR, 0.05042, 0.00254,      119,        6,      113
LGS, 0.02597, 0.00067,      154,        4,      150
LGT, 0.06   , 0.0036 ,      100,        6,       94
LGV, 0.09091, 0.00826,       99,        9,       90
LGW, 0      , 0      ,       23,        0,       23
LGY, 0.05714, 0.00327,       70,        4,       66
LG_, 0      , 0      ,       12,        0,       12
LHL, 0.04348, 0.00189,       46,        2,       44
LHM, 0      , 0      ,       21,        0,       21
LHN, 0.09091, 0.00826,       44,        4,       40
LHP, 0.0625 , 0.00391,       48,        3,       45
LHQ, 0.07407, 0.00549,       54,        4,       50
LHR, 0.05   , 0.0025 ,       60,        3,       57
LHS, 0.1    , 0.01   ,       60,        6,       54
LHT, 0.1    , 0.01   ,       40,        4,       36
LHV, 0.05769, 0.00333,       52,        3,       49
LHW, 0.125  , 0.01562,        8,        1,        7
LHY, 0.08824, 0.00779,       34,        3,       31
LH_, 0      , 0      ,        2,        0,        2
LIL, 0.12766, 0.0163 ,       47,        6,       41
LIM, 0.03704, 0.00137,       27,        1,       26
LIN, 0.07692, 0.00592,       78,        6,       72
LIP, 0.07895, 0.00623,       76,        6,       70
LIQ, 0.07317, 0.00535,       82,        6,       76
LIR, 0.04348, 0.00189,       92,        4,       88
LIS, 0.04878, 0.00238,      123,        6,      117
LIT, 0.05263, 0.00277,       95,        5,       90
LIV, 0.05263, 0.00277,       76,        4,       72
LIW, 0.16667, 0.02778,       12,        2,       10
LIY, 0.06818, 0.00465,       44,        3,       41
LI_, 0.16667, 0.02778,        6,        1,        5
LKL, 0.05319, 0.00283,       94,        5,       89
LKM, 0.05882, 0.00346,       51,        3,       48
LKN, 0.1028 , 0.01057,      107,       11,       96
LKP, 0.02353, 0.00055,       85,        2,       83
LKQ, 0.05051, 0.00255,       99,        5,       94
LKR, 0.09449, 0.00893,      127,       12,      115
LKS, 0.08092, 0.00655,      173,       14,      159
LKT, 0.02857, 0.00082,      140,        4,      136
LKV, 0.05333, 0.00284,      150,        8,      142
LKW, 0.05   , 0.0025 ,       40,        2,       38
LKY, 0.11594, 0.01344,       69,        8,       61
LK_, 0.05263, 0.00277,       19,        1,       18
LLL, 0.03448, 0.00119,      116,        4,      112
LLM, 0.08696, 0.00756,       46,        4,       42
LLN, 0.04819, 0.00232,      166,        8,      158
LLP, 0.03947, 0.00156,      152,        6,      146
LLQ, 0.09195, 0.00846,      174,       16,      158
LLR, 0.06936, 0.00481,      173,       12,      161
LLS, 0.05584, 0.00312,      197,       11,      186
LLT, 0.07895, 0.00623,      152,       12,      140
LLV, 0.10769, 0.0116 ,      130,       14,      116
LLW, 0.03571, 0.00128,       28,        1,       27
LLY, 0.05634, 0.00317,       71,        4,       67
LL_, 0      , 0      ,        7,        0,        7
LML, 0.15789, 0.02493,       19,        3,       16
LMM, 0.35714, 0.12755,       14,        5,        9
LMN, 0.12195, 0.01487,       41,        5,       36
LMP, 0.03571, 0.00128,       28,        1,       27
LMQ, 0.04651, 0.00216,       43,        2,       41
LMR, 0      , 0      ,       36,        0,       36
LMS, 0.09615, 0.00925,       52,        5,       47
LMT, 0.07895, 0.00623,       38,        3,       35
LMV, 0.14634, 0.02142,       41,        6,       35
LMW, 0      , 0      ,        4,        0,        4
LMY, 0      , 0      ,       17,        0,       17
LM_, 0.125  , 0.01562,        8,        1,        7
LNL, 0.02564, 0.00066,       78,        2,       76
LNM, 0.0625 , 0.00391,       32,        2,       30
LNN, 0.07292, 0.00532,       96,        7,       89
LNP, 0.07368, 0.00543,       95,        7,       88
LNQ, 0.07937, 0.0063 ,       63,        5,       58
LNR, 0.08824, 0.00779,      102,        9,       93
LNS, 0.09821, 0.00965,      112,       11,      101
LNT, 0.04706, 0.00221,       85,        4,       81
LNV, 0.0625 , 0.00391,      112,        7,      105
LNW, 0.17647, 0.03114,       17,        3,       14
LNY, 0.01587, 0.00025,       63,        1,       62
LN_, 0      , 0      ,        8,        0,        8
LPL, 0.01471, 0.00022,       68,        1,       67
LPM, 0.05263, 0.00277,       19,        1,       18
LPN, 0.05479, 0.003  ,       73,        4,       69
LPP, 0.0084 , 0.00007,      119,        1,      118
LPQ, 0.01408, 0.0002 ,       71,        1,       70
LPR, 0.03448, 0.00119,       87,        3,       84
LPS, 0.04237, 0.0018 ,      118,        5,      113
LPT, 0.05319, 0.00283,       94,        5,       89
LPV, 0.03101, 0.00096,      129,        4,      125
LPW, 0.03704, 0.00137,       27,        1,       26
LPY, 0.05769, 0.00333,       52,        3,       49
LP_, 0      , 0      ,        7,        0,        7
LQL, 0.12162, 0.01479,       74,        9,       65
LQM, 0      , 0      ,       34,        0,       34
LQN, 0.08642, 0.00747,       81,        7,       74
LQP, 0.04478, 0.002  ,       67,        3,       64
LQQ, 0.04348, 0.00189,      115,        5,      110
LQR, 0.06522, 0.00425,       92,        6,       86
LQS, 0.0339 , 0.00115,      118,        4,      114
LQT, 0.02381, 0.00057,       84,        2,       82
LQV, 0.05983, 0.00358,      117,        7,      110
LQW, 0.04167, 0.00174,       24,        1,       23
LQY, 0.02857, 0.00082,       70,        2,       68
LQ_, 0.16667, 0.02778,        6,        1,        5
LRL, 0.15152, 0.02296,       99,       15,       84
LRM, 0.11905, 0.01417,       42,        5,       37
LRN, 0.09709, 0.00943,      103,       10,       93
LRP, 0.11881, 0.01412,      101,       12,       89
LRQ, 0.06731, 0.00453,      104,        7,       97
LRR, 0.125  , 0.01562,      120,       15,      105
LRS, 0.06164, 0.0038 ,      146,        9,      137
LRT, 0.09091, 0.00826,       88,        8,       80
LRV, 0.0411 , 0.00169,      146,        6,      140
LRW, 0.03226, 0.00104,       31,        1,       30
LRY, 0.11538, 0.01331,       78,        9,       69
LR_, 0      , 0      ,        4,        0,        4
LSL, 0.125  , 0.01562,      112,       14,       98
LSM, 0.02564, 0.00066,       39,        1,       38
LSN, 0.07368, 0.00543,       95,        7,       88
LSP, 0.03597, 0.00129,      139,        5,      134
LSQ, 0.03448, 0.00119,      116,        4,      112
LSR, 0.03077, 0.00095,      130,        4,      126
LSS, 0.08383, 0.00703,      167,       14,      153
LST, 0.04762, 0.00227,      126,        6,      120
LSV, 0.02326, 0.00054,      129,        3,      126
LSW, 0.09091, 0.00826,       33,        3,       30
LSY, 0.04918, 0.00242,       61,        3,       58
LS_, 0.09524, 0.00907,       21,        2,       19
LTL, 0.0303 , 0.00092,       66,        2,       64
LTM, 0.04762, 0.00227,       42,        2,       40
LTN, 0.09   , 0.0081 ,      100,        9,       91
LTP, 0      , 0      ,      133,        0,      133
LTQ, 0.03191, 0.00102,       94,        3,       91
LTR, 0.04598, 0.00211,       87,        4,       83
LTS, 0.0885 , 0.00783,      113,       10,      103
LTT, 0.05738, 0.00329,      122,        7,      115
LTV, 0.04861, 0.00236,      144,        7,      137
LTW, 0.06897, 0.00476,       29,        2,       27
LTY, 0.07353, 0.00541,       68,        5,       63
LT_, 0      , 0      ,        2,        0,        2
LVL, 0.03659, 0.00134,       82,        3,       79
LVM, 0.08108, 0.00657,       37,        3,       34
LVN, 0.03529, 0.00125,       85,        3,       82
LVP, 0.02542, 0.00065,      118,        3,      115
LVQ, 0.05882, 0.00346,      102,        6,       96
LVR, 0.05036, 0.00254,      139,        7,      132
LVS, 0.06522, 0.00425,      138,        9,      129
LVT, 0.05172, 0.00268,      116,        6,      110
LVV, 0.07207, 0.00519,      111,        8,      103
LVW, 0      , 0      ,       16,        0,       16
LVY, 0.04651, 0.00216,       43,        2,       41
LV_, 0      , 0      ,        3,        0,        3
LWL, 0.13333, 0.01778,       15,        2,       13
LWM, 0      , 0      ,        6,        0,        6
LWN, 0.15789, 0.02493,       19,        3,       16
LWP, 0.125  , 0.01562,       16,        2,       14
LWQ, 0.13043, 0.01701,       23,        3,       20
LWR, 0      , 0      ,       26,        0,       26
LWS, 0.23077, 0.05325,       26,        6,       20
LWT, 0.04545, 0.00207,       22,        1,       21
LWV, 0.21053, 0.04432,       19,        4,       15
LWW, 0      , 0      ,        7,        0,        7
LWY, 0.2    , 0.04   ,       15,        3,       12
LYL, 0.14   , 0.0196 ,       50,        7,       43
LYM, 0.20833, 0.0434 ,       24,        5,       19
LYN, 0.12698, 0.01612,       63,        8,       55
LYP, 0.125  , 0.01562,       64,        8,       56
LYQ, 0.08163, 0.00666,       49,        4,       45
LYR, 0.10843, 0.01176,       83,        9,       74
LYS, 0.10227, 0.01046,       88,        9,       79
LYT, 0.08824, 0.00779,       68,        6,       62
LYV, 0.08065, 0.0065 ,       62,        5,       57
LYW, 0.15385, 0.02367,       13,        2,       11
LYY, 0.20339, 0.04137,       59,       12,       47
LY_, 0      , 0      ,        5,        0,        5
MAM, 0      , 0      ,        6,        0,        6
MAN, 0      , 0      ,       18,        0,       18
MAP, 0.09091, 0.00826,       22,        2,       20
MAQ, 0      , 0      ,       28,        0,       28
MAR, 0      , 0      ,       31,        0,       31
MAS, 0      , 0      ,       33,        0,       33
MAT, 0.0625 , 0.00391,       32,        2,       30
MAV, 0.0625 , 0.00391,       32,        2,       30
MAW, 0      , 0      ,        7,        0,        7
MAY, 0.05   , 0.0025 ,       20,        1,       19
MA_, 0.1    , 0.01   ,       10,        1,        9
MCM, 0      , 0      ,        1,        0,        1
MCN, 0      , 0      ,        6,        0,        6
MCP, 0      , 0      ,        6,        0,        6
MCQ, 0      , 0      ,        6,        0,        6
MCR, 0.25   , 0.0625 ,        4,        1,        3
MCS, 0      , 0      ,        9,        0,        9
MCT, 0      , 0      ,        5,        0,        5
MCV, 0      , 0      ,        7,        0,        7
MCY, 0      , 0      ,        1,        0,        1
MC_, 0.33333, 0.11111,        3,        1,        2
MDM, 0      , 0      ,        3,        0,        3
MDN, 0      , 0      ,       17,        0,       17
MDP, 0.03333, 0.00111,       30,        1,       29
MDQ, 0.0303 , 0.00092,       33,        1,       32
MDR, 0.13333, 0.01778,       45,        6,       39
MDS, 0.06061, 0.00367,       33,        2,       31
MDT, 0.03571, 0.00128,       28,        1,       27
MDV, 0.03125, 0.00098,       32,        1,       31
MDW, 0.11111, 0.01235,        9,        1,        8
MDY, 0.04167, 0.00174,       24,        1,       23
MD_, 0      , 0      ,        1,        0,        1
MEM, 0      , 0      ,        9,        0,        9
MEN, 0.03571, 0.00128,       28,        1,       27
MEP, 0.12   , 0.0144 ,       25,        3,       22
MEQ, 0      , 0      ,       30,        0,       30
MER, 0      , 0      ,       34,        0,       34
MES, 0.02941, 0.00087,       34,        1,       33
MET, 0.07692, 0.00592,       26,        2,       24
MEV, 0.02439, 0.00059,       41,        1,       40
MEW, 0.125  , 0.01562,        8,        1,        7
MEY, 0.08   , 0.0064 ,       25,        2,       23
ME_, 0      , 0      ,        1,        0,        1
MFM, 0      , 0      ,        1,        0,        1
MFN, 0.11765, 0.01384,       17,        2,       15
MFP, 0      , 0      ,        7,        0,        7
MFQ, 0      , 0      ,        6,        0,        6
MFR, 0.1875 , 0.03516,       16,        3,       13
MFS, 0.08696, 0.00756,       23,        2,       21
MFT, 0      , 0      ,       12,        0,       12
MFV, 0.13333, 0.01778,       15,        2,       13
MFW, 0.16667, 0.02778,        6,        1,        5
MFY, 0.27273, 0.07438,       11,        3,        8
MF_, 0      , 0      ,        1,        0,        1
MGM, 0      , 0      ,        3,        0,        3
MGN, 0.05556, 0.00309,       18,        1,       17
MGP, 0.10811, 0.01169,       37,        4,       33
MGQ, 0.03704, 0.00137,       27,        1,       26
MGR, 0      , 0      ,       21,        0,       21
MGS, 0.02778, 0.00077,       36,        1,       35
MGT, 0.2    , 0.04   ,       25,        5,       20
MGV, 0.06667, 0.00444,       30,        2,       28
MGW, 0.3    , 0.09   ,       10,        3,        7
MGY, 0      , 0      ,       10,        0,       10
MG_, 0      , 0      ,        5,        0,        5
MHM, 0      , 0      ,        2,        0,        2
MHN, 0      , 0      ,        4,        0,        4
MHP, 0.07692, 0.00592,       13,        1,       12
MHQ, 0.125  , 0.01562,       16,        2,       14
MHR, 0.08333, 0.00694,       12,        1,       11
MHS, 0      , 0      ,       32,        0,       32
MHT, 0      , 0      ,        7,        0,        7
MHV, 0      , 0      ,        6,        0,        6
MHW, 0.6    , 0.36   ,        5,        3,        2
MHY, 0      , 0      ,        5,        0,        5
MH_, 0      , 0      ,        8,        0,        8
MIM, 0      , 0      ,        3,        0,        3
MIN, 0.09091, 0.00826,       22,        2,       20
MIP, 0.05882, 0.00346,       17,        1,       16
MIQ, 0      , 0      ,       25,        0,       25
MIR, 0.14286, 0.02041,       21,        3,       18
MIS, 0      , 0      ,       22,        0,       22
MIT, 0.03448, 0.00119,       29,        1,       28
MIV, 0.11111, 0.01235,       18,        2,       16
MIW, 0.5    , 0.25   ,        2,        1,        1
MIY, 0.14286, 0.02041,        7,        1,        6
MKM, 0.125  , 0.01562,        8,        1,        7
MKN, 0.04   , 0.0016 ,       25,        1,       24
MKP, 0.04348, 0.00189,       23,        1,       22
MKQ, 0.06897, 0.00476,       29,        2,       27
MKR, 0.07692, 0.00592,       26,        2,       24
MKS, 0.03448, 0.00119,       29,        1,       28
MKT, 0.03333, 0.00111,       30,        1,       29
MKV, 0.08333, 0.00694,       24,        2,       22
MKW, 0      , 0      ,        9,        0,        9
MKY, 0      , 0      ,       17,        0,       17
MK_, 0      , 0      ,        1,        0,        1
MLM, 0      , 0      ,        6,        0,        6
MLN, 0.07692, 0.00592,       39,        3,       36
MLP, 0.10345, 0.0107 ,       29,        3,       26
MLQ, 0.1    , 0.01   ,       40,        4,       36
MLR, 0      , 0      ,       33,        0,       33
MLS, 0.025  , 0.00063,       40,        1,       39
MLT, 0.05556, 0.00309,       36,        2,       34
MLV, 0.05263, 0.00277,       38,        2,       36
MLW, 0      , 0      ,        5,        0,        5
MLY, 0.05263, 0.00277,       19,        1,       18
ML_, 1      , 1      ,        2,        2,        0
MMM, 0      , 0      ,        1,        0,        1
MMN, 0.07143, 0.0051 ,       14,        1,       13
MMP, 0.2    , 0.04   ,        5,        1,        4
MMQ, 0.375  , 0.14062,       16,        6,       10
MMR, 0      , 0      ,        9,        0,        9
MMS, 0.1    , 0.01   ,       10,        1,        9
MMT, 0.33333, 0.11111,       12,        4,        8
MMV, 0.18182, 0.03306,       11,        2,        9
MMW, 0.5    , 0.25   ,        2,        1,        1
MMY, 0.25   , 0.0625 ,        8,        2,        6
MM_, 0      , 0      ,        1,        0,        1
MNM, 0      , 0      ,        2,        0,        2
MNN, 0.1875 , 0.03516,       16,        3,       13
MNP, 0      , 0      ,       19,        0,       19
MNQ, 0      , 0      ,       14,        0,       14
MNR, 0.06667, 0.00444,       15,        1,       14
MNS, 0.0625 , 0.00391,       32,        2,       30
MNT, 0.08333, 0.00694,       24,        2,       22
MNV, 0.04545, 0.00207,       22,        1,       21
MNW, 0      , 0      ,        6,        0,        6
MNY, 0.14286, 0.02041,        7,        1,        6
MN_, 0      , 0      ,        2,        0,        2
MPM, 0.66667, 0.44444,        3,        2,        1
MPN, 0      , 0      ,       22,        0,       22
MPP, 0.07692, 0.00592,       13,        1,       12
MPQ, 0.125  , 0.01562,        8,        1,        7
MPR, 0.13333, 0.01778,       15,        2,       13
MPS, 0.03571, 0.00128,       28,        1,       27
MPT, 0.05263, 0.00277,       19,        1,       18
MPV, 0.06452, 0.00416,       31,        2,       29
MPW, 0      , 0      ,        6,        0,        6
MPY, 0      , 0      ,        5,        0,        5
MP_, 0      , 0      ,        3,        0,        3
MQM, 0.28571, 0.08163,        7,        2,        5
MQN, 0      , 0      ,       19,        0,       19
MQP, 0.05   , 0.0025 ,       20,        1,       19
MQQ, 0.0625 , 0.00391,       16,        1,       15
MQR, 0.13636, 0.0186 ,       22,        3,       19
MQS, 0.04348, 0.00189,       23,        1,       22
MQT, 0.1    , 0.01   ,       20,        2,       18
MQV, 0.13333, 0.01778,       30,        4,       26
MQW, 0      , 0      ,        3,        0,        3
MQY, 0      , 0      ,        7,        0,        7
MQ_, 0      , 0      ,        4,        0,        4
MRM, 0      , 0      ,        4,        0,        4
MRN, 0.09091, 0.00826,       11,        1,       10
MRP, 0.07143, 0.0051 ,       14,        1,       13
MRQ, 0.08333, 0.00694,       24,        2,       22
MRR, 0.2069 , 0.04281,       29,        6,       23
MRS, 0.03704, 0.00137,       27,        1,       26
MRT, 0.15   , 0.0225 ,       20,        3,       17
MRV, 0.09677, 0.00937,       31,        3,       28
MRW, 0      , 0      ,        6,        0,        6
MRY, 0.2    , 0.04   ,       15,        3,       12
MR_, 0      , 0      ,        2,        0,        2
MSM, 0      , 0      ,        4,        0,        4
MSN, 0      , 0      ,       16,        0,       16
MSP, 0.03704, 0.00137,       27,        1,       26
MSQ, 0.05263, 0.00277,       19,        1,       18
MSR, 0.06897, 0.00476,       29,        2,       27
MSS, 0.125  , 0.01562,       32,        4,       28
MST, 0.17241, 0.02973,       29,        5,       24
MSV, 0.03125, 0.00098,       32,        1,       31
MSW, 0      , 0      ,        5,        0,        5
MSY, 0.17241, 0.02973,       29,        5,       24
MS_, 0.16667, 0.02778,        6,        1,        5
MTM, 0.09091, 0.00826,       11,        1,       10
MTN, 0      , 0      ,       18,        0,       18
MTP, 0.04762, 0.00227,       21,        1,       20
MTQ, 0.05263, 0.00277,       19,        1,       18
MTR, 0.05882, 0.00346,       17,        1,       16
MTS, 0.04   , 0.0016 ,       25,        1,       24
MTT, 0.08696, 0.00756,       23,        2,       21
MTV, 0.12   , 0.0144 ,       25,        3,       22
MTW, 0      , 0      ,        2,        0,        2
MTY, 0.16667, 0.02778,       12,        2,       10
MT_, 0      , 0      ,        3,        0,        3
MVM, 0      , 0      ,        6,        0,        6
MVN, 0.0625 , 0.00391,       16,        1,       15
MVP, 0      , 0      ,       24,        0,       24
MVQ, 0.04762, 0.00227,       21,        1,       20
MVR, 0.05   , 0.0025 ,       20,        1,       19
MVS, 0.05882, 0.00346,       34,        2,       32
MVT, 0.0625 , 0.00391,       32,        2,       30
MVV, 0      , 0      ,       24,        0,       24
MVW, 0.28571, 0.08163,        7,        2,        5
MVY, 0.23077, 0.05325,       13,        3,       10
MV_, 0      , 0      ,        1,        0,        1
MWN, 0.42857, 0.18367,        7,        3,        4
MWP, 0.33333, 0.11111,        3,        1,        2
MWQ, 0.4    , 0.16   ,        5,        2,        3
MWR, 0      , 0      ,        6,        0,        6
MWS, 0      , 0      ,        5,        0,        5
MWT, 0      , 0      ,        4,        0,        4
MWV, 0.25   , 0.0625 ,        4,        1,        3
MWW, 0.2    , 0.04   ,        5,        1,        4
MWY, 0.25   , 0.0625 ,        4,        1,        3
MYM, 0      , 0      ,        1,        0,        1
MYN, 0      , 0      ,        5,        0,        5
MYP, 0.17647, 0.03114,       17,        3,       14
MYQ, 0.16667, 0.02778,       12,        2,       10
MYR, 0.08333, 0.00694,       12,        1,       11
MYS, 0.14286, 0.02041,       21,        3,       18
MYT, 0.09091, 0.00826,       11,        1,       10
MYV, 0      , 0      ,       12,        0,       12
MYW, 0.4    , 0.16   ,        5,        2,        3
MYY, 0.13333, 0.01778,       15,        2,       13
NAN, 0.05263, 0.00277,       19,        1,       18
NAP, 0      , 0      ,       39,        0,       39
NAQ, 0.09756, 0.00952,       41,        4,       37
NAR, 0.02778, 0.00077,       36,        1,       35
NAS, 0.0597 , 0.00356,       67,        4,       63
NAT, 0.06   , 0.0036 ,       50,        3,       47
NAV, 0.01923, 0.00037,       52,        1,       51
NAW, 0.05882, 0.00346,       17,        1,       16
NAY, 0.05714, 0.00327,       35,        2,       33
NA_, 0      , 0      ,        5,        0,        5
NCN, 0      , 0      ,        4,        0,        4
NCP, 0      , 0      ,       10,        0,       10
NCQ, 0      , 0      ,       11,        0,       11
NCR, 0      , 0      ,       19,        0,       19
NCS, 0      , 0      ,       17,        0,       17
NCT, 0.05556, 0.00309,       18,        1,       17
NCV, 0      , 0      ,       15,        0,       15
NCW, 0.16667, 0.02778,        6,        1,        5
NCY, 0.0625 , 0.00391,       16,        1,       15
NDN, 0.05263, 0.00277,       19,        1,       18
NDP, 0.05455, 0.00298,       55,        3,       52
NDQ, 0.02632, 0.00069,       38,        1,       37
NDR, 0.03922, 0.00154,       51,        2,       49
NDS, 0.01818, 0.00033,       55,        1,       54
NDT, 0.06667, 0.00444,       45,        3,       42
NDV, 0.05357, 0.00287,       56,        3,       53
NDW, 0.13333, 0.01778,       15,        2,       13
NDY, 0.13889, 0.01929,       36,        5,       31
ND_, 0      , 0      ,        2,        0,        2
NEN, 0.08   , 0.0064 ,       25,        2,       23
NEP, 0.04688, 0.0022 ,       64,        3,       61
NEQ, 0.0303 , 0.00092,       33,        1,       32
NER, 0.03279, 0.00107,       61,        2,       59
NES, 0      , 0      ,       76,        0,       76
NET, 0.03125, 0.00098,       64,        2,       62
NEV, 0.02326, 0.00054,       86,        2,       84
NEW, 0.04762, 0.00227,       21,        1,       20
NEY, 0.0625 , 0.00391,       48,        3,       45
NE_, 0      , 0      ,        7,        0,        7
NFN, 0      , 0      ,       19,        0,       19
NFP, 0.07143, 0.0051 ,       28,        2,       26
NFQ, 0      , 0      ,       40,        0,       40
NFR, 0.09091, 0.00826,       44,        4,       40
NFS, 0.0339 , 0.00115,       59,        2,       57
NFT, 0.06   , 0.0036 ,       50,        3,       47
NFV, 0.05263, 0.00277,       38,        2,       36
NFW, 0.18182, 0.03306,       11,        2,        9
NFY, 0.16   , 0.0256 ,       25,        4,       21
NF_, 0.5    , 0.25   ,        2,        1,        1
NGN, 0.02778, 0.00077,       36,        1,       35
NGP, 0.05   , 0.0025 ,       40,        2,       38
NGQ, 0.02041, 0.00042,       49,        1,       48
NGR, 0.0137 , 0.00019,       73,        1,       72
NGS, 0.04301, 0.00185,       93,        4,       89
NGT, 0.02381, 0.00057,       84,        2,       82
NGV, 0.04444, 0.00198,       90,        4,       86
NGW, 0.06667, 0.00444,       15,        1,       14
NGY, 0.12727, 0.0162 ,       55,        7,       48
NG_, 0      , 0      ,        7,        0,        7
NHN, 0.3    , 0.09   ,       10,        3,        7
NHP, 0.05   , 0.0025 ,       20,        1,       19
NHQ, 0.14286, 0.02041,       14,        2,       12
NHR, 0.2    , 0.04   ,       15,        3,       12
NHS, 0.09524, 0.00907,       21,        2,       19
NHT, 0.05   , 0.0025 ,       20,        1,       19
NHV, 0.09091, 0.00826,       22,        2,       20
NHW, 0      , 0      ,        3,        0,        3
NHY, 0.0625 , 0.00391,       16,        1,       15
NIN, 0.04   , 0.0016 ,       25,        1,       24
NIP, 0.03922, 0.00154,       51,        2,       49
NIQ, 0.0625 , 0.00391,       32,        2,       30
NIR, 0.08333, 0.00694,       48,        4,       44
NIS, 0.08108, 0.00657,       74,        6,       68
NIT, 0.07463, 0.00557,       67,        5,       62
NIV, 0.0597 , 0.00356,       67,        4,       63
NIW, 0.05556, 0.00309,       18,        1,       17
NIY, 0.12821, 0.01644,       39,        5,       34
NI_, 0      , 0      ,        6,        0,        6
NKN, 0      , 0      ,       27,        0,       27
NKP, 0.04762, 0.00227,       42,        2,       40
NKQ, 0.02564, 0.00066,       39,        1,       38
NKR, 0.05085, 0.00259,       59,        3,       56
NKS, 0.05357, 0.00287,       56,        3,       53
NKT, 0.08197, 0.00672,       61,        5,       56
NKV, 0.07317, 0.00535,       82,        6,       76
NKW, 0.1    , 0.01   ,       10,        1,        9
NKY, 0.04255, 0.00181,       47,        2,       45
NK_, 0      , 0      ,        2,        0,        2
NLN, 0      , 0      ,       31,        0,       31
NLP, 0.06667, 0.00444,       75,        5,       70
NLQ, 0.01754, 0.00031,       57,        1,       56
NLR, 0.02899, 0.00084,       69,        2,       67
NLS, 0.14851, 0.02206,      101,       15,       86
NLT, 0.05376, 0.00289,       93,        5,       88
NLV, 0.04819, 0.00232,       83,        4,       79
NLW, 0.07143, 0.0051 ,       14,        1,       13
NLY, 0.03175, 0.00101,       63,        2,       61
NL_, 0      , 0      ,        4,        0,        4
NMN, 0.14286, 0.02041,        7,        1,        6
NMP, 0.27778, 0.07716,       18,        5,       13
NMQ, 0.3    , 0.09   ,       10,        3,        7
NMR, 0      , 0      ,       13,        0,       13
NMS, 0      , 0      ,       19,        0,       19
NMT, 0.05882, 0.00346,       17,        1,       16
NMV, 0.13043, 0.01701,       23,        3,       20
NMW, 0.16667, 0.02778,        6,        1,        5
NMY, 0.18182, 0.03306,       11,        2,        9
NM_, 0      , 0      ,        7,        0,        7
NNN, 0.05   , 0.0025 ,       20,        1,       19
NNP, 0.07317, 0.00535,       41,        3,       38
NNQ, 0      , 0      ,       28,        0,       28
NNR, 0.06977, 0.00487,       43,        3,       40
NNS, 0.01887, 0.00036,       53,        1,       52
NNT, 0.025  , 0.00063,       40,        1,       39
NNV, 0.05556, 0.00309,       54,        3,       51
NNW, 0.0625 , 0.00391,       16,        1,       15
NNY, 0.06818, 0.00465,       44,        3,       41
NN_, 0      , 0      ,        5,        0,        5
NPN, 0.04762, 0.00227,       42,        2,       40
NPP, 0      , 0      ,       55,        0,       55
NPQ, 0.03333, 0.00111,       30,        1,       29
NPR, 0.08   , 0.0064 ,       25,        2,       23
NPS, 0.01389, 0.00019,       72,        1,       71
NPT, 0.01923, 0.00037,       52,        1,       51
NPV, 0.02273, 0.00052,       44,        1,       43
NPW, 0      , 0      ,        4,        0,        4
NPY, 0.06061, 0.00367,       33,        2,       31
NP_, 0      , 0      ,        1,        0,        1
NQN, 0      , 0      ,       13,        0,       13
NQP, 0      , 0      ,       21,        0,       21
NQQ, 0      , 0      ,       34,        0,       34
NQR, 0.02703, 0.00073,       37,        1,       36
NQS, 0.09434, 0.0089 ,       53,        5,       48
NQT, 0.09677, 0.00937,       31,        3,       28
NQV, 0.04348, 0.00189,       46,        2,       44
NQW, 0      , 0      ,        9,        0,        9
NQY, 0      , 0      ,       24,        0,       24
NQ_, 0      , 0      ,        1,        0,        1
NRN, 0.08696, 0.00756,       23,        2,       21
NRP, 0.06667, 0.00444,       45,        3,       42
NRQ, 0.09091, 0.00826,       22,        2,       20
NRR, 0.05263, 0.00277,       38,        2,       36
NRS, 0.17857, 0.03189,       56,       10,       46
NRT, 0.09756, 0.00952,       41,        4,       37
NRV, 0.04615, 0.00213,       65,        3,       62
NRW, 0.23077, 0.05325,       13,        3,       10
NRY, 0.15556, 0.0242 ,       45,        7,       38
NR_, 0      , 0      ,        1,        0,        1
NSN, 0.08333, 0.00694,       24,        2,       22
NSP, 0.03509, 0.00123,       57,        2,       55
NSQ, 0.05405, 0.00292,       37,        2,       35
NSR, 0      , 0      ,       53,        0,       53
NSS, 0.03226, 0.00104,       93,        3,       90
NST, 0.03704, 0.00137,       54,        2,       52
NSV, 0.08065, 0.0065 ,       62,        5,       57
NSW, 0      , 0      ,       16,        0,       16
NSY, 0      , 0      ,       32,        0,       32
NS_, 0.14286, 0.02041,        7,        1,        6
NTN, 0      , 0      ,       18,        0,       18
NTP, 0      , 0      ,       33,        0,       33
NTQ, 0.03125, 0.00098,       32,        1,       31
NTR, 0      , 0      ,       33,        0,       33
NTS, 0.05357, 0.00287,       56,        3,       53
NTT, 0.11321, 0.01282,       53,        6,       47
NTV, 0.01538, 0.00024,       65,        1,       64
NTW, 0.0625 , 0.00391,       16,        1,       15
NTY, 0.04878, 0.00238,       41,        2,       39
NT_, 0      , 0      ,        1,        0,        1
NVN, 0.04762, 0.00227,       21,        1,       20
NVP, 0.05063, 0.00256,       79,        4,       75
NVQ, 0.04348, 0.00189,       46,        2,       44
NVR, 0.04167, 0.00174,       48,        2,       46
NVS, 0.02941, 0.00087,       68,        2,       66
NVT, 0.06849, 0.00469,       73,        5,       68
NVV, 0.03704, 0.00137,       81,        3,       78
NVW, 0      , 0      ,       12,        0,       12
NVY, 0.10526, 0.01108,       38,        4,       34
NWN, 0.11111, 0.01235,        9,        1,        8
NWP, 0      , 0      ,       13,        0,       13
NWQ, 0      , 0      ,        7,        0,        7
NWR, 0.08333, 0.00694,       12,        1,       11
NWS, 0.05   , 0.0025 ,       20,        1,       19
NWT, 0.07143, 0.0051 ,       14,        1,       13
NWV, 0.05882, 0.00346,       17,        1,       16
NWW, 0      , 0      ,        4,        0,        4
NWY, 0.57143, 0.32653,       14,        8,        6
NYN, 0      , 0      ,       13,        0,       13
NYP, 0.08333, 0.00694,       36,        3,       33
NYQ, 0.21212, 0.045  ,       33,        7,       26
NYR, 0.04444, 0.00198,       45,        2,       43
NYS, 0.125  , 0.01562,       40,        5,       35
NYT, 0.10811, 0.01169,       37,        4,       33
NYV, 0.24528, 0.06016,       53,       13,       40
NYW, 0      , 0      ,       14,        0,       14
NYY, 0.25806, 0.0666 ,       31,        8,       23
NY_, 0      , 0      ,        2,        0,        2
PAP, 0.03704, 0.00137,       27,        1,       26
PAQ, 0.02273, 0.00052,       44,        1,       43
PAR, 0.04444, 0.00198,       45,        2,       43
PAS, 0.04   , 0.0016 ,       75,        3,       72
PAT, 0.01754, 0.00031,       57,        1,       56
PAV, 0.02667, 0.00071,       75,        2,       73
PAW, 0.09091, 0.00826,       11,        1,       10
PAY, 0.02703, 0.00073,       37,        1,       36
PA_, 0      , 0      ,        7,        0,        7
PCP, 0.08333, 0.00694,       12,        1,       11
PCQ, 0.05556, 0.00309,       18,        1,       17
PCR, 0.1    , 0.01   ,       10,        1,        9
PCS, 0.03571, 0.00128,       28,        1,       27
PCT, 0.11111, 0.01235,       18,        2,       16
PCV, 0.21429, 0.04592,       14,        3,       11
PCW, 0      , 0      ,        2,        0,        2
PCY, 0      , 0      ,       10,        0,       10
PDP, 0.125  , 0.01562,       32,        4,       28
PDQ, 0.07547, 0.0057 ,       53,        4,       49
PDR, 0.06   , 0.0036 ,       50,        3,       47
PDS, 0.04054, 0.00164,       74,        3,       71
PDT, 0.01667, 0.00028,       60,        1,       59
PDV, 0.02817, 0.00079,       71,        2,       69
PDW, 0      , 0      ,       16,        0,       16
PDY, 0.07843, 0.00615,       51,        4,       47
PD_, 0      , 0      ,        6,        0,        6
PEP, 0.09091, 0.00826,       33,        3,       30
PEQ, 0.05   , 0.0025 ,       40,        2,       38
PER, 0.01515, 0.00023,       66,        1,       65
PES, 0.03797, 0.00144,       79,        3,       76
PET, 0.04412, 0.00195,       68,        3,       65
PEV, 0.09756, 0.00952,       82,        8,       74
PEW, 0.18182, 0.03306,       33,        6,       27
PEY, 0.09302, 0.00865,       43,        4,       39
PE_, 0      , 0      ,       14,        0,       14
PFP, 0.09524, 0.00907,       21,        2,       19
PFQ, 0.2    , 0.04   ,       35,        7,       28
PFR, 0.02174, 0.00047,       46,        1,       45
PFS, 0.02083, 0.00043,       48,        1,       47
PFT, 0.09615, 0.00925,       52,        5,       47
PFV, 0.16667, 0.02778,       48,        8,       40
PFW, 0.125  , 0.01562,        8,        1,        7
PFY, 0.04545, 0.00207,       22,        1,       21
PF_, 0      , 0      ,        2,        0,        2
PGP, 0      , 0      ,       27,        0,       27
PGQ, 0.04762, 0.00227,       42,        2,       40
PGR, 0      , 0      ,       48,        0,       48
PGS, 0.03158, 0.001  ,       95,        3,       92
PGT, 0.04054, 0.00164,       74,        3,       71
PGV, 0.01471, 0.00022,       68,        1,       67
PGW, 0.04167, 0.00174,       24,        1,       23
PGY, 0.02632, 0.00069,       38,        1,       37
PG_, 0      , 0      ,       22,        0,       22
PHP, 0.07143, 0.0051 ,       14,        1,       13
PHQ, 0.07692, 0.00592,       13,        1,       12
PHR, 0.05556, 0.00309,       18,        1,       17
PHS, 0.09091, 0.00826,       22,        2,       20
PHT, 0.0625 , 0.00391,       32,        2,       30
PHV, 0.06452, 0.00416,       31,        2,       29
PHW, 0      , 0      ,        5,        0,        5
PHY, 0.125  , 0.01562,        8,        1,        7
PH_, 0      , 0      ,        3,        0,        3
PIP, 0.125  , 0.01562,       32,        4,       28
PIQ, 0.08889, 0.0079 ,       45,        4,       41
PIR, 0      , 0      ,       41,        0,       41
PIS, 0.08451, 0.00714,       71,        6,       65
PIT, 0.1    , 0.01   ,       60,        6,       54
PIV, 0      , 0      ,       75,        0,       75
PIW, 0      , 0      ,        8,        0,        8
PIY, 0.1    , 0.01   ,       30,        3,       27
PI_, 0      , 0      ,        5,        0,        5
PKP, 0      , 0      ,       22,        0,       22
PKQ, 0      , 0      ,       36,        0,       36
PKR, 0.05455, 0.00298,       55,        3,       52
PKS, 0.05172, 0.00268,       58,        3,       55
PKT, 0.03704, 0.00137,       54,        2,       52
PKV, 0.06024, 0.00363,       83,        5,       78
PKW, 0      , 0      ,       21,        0,       21
PKY, 0.02632, 0.00069,       38,        1,       37
PK_, 0      , 0      ,       12,        0,       12
PLP, 0.03846, 0.00148,       78,        3,       75
PLQ, 0.01429, 0.0002 ,       70,        1,       69
PLR, 0.02899, 0.00084,       69,        2,       67
PLS, 0.04065, 0.00165,      123,        5,      118
PLT, 0.01961, 0.00038,      102,        2,      100
PLV, 0.03297, 0.00109,       91,        3,       88
PLW, 0      , 0      ,       24,        0,       24
PLY, 0.05556, 0.00309,       54,        3,       51
PL_, 0      , 0      ,        2,        0,        2
PMP, 0      , 0      ,        9,        0,        9
PMQ, 0.07143, 0.0051 ,       14,        1,       13
PMR, 0.1875 , 0.03516,       16,        3,       13
PMS, 0      , 0      ,       14,        0,       14
PMT, 0.16   , 0.0256 ,       25,        4,       21
PMV, 0.26087, 0.06805,       23,        6,       17
PMW, 0      , 0      ,        2,        0,        2
PMY, 0      , 0      ,       11,        0,       11
PM_, 0      , 0      ,        4,        0,        4
PNP, 0      , 0      ,       23,        0,       23
PNQ, 0.08824, 0.00779,       34,        3,       31
PNR, 0.04255, 0.00181,       47,        2,       45
PNS, 0.06383, 0.00407,       47,        3,       44
PNT, 0.04444, 0.00198,       45,        2,       43
PNV, 0.0678 , 0.0046 ,       59,        4,       55
PNW, 0.15385, 0.02367,       13,        2,       11
PNY, 0.07843, 0.00615,       51,        4,       47
PN_, 0      , 0      ,        2,        0,        2
PPP, 0.04167, 0.00174,       48,        2,       46
PPQ, 0.02222, 0.00049,       45,        1,       44
PPR, 0.025  , 0.00063,       40,        1,       39
PPS, 0      , 0      ,       57,        0,       57
PPT, 0.03448, 0.00119,       58,        2,       56
PPV, 0      , 0      ,       58,        0,       58
PPW, 0.1    , 0.01   ,       10,        1,        9
PPY, 0.18182, 0.03306,       22,        4,       18
PP_, 0      , 0      ,        8,        0,        8
PQP, 0.04167, 0.00174,       24,        1,       23
PQQ, 0      , 0      ,       43,        0,       43
PQR, 0.05556, 0.00309,       36,        2,       34
PQS, 0.03125, 0.00098,       32,        1,       31
PQT, 0.07317, 0.00535,       41,        3,       38
PQV, 0.12245, 0.01499,       49,        6,       43
PQW, 0.125  , 0.01562,        8,        1,        7
PQY, 0.21053, 0.04432,       19,        4,       15
PQ_, 0      , 0      ,        3,        0,        3
PRP, 0.1    , 0.01   ,       20,        2,       18
PRQ, 0.10345, 0.0107 ,       29,        3,       26
PRR, 0.04762, 0.00227,       42,        2,       40
PRS, 0.05085, 0.00259,       59,        3,       56
PRT, 0.13333, 0.01778,       45,        6,       39
PRV, 0.10714, 0.01148,       56,        6,       50
PRW, 0      , 0      ,       11,        0,       11
PRY, 0.05714, 0.00327,       35,        2,       33
PR_, 0.125  , 0.01562,        8,        1,        7
PSP, 0      , 0      ,       26,        0,       26
PSQ, 0.04762, 0.00227,       42,        2,       40
PSR, 0      , 0      ,       45,        0,       45
PSS, 0.075  , 0.00562,       80,        6,       74
PST, 0.04545, 0.00207,       44,        2,       42
PSV, 0.03488, 0.00122,       86,        3,       83
PSW, 0.0625 , 0.00391,       16,        1,       15
PSY, 0      , 0      ,       39,        0,       39
PS_, 0      , 0      ,       14,        0,       14
PTP, 0.05556, 0.00309,       36,        2,       34
PTQ, 0.03125, 0.00098,       32,        1,       31
PTR, 0.02703, 0.00073,       37,        1,       36
PTS, 0.03077, 0.00095,       65,        2,       63
PTT, 0.02174, 0.00047,       46,        1,       45
PTV, 0      , 0      ,       67,        0,       67
PTW, 0.11538, 0.01331,       26,        3,       23
PTY, 0.03846, 0.00148,       52,        2,       50
PT_, 0      , 0      ,        1,        0,        1
PVP, 0.0625 , 0.00391,       32,        2,       30
PVQ, 0.10638, 0.01132,       47,        5,       42
PVR, 0.02128, 0.00045,       47,        1,       46
PVS, 0.0463 , 0.00214,      108,        5,      103
PVT, 0.03896, 0.00152,       77,        3,       74
PVV, 0.02703, 0.00073,       74,        2,       72
PVW, 0      , 0      ,       18,        0,       18
PVY, 0.12121, 0.01469,       33,        4,       29
PV_, 0      , 0      ,        1,        0,        1
PWP, 0      , 0      ,        6,        0,        6
PWQ, 0      , 0      ,       12,        0,       12
PWR, 0      , 0      ,       11,        0,       11
PWS, 0.1    , 0.01   ,       20,        2,       18
PWT, 0.11111, 0.01235,       18,        2,       16
PWV, 0      , 0      ,       11,        0,       11
PWW, 0      , 0      ,        2,        0,        2
PWY, 0      , 0      ,       12,        0,       12
PYP, 0.10526, 0.01108,       19,        2,       17
PYQ, 0.04167, 0.00174,       24,        1,       23
PYR, 0.04167, 0.00174,       24,        1,       23
PYS, 0.16667, 0.02778,       36,        6,       30
PYT, 0.16216, 0.0263 ,       37,        6,       31
PYV, 0.07547, 0.0057 ,       53,        4,       49
PYW, 0.33333, 0.11111,        6,        2,        4
PYY, 0.23077, 0.05325,       26,        6,       20
PY_, 0      , 0      ,        1,        0,        1
QAQ, 0      , 0      ,       23,        0,       23
QAR, 0.04167, 0.00174,       48,        2,       46
QAS, 0.03509, 0.00123,       57,        2,       55
QAT, 0.08163, 0.00666,       49,        4,       45
QAV, 0.06061, 0.00367,       66,        4,       62
QAW, 0.08333, 0.00694,       12,        1,       11
QAY, 0      , 0      ,       28,        0,       28
QA_, 0      , 0      ,        7,        0,        7
QCQ, 0      , 0      ,       14,        0,       14
QCR, 0.05556, 0.00309,       18,        1,       17
QCS, 0      , 0      ,       13,        0,       13
QCT, 0.07143, 0.0051 ,       14,        1,       13
QCV, 0      , 0      ,       10,        0,       10
QCW, 0      , 0      ,        2,        0,        2
QCY, 0      , 0      ,        8,        0,        8
QDQ, 0      , 0      ,       18,        0,       18
QDR, 0.0303 , 0.00092,       33,        1,       32
QDS, 0.05128, 0.00263,       39,        2,       37
QDT, 0.02083, 0.00043,       48,        1,       47
QDV, 0.10938, 0.01196,       64,        7,       57
QDW, 0      , 0      ,       11,        0,       11
QDY, 0.02857, 0.00082,       35,        1,       34
QD_, 0.14286, 0.02041,        7,        1,        6
QEQ, 0.03125, 0.00098,       32,        1,       31
QER, 0.01786, 0.00032,       56,        1,       55
QES, 0.10145, 0.01029,       69,        7,       62
QET, 0.02041, 0.00042,       49,        1,       48
QEV, 0.0274 , 0.00075,       73,        2,       71
QEW, 0.04762, 0.00227,       21,        1,       20
QEY, 0.02381, 0.00057,       42,        1,       41
QE_, 0      , 0      ,        6,        0,        6
QFQ, 0      , 0      ,       15,        0,       15
QFR, 0.10345, 0.0107 ,       29,        3,       26
QFS, 0.09091, 0.00826,       33,        3,       30
QFT, 0.07273, 0.00529,       55,        4,       51
QFV, 0.0625 , 0.00391,       32,        2,       30
QFW, 0      , 0      ,        3,        0,        3
QFY, 0.125  , 0.01562,       24,        3,       21
QF_, 0      , 0      ,        3,        0,        3
QGQ, 0.03448, 0.00119,       29,        1,       28
QGR, 0.04167, 0.00174,       48,        2,       46
QGS, 0.05   , 0.0025 ,       60,        3,       57
QGT, 0.03922, 0.00154,       51,        2,       49
QGV, 0.06667, 0.00444,       45,        3,       42
QGW, 0.07143, 0.0051 ,       14,        1,       13
QGY, 0      , 0      ,       26,        0,       26
QG_, 0      , 0      ,        1,        0,        1
QHQ, 0.25   , 0.0625 ,        8,        2,        6
QHR, 0      , 0      ,       18,        0,       18
QHS, 0.07692, 0.00592,       13,        1,       12
QHT, 0.16667, 0.02778,       18,        3,       15
QHV, 0.04348, 0.00189,       23,        1,       22
QHW, 0      , 0      ,        6,        0,        6
QHY, 0      , 0      ,       17,        0,       17
QIQ, 0.05556, 0.00309,       18,        1,       17
QIR, 0.11364, 0.01291,       44,        5,       39
QIS, 0.06122, 0.00375,       49,        3,       46
QIT, 0.12195, 0.01487,       41,        5,       36
QIV, 0.03636, 0.00132,       55,        2,       53
QIW, 0      , 0      ,       12,        0,       12
QIY, 0.03125, 0.00098,       32,        1,       31
QI_, 0      , 0      ,        1,        0,        1
QKQ, 0.06667, 0.00444,       15,        1,       14
QKR, 0.06667, 0.00444,       45,        3,       42
QKS, 0.06557, 0.0043 ,       61,        4,       57
QKT, 0.06667, 0.00444,       30,        2,       28
QKV, 0.01333, 0.00018,       75,        1,       74
QKW, 0.04762, 0.00227,       21,        1,       20
QKY, 0.0303 , 0.00092,       33,        1,       32
QK_, 0      , 0      ,        4,        0,        4
QLQ, 0.06061, 0.00367,       33,        2,       31
QLR, 0.01471, 0.00022,       68,        1,       67
QLS, 0.0381 , 0.00145,      105,        4,      101
QLT, 0.06098, 0.00372,       82,        5,       77
QLV, 0.06   , 0.0036 ,      100,        6,       94
QLW, 0.16667, 0.02778,        6,        1,        5
QLY, 0.06667, 0.00444,       45,        3,       42
QL_, 0      , 0      ,        7,        0,        7
QMQ, 0      , 0      ,        6,        0,        6
QMR, 0      , 0      ,       19,        0,       19
QMS, 0      , 0      ,       20,        0,       20
QMT, 0.06667, 0.00444,       15,        1,       14
QMV, 0.13636, 0.0186 ,       22,        3,       19
QMW, 0      , 0      ,        6,        0,        6
QMY, 0      , 0      ,       10,        0,       10
QM_, 0      , 0      ,        9,        0,        9
QNQ, 0.13333, 0.01778,       15,        2,       13
QNR, 0.06452, 0.00416,       31,        2,       29
QNS, 0.13636, 0.0186 ,       44,        6,       38
QNT, 0.13333, 0.01778,       30,        4,       26
QNV, 0.06122, 0.00375,       49,        3,       46
QNW, 0.06667, 0.00444,       15,        1,       14
QNY, 0.05714, 0.00327,       35,        2,       33
QN_, 0      , 0      ,        3,        0,        3
QPQ, 0      , 0      ,       14,        0,       14
QPR, 0.08   , 0.0064 ,       25,        2,       23
QPS, 0      , 0      ,       44,        0,       44
QPT, 0      , 0      ,       35,        0,       35
QPV, 0.0566 , 0.0032 ,       53,        3,       50
QPW, 0.11111, 0.01235,        9,        1,        8
QPY, 0      , 0      ,       24,        0,       24
QP_, 0.2    , 0.04   ,       10,        2,        8
QQQ, 0.04   , 0.0016 ,       25,        1,       24
QQR, 0.03846, 0.00148,       52,        2,       50
QQS, 0.04082, 0.00167,       49,        2,       47
QQT, 0.02564, 0.00066,       39,        1,       38
QQV, 0.125  , 0.01562,       64,        8,       56
QQW, 0.0625 , 0.00391,       16,        1,       15
QQY, 0.02778, 0.00077,       36,        1,       35
QQ_, 0      , 0      ,        7,        0,        7
QRQ, 0.125  , 0.01562,       16,        2,       14
QRR, 0.09434, 0.0089 ,       53,        5,       48
QRS, 0.05128, 0.00263,       39,        2,       37
QRT, 0.02   , 0.0004 ,       50,        1,       49
QRV, 0.07792, 0.00607,       77,        6,       71
QRW, 0      , 0      ,       14,        0,       14
QRY, 0.06452, 0.00416,       31,        2,       29
QR_, 0      , 0      ,        1,        0,        1
QSQ, 0      , 0      ,       24,        0,       24
QSR, 0.03226, 0.00104,       31,        1,       30
QSS, 0.03571, 0.00128,       56,        2,       54
QST, 0.05455, 0.00298,       55,        3,       52
QSV, 0.08333, 0.00694,       72,        6,       66
QSW, 0      , 0      ,       15,        0,       15
QSY, 0.02857, 0.00082,       35,        1,       34
QS_, 0      , 0      ,        3,        0,        3
QTQ, 0.14286, 0.02041,        7,        1,        6
QTR, 0.08824, 0.00779,       34,        3,       31
QTS, 0.04651, 0.00216,       43,        2,       41
QTT, 0.11111, 0.01235,       45,        5,       40
QTV, 0.0597 , 0.00356,       67,        4,       63
QTW, 0      , 0      ,        6,        0,        6
QTY, 0.06667, 0.00444,       30,        2,       28
QT_, 0.33333, 0.11111,        3,        1,        2
QVQ, 0.04762, 0.00227,       21,        1,       20
QVR, 0.10526, 0.01108,       38,        4,       34
QVS, 0.07143, 0.0051 ,       56,        4,       52
QVT, 0.10169, 0.01034,       59,        6,       53
QVV, 0.07955, 0.00633,       88,        7,       81
QVW, 0.23077, 0.05325,       13,        3,       10
QVY, 0.04878, 0.00238,       41,        2,       39
QV_, 0      , 0      ,        8,        0,        8
QWQ, 0.08333, 0.00694,       12,        1,       11
QWR, 0.06667, 0.00444,       15,        1,       14
QWS, 0.07692, 0.00592,       13,        1,       12
QWT, 0.28571, 0.08163,       14,        4,       10
QWV, 0.1875 , 0.03516,       16,        3,       13
QWW, 0.25   , 0.0625 ,        4,        1,        3
QWY, 0.125  , 0.01562,        8,        1,        7
QYQ, 0.05263, 0.00277,       19,        1,       18
QYR, 0.0625 , 0.00391,       32,        2,       30
QYS, 0      , 0      ,       24,        0,       24
QYT, 0.07692, 0.00592,       26,        2,       24
QYV, 0.10811, 0.01169,       37,        4,       33
QYW, 0.08333, 0.00694,       12,        1,       11
QYY, 0.08333, 0.00694,       36,        3,       33
QY_, 1      , 1      ,        1,        1,        0
RAR, 0      , 0      ,       34,        0,       34
RAS, 0.01724, 0.0003 ,       58,        1,       57
RAT, 0      , 0      ,       44,        0,       44
RAV, 0.0125 , 0.00016,       80,        1,       79
RAW, 0      , 0      ,        8,        0,        8
RAY, 0.08333, 0.00694,       36,        3,       33
RA_, 0.1    , 0.01   ,       10,        1,        9
RCR, 0      , 0      ,        7,        0,        7
RCS, 0      , 0      ,       24,        0,       24
RCT, 0      , 0      ,       10,        0,       10
RCV, 0      , 0      ,       18,        0,       18
RCW, 0.2    , 0.04   ,        5,        1,        4
RCY, 0.15385, 0.02367,       13,        2,       11
RC_, 0      , 0      ,        6,        0,        6
RDR, 0.04348, 0.00189,       23,        1,       22
RDS, 0.0625 , 0.00391,       80,        5,       75
RDT, 0.06122, 0.00375,       49,        3,       46
RDV, 0.09091, 0.00826,       66,        6,       60
RDW, 0      , 0      ,       18,        0,       18
RDY, 0.02703, 0.00073,       37,        1,       36
RD_, 0      , 0      ,        3,        0,        3
RER, 0.04255, 0.00181,       47,        2,       45
RES, 0      , 0      ,       63,        0,       63
RET, 0      , 0      ,       62,        0,       62
REV, 0.00901, 0.00008,      111,        1,      110
REW, 0.07143, 0.0051 ,       28,        2,       26
REY, 0.04082, 0.00167,       49,        2,       47
RE_, 0      , 0      ,        6,        0,        6
RFR, 0      , 0      ,       16,        0,       16
RFS, 0.10345, 0.0107 ,       58,        6,       52
RFT, 0.08571, 0.00735,       35,        3,       32
RFV, 0.08889, 0.0079 ,       45,        4,       41
RFW, 0.09091, 0.00826,       11,        1,       10
RFY, 0.125  , 0.01562,       32,        4,       28
RF_, 0      , 0      ,        4,        0,        4
RGR, 0.03571, 0.00128,       28,        1,       27
RGS, 0.04167, 0.00174,       96,        4,       92
RGT, 0.07937, 0.0063 ,       63,        5,       58
RGV, 0.03488, 0.00122,       86,        3,       83
RGW, 0.31818, 0.10124,       22,        7,       15
RGY, 0.05   , 0.0025 ,       40,        2,       38
RG_, 0      , 0      ,        7,        0,        7
RHR, 0      , 0      ,        5,        0,        5
RHS, 0.08333, 0.00694,       24,        2,       22
RHT, 0.1    , 0.01   ,       20,        2,       18
RHV, 0.13043, 0.01701,       23,        3,       20
RHW, 0      , 0      ,        4,        0,        4
RHY, 0      , 0      ,       25,        0,       25
RH_, 0      , 0      ,        3,        0,        3
RIR, 0.16   , 0.0256 ,       25,        4,       21
RIS, 0.10938, 0.01196,       64,        7,       57
RIT, 0.04762, 0.00227,       42,        2,       40
RIV, 0      , 0      ,       73,        0,       73
RIW, 0      , 0      ,       10,        0,       10
RIY, 0.1    , 0.01   ,       30,        3,       27
RI_, 0      , 0      ,        3,        0,        3
RKR, 0.0625 , 0.00391,       32,        2,       30
RKS, 0.05882, 0.00346,       68,        4,       64
RKT, 0.01724, 0.0003 ,       58,        1,       57
RKV, 0.01449, 0.00021,       69,        1,       68
RKW, 0.21429, 0.04592,       14,        3,       11
RKY, 0.04545, 0.00207,       44,        2,       42
RK_, 0      , 0      ,        6,        0,        6
RLR, 0.01923, 0.00037,       52,        1,       51
RLS, 0.05983, 0.00358,      117,        7,      110
RLT, 0.05357, 0.00287,      112,        6,      106
RLV, 0.07207, 0.00519,      111,        8,      103
RLW, 0      , 0      ,       20,        0,       20
RLY, 0.08065, 0.0065 ,       62,        5,       57
RL_, 0.16667, 0.02778,        6,        1,        5
RMR, 0.16667, 0.02778,       12,        2,       10
RMS, 0.06897, 0.00476,       29,        2,       27
RMT, 0.05263, 0.00277,       19,        1,       18
RMV, 0.04348, 0.00189,       23,        1,       22
RMW, 0.11111, 0.01235,        9,        1,        8
RMY, 0.11111, 0.01235,        9,        1,        8
RM_, 0.2    , 0.04   ,        5,        1,        4
RNR, 0.13636, 0.0186 ,       22,        3,       19
RNS, 0.12766, 0.0163 ,       47,        6,       41
RNT, 0.11429, 0.01306,       35,        4,       31
RNV, 0.09524, 0.00907,       63,        6,       57
RNW, 0      , 0      ,       10,        0,       10
RNY, 0.03226, 0.00104,       31,        1,       30
RN_, 0      , 0      ,        3,        0,        3
RPR, 0.04545, 0.00207,       22,        1,       21
RPS, 0.03509, 0.00123,       57,        2,       55
RPT, 0.10204, 0.01041,       49,        5,       44
RPV, 0.02817, 0.00079,       71,        2,       69
RPW, 0      , 0      ,        9,        0,        9
RPY, 0.04762, 0.00227,       21,        1,       20
RP_, 0.33333, 0.11111,        6,        2,        4
RQR, 0      , 0      ,       13,        0,       13
RQS, 0.05085, 0.00259,       59,        3,       56
RQT, 0.05405, 0.00292,       37,        2,       35
RQV, 0.08065, 0.0065 ,       62,        5,       57
RQW, 0      , 0      ,       11,        0,       11
RQY, 0.12   , 0.0144 ,       25,        3,       22
RQ_, 0      , 0      ,        6,        0,        6
RRR, 0.09375, 0.00879,       32,        3,       29
RRS, 0.14035, 0.0197 ,       57,        8,       49
RRT, 0.1875 , 0.03516,       48,        9,       39
RRV, 0.02703, 0.00073,       74,        2,       72
RRW, 0      , 0      ,       13,        0,       13
RRY, 0.14583, 0.02127,       48,        7,       41
RR_, 0      , 0      ,        8,        0,        8
RSR, 0.07407, 0.00549,       27,        2,       25
RSS, 0.02469, 0.00061,       81,        2,       79
RST, 0.01754, 0.00031,       57,        1,       56
RSV, 0.01149, 0.00013,       87,        1,       86
RSW, 0      , 0      ,       15,        0,       15
RSY, 0.06122, 0.00375,       49,        3,       46
RS_, 0      , 0      ,        9,        0,        9
RTR, 0.13636, 0.0186 ,       22,        3,       19
RTS, 0.04839, 0.00234,       62,        3,       59
RTT, 0.12766, 0.0163 ,       47,        6,       41
RTV, 0.11957, 0.0143 ,       92,       11,       81
RTW, 0.125  , 0.01562,       16,        2,       14
RTY, 0.11429, 0.01306,       35,        4,       31
RT_, 0.5    , 0.25   ,        4,        2,        2
RVR, 0.1    , 0.01   ,       40,        4,       36
RVS, 0.0303 , 0.00092,       66,        2,       64
RVT, 0.08571, 0.00735,       70,        6,       64
RVV, 0.08602, 0.0074 ,       93,        8,       85
RVW, 0.14286, 0.02041,       14,        2,       12
RVY, 0.02381, 0.00057,       42,        1,       41
RV_, 0.4    , 0.16   ,        5,        2,        3
RWR, 0      , 0      ,        8,        0,        8
RWS, 0.36842, 0.13573,       19,        7,       12
RWT, 0.18182, 0.03306,       22,        4,       18
RWV, 0.04545, 0.00207,       22,        1,       21
RWW, 0.33333, 0.11111,        3,        1,        2
RWY, 0.125  , 0.01562,        8,        1,        7
RW_, 0      , 0      ,        1,        0,        1
RYR, 0.13043, 0.01701,       23,        3,       20
RYS, 0.09615, 0.00925,       52,        5,       47
RYT, 0.07895, 0.00623,       38,        3,       35
RYV, 0.13725, 0.01884,       51,        7,       44
RYW, 0.33333, 0.11111,       12,        4,        8
RYY, 0.14815, 0.02195,       27,        4,       23
SAS, 0.025  , 0.00063,       40,        1,       39
SAT, 0.02857, 0.00082,       70,        2,       68
SAV, 0.02273, 0.00052,       88,        2,       86
SAW, 0.04545, 0.00207,       22,        1,       21
SAY, 0.01961, 0.00038,       51,        1,       50
SA_, 0      , 0      ,       10,        0,       10
SCS, 0      , 0      ,       11,        0,       11
SCT, 0      , 0      ,       25,        0,       25
SCV, 0.0303 , 0.00092,       33,        1,       32
SCW, 0.2    , 0.04   ,        5,        1,        4
SCY, 0.11111, 0.01235,        9,        1,        8
SC_, 0      , 0      ,        2,        0,        2
SDS, 0.04255, 0.00181,       47,        2,       45
SDT, 0.03175, 0.00101,       63,        2,       61
SDV, 0.05941, 0.00353,      101,        6,       95
SDW, 0.06897, 0.00476,       29,        2,       27
SDY, 0.05263, 0.00277,       57,        3,       54
SD_, 0      , 0      ,        5,        0,        5
SES, 0.04545, 0.00207,       44,        2,       42
SET, 0      , 0      ,       70,        0,       70
SEV, 0.06122, 0.00375,       98,        6,       92
SEW, 0      , 0      ,       13,        0,       13
SEY, 0.01852, 0.00034,       54,        1,       53
SE_, 0.2    , 0.04   ,        5,        1,        4
SFS, 0.11905, 0.01417,       42,        5,       37
SFT, 0.05263, 0.00277,       57,        3,       54
SFV, 0.13559, 0.01839,       59,        8,       51
SFW, 0.125  , 0.01562,        8,        1,        7
SFY, 0.15789, 0.02493,       38,        6,       32
SGS, 0.10714, 0.01148,       56,        6,       50
SGT, 0.06731, 0.00453,      104,        7,       97
SGV, 0.05769, 0.00333,      104,        6,       98
SGW, 0.05   , 0.0025 ,       20,        1,       19
SGY, 0.04545, 0.00207,       66,        3,       63
SG_, 0.04348, 0.00189,       46,        2,       44
SHS, 0.05   , 0.0025 ,       20,        1,       19
SHT, 0.05882, 0.00346,       34,        2,       32
SHV, 0.09677, 0.00937,       31,        3,       28
SHW, 0.6    , 0.36   ,       10,        6,        4
SHY, 0.11765, 0.01384,       17,        2,       15
SH_, 0      , 0      ,        2,        0,        2
SIS, 0.18605, 0.03461,       43,        8,       35
SIT, 0.03333, 0.00111,       90,        3,       87
SIV, 0.07143, 0.0051 ,       70,        5,       65
SIW, 0.06667, 0.00444,       15,        1,       14
SIY, 0.02941, 0.00087,       34,        1,       33
SI_, 0      , 0      ,        2,        0,        2
SKS, 0.09756, 0.00952,       41,        4,       37
SKT, 0.07895, 0.00623,       76,        6,       70
SKV, 0.04396, 0.00193,       91,        4,       87
SKW, 0.05263, 0.00277,       19,        1,       18
SKY, 0.06122, 0.00375,       49,        3,       46
SK_, 0      , 0      ,        3,        0,        3
SLS, 0.06742, 0.00454,       89,        6,       83
SLT, 0.05556, 0.00309,      108,        6,      102
SLV, 0.05263, 0.00277,      133,        7,      126
SLW, 0.09091, 0.00826,       22,        2,       20
SLY, 0.01351, 0.00018,       74,        1,       73
SL_, 0.11111, 0.01235,        9,        1,        8
SMS, 0.19048, 0.03628,       21,        4,       17
SMT, 0.05   , 0.0025 ,       20,        1,       19
SMV, 0.06452, 0.00416,       31,        2,       29
SMW, 0.14286, 0.02041,        7,        1,        6
SMY, 0.11765, 0.01384,       17,        2,       15
SM_, 0      , 0      ,       14,        0,       14
SNS, 0.04167, 0.00174,       24,        1,       23
SNT, 0      , 0      ,       45,        0,       45
SNV, 0.06579, 0.00433,       76,        5,       71
SNW, 0.04545, 0.00207,       22,        1,       21
SNY, 0.23684, 0.05609,       38,        9,       29
SN_, 0      , 0      ,        9,        0,        9
SPS, 0.02778, 0.00077,       36,        1,       35
SPT, 0      , 0      ,       59,        0,       59
SPV, 0.03947, 0.00156,       76,        3,       73
SPW, 0.07692, 0.00592,       13,        1,       12
SPY, 0.03774, 0.00142,       53,        2,       51
SP_, 0.2    , 0.04   ,        5,        1,        4
SQS, 0.05714, 0.00327,       35,        2,       33
SQT, 0.04878, 0.00238,       41,        2,       39
SQV, 0.02857, 0.00082,       70,        2,       68
SQW, 0.14286, 0.02041,       14,        2,       12
SQY, 0.04348, 0.00189,       46,        2,       44
SQ_, 0      , 0      ,        8,        0,        8
SRS, 0.075  , 0.00562,       40,        3,       37
SRT, 0.02128, 0.00045,       47,        1,       46
SRV, 0.08791, 0.00773,       91,        8,       83
SRW, 0      , 0      ,       19,        0,       19
SRY, 0.05556, 0.00309,       54,        3,       51
SR_, 0      , 0      ,        8,        0,        8
SSS, 0.07143, 0.0051 ,       70,        5,       65
SST, 0.07609, 0.00579,       92,        7,       85
SSV, 0.07463, 0.00557,      134,       10,      124
SSW, 0.09091, 0.00826,       22,        2,       20
SSY, 0.11475, 0.01317,       61,        7,       54
SS_, 0.05882, 0.00346,       17,        1,       16
STS, 0.13158, 0.01731,       38,        5,       33
STT, 0.09859, 0.00972,       71,        7,       64
STV, 0      , 0      ,       90,        0,       90
STW, 0.11765, 0.01384,       17,        2,       15
STY, 0.06818, 0.00465,       44,        3,       41
ST_, 0.11111, 0.01235,        9,        1,        8
SVS, 0.02439, 0.00059,       41,        1,       40
SVT, 0.10256, 0.01052,       78,        8,       70
SVV, 0.04124, 0.0017 ,       97,        4,       93
SVW, 0.0625 , 0.00391,       16,        1,       15
SVY, 0      , 0      ,       45,        0,       45
SV_, 0      , 0      ,       10,        0,       10
SWS, 0.22222, 0.04938,       18,        4,       14
SWT, 0.08333, 0.00694,       24,        2,       22
SWV, 0.15385, 0.02367,       26,        4,       22
SWW, 0      , 0      ,        3,        0,        3
SWY, 0.2    , 0.04   ,       10,        2,        8
SW_, 1      , 1      ,        1,        1,        0
SYS, 0.19355, 0.03746,       31,        6,       25
SYT, 0.07463, 0.00557,       67,        5,       62
SYV, 0.1194 , 0.01426,       67,        8,       59
SYW, 0.09091, 0.00826,       11,        1,       10
SYY, 0.08824, 0.00779,       34,        3,       31
SY_, 0.5    , 0.25   ,        2,        1,        1
TAT, 0.05405, 0.00292,       37,        2,       35
TAV, 0.02597, 0.00067,       77,        2,       75
TAW, 0      , 0      ,       13,        0,       13
TAY, 0.05128, 0.00263,       39,        2,       37
TA_, 0.125  , 0.01562,        8,        1,        7
TCT, 0      , 0      ,        7,        0,        7
TCV, 0.26667, 0.07111,       15,        4,       11
TCW, 0      , 0      ,        4,        0,        4
TCY, 0.3    , 0.09   ,       10,        3,        7
TDT, 0.06897, 0.00476,       29,        2,       27
TDV, 0.06667, 0.00444,       75,        5,       70
TDW, 0.1875 , 0.03516,       16,        3,       13
TDY, 0.1    , 0.01   ,       50,        5,       45
TD_, 0.11111, 0.01235,        9,        1,        8
TET, 0.05405, 0.00292,       37,        2,       35
TEV, 0.07595, 0.00577,       79,        6,       73
TEW, 0.16667, 0.02778,       12,        2,       10
TEY, 0.07407, 0.00549,       54,        4,       50
TE_, 0      , 0      ,        6,        0,        6
TFT, 0.05714, 0.00327,       35,        2,       33
TFV, 0.13725, 0.01884,       51,        7,       44
TFW, 0      , 0      ,        3,        0,        3
TFY, 0.09375, 0.00879,       32,        3,       29
TF_, 0      , 0      ,        3,        0,        3
TGT, 0.09259, 0.00857,       54,        5,       49
TGV, 0.02632, 0.00069,       76,        2,       74
TGW, 0.07692, 0.00592,       13,        1,       12
TGY, 0.05   , 0.0025 ,       40,        2,       38
TG_, 0      , 0      ,        8,        0,        8
THT, 0.22222, 0.04938,        9,        2,        7
THV, 0.0303 , 0.00092,       33,        1,       32
THW, 0      , 0      ,        5,        0,        5
THY, 0.1    , 0.01   ,       20,        2,       18
TIT, 0.09091, 0.00826,       44,        4,       40
TIV, 0.01754, 0.00031,       57,        1,       56
TIW, 0      , 0      ,       14,        0,       14
TIY, 0.12821, 0.01644,       39,        5,       34
TI_, 0      , 0      ,        3,        0,        3
TKT, 0.11429, 0.01306,       35,        4,       31
TKV, 0.06897, 0.00476,       87,        6,       81
TKW, 0      , 0      ,       11,        0,       11
TKY, 0      , 0      ,       45,        0,       45
TK_, 0      , 0      ,        4,        0,        4
TLT, 0.04615, 0.00213,       65,        3,       62
TLV, 0.04237, 0.0018 ,      118,        5,      113
TLW, 0.14286, 0.02041,        7,        1,        6
TLY, 0.05085, 0.00259,       59,        3,       56
TL_, 0      , 0      ,        3,        0,        3
TMT, 0.33333, 0.11111,        6,        2,        4
TMV, 0.09524, 0.00907,       21,        2,       19
TMW, 0      , 0      ,        4,        0,        4
TMY, 0.07692, 0.00592,       13,        1,       12
TM_, 0      , 0      ,        6,        0,        6
TNT, 0.06667, 0.00444,       30,        2,       28
TNV, 0.10811, 0.01169,       74,        8,       66
TNW, 0      , 0      ,        8,        0,        8
TNY, 0.02703, 0.00073,       37,        1,       36
TN_, 0      , 0      ,        4,        0,        4
TPT, 0.13333, 0.01778,       30,        4,       26
TPV, 0.03797, 0.00144,       79,        3,       76
TPW, 0.11765, 0.01384,       17,        2,       15
TPY, 0.08333, 0.00694,       36,        3,       33
TP_, 0      , 0      ,        8,        0,        8
TQT, 0.07143, 0.0051 ,       28,        2,       26
TQV, 0.08065, 0.0065 ,       62,        5,       57
TQW, 0.16667, 0.02778,       18,        3,       15
TQY, 0.09091, 0.00826,       33,        3,       30
TQ_, 0.14286, 0.02041,        7,        1,        6
TRT, 0.06452, 0.00416,       31,        2,       29
TRV, 0.09589, 0.00919,       73,        7,       66
TRW, 0.2    , 0.04   ,       10,        2,        8
TRY, 0.05128, 0.00263,       39,        2,       37
TR_, 0      , 0      ,        9,        0,        9
TST, 0.02941, 0.00087,       34,        1,       33
TSV, 0.06742, 0.00454,       89,        6,       83
TSW, 0.1    , 0.01   ,       10,        1,        9
TSY, 0.04545, 0.00207,       44,        2,       42
TS_, 0      , 0      ,        7,        0,        7
TTT, 0.18182, 0.03306,       44,        8,       36
TTV, 0.03704, 0.00137,       81,        3,       78
TTW, 0.04545, 0.00207,       22,        1,       21
TTY, 0.1    , 0.01   ,       30,        3,       27
TT_, 0.4    , 0.16   ,        5,        2,        3
TVT, 0.05714, 0.00327,       35,        2,       33
TVV, 0.03614, 0.00131,       83,        3,       80
TVW, 0      , 0      ,       16,        0,       16
TVY, 0.0625 , 0.00391,       48,        3,       45
TV_, 0      , 0      ,        5,        0,        5
TWT, 0.08333, 0.00694,       12,        1,       11
TWV, 0.1875 , 0.03516,       16,        3,       13
TWW, 0.25   , 0.0625 ,        4,        1,        3
TWY, 0.2    , 0.04   ,        5,        1,        4
TW_, 0      , 0      ,        1,        0,        1
TYT, 0.03571, 0.00128,       28,        1,       27
TYV, 0.15556, 0.0242 ,       45,        7,       38
TYW, 0      , 0      ,        7,        0,        7
TYY, 0.13953, 0.01947,       43,        6,       37
TY_, 0      , 0      ,        2,        0,        2
VAV, 0.0625 , 0.00391,       48,        3,       45
VAW, 0.05882, 0.00346,       17,        1,       16
VAY, 0.09524, 0.00907,       42,        4,       38
VA_, 0      , 0      ,        5,        0,        5
VCV, 0.125  , 0.01562,        8,        1,        7
VCW, 0      , 0      ,        6,        0,        6
VCY, 0.07143, 0.0051 ,       14,        1,       13
VDV, 0.05263, 0.00277,       57,        3,       54
VDW, 0.10345, 0.0107 ,       29,        3,       26
VDY, 0.05   , 0.0025 ,       60,        3,       57
VD_, 0      , 0      ,        9,        0,        9
VEV, 0.06154, 0.00379,       65,        4,       61
VEW, 0      , 0      ,       21,        0,       21
VEY, 0.11765, 0.01384,       85,       10,       75
VE_, 0      , 0      ,        8,        0,        8
VFV, 0.11538, 0.01331,       26,        3,       23
VFW, 0.14286, 0.02041,        7,        1,        6
VFY, 0.11765, 0.01384,       34,        4,       30
VF_, 0.16667, 0.02778,        6,        1,        5
VGV, 0.05   , 0.0025 ,       60,        3,       57
VGW, 0.22222, 0.04938,        9,        2,        7
VGY, 0.06   , 0.0036 ,       50,        3,       47
VG_, 0      , 0      ,        3,        0,        3
VHV, 0.13793, 0.01902,       29,        4,       25
VHW, 0.16667, 0.02778,        6,        1,        5
VHY, 0.04545, 0.00207,       22,        1,       21
VH_, 0      , 0      ,        1,        0,        1
VIV, 0.03125, 0.00098,       32,        1,       31
VIW, 0.125  , 0.01562,        8,        1,        7
VIY, 0.08824, 0.00779,       34,        3,       31
VI_, 0      , 0      ,        4,        0,        4
VKV, 0.05455, 0.00298,       55,        3,       52
VKW, 0      , 0      ,       16,        0,       16
VKY, 0.06897, 0.00476,       58,        4,       54
VK_, 0      , 0      ,        8,        0,        8
VLV, 0.02273, 0.00052,       44,        1,       43
VLW, 0.04545, 0.00207,       22,        1,       21
VLY, 0.01852, 0.00034,       54,        1,       53
VL_, 0      , 0      ,        5,        0,        5
VMV, 0.08696, 0.00756,       23,        2,       21
VMW, 0.2    , 0.04   ,        5,        1,        4
VMY, 0.2    , 0.04   ,        5,        1,        4
VM_, 0      , 0      ,        9,        0,        9
VNV, 0.1087 , 0.01181,       46,        5,       41
VNW, 0.05882, 0.00346,       17,        1,       16
VNY, 0.06061, 0.00367,       33,        2,       31
VN_, 0      , 0      ,        3,        0,        3
VPV, 0.07547, 0.0057 ,       53,        4,       49
VPW, 0      , 0      ,        6,        0,        6
VPY, 0.08   , 0.0064 ,       50,        4,       46
VP_, 0      , 0      ,       10,        0,       10
VQV, 0.06522, 0.00425,       46,        3,       43
VQW, 0      , 0      ,       15,        0,       15
VQY, 0      , 0      ,       32,        0,       32
VQ_, 0      , 0      ,        3,        0,        3
VRV, 0.09804, 0.00961,       51,        5,       46
VRW, 0.03448, 0.00119,       29,        1,       28
VRY, 0.12727, 0.0162 ,       55,        7,       48
VR_, 0      , 0      ,        6,        0,        6
VSV, 0.03774, 0.00142,       53,        2,       51
VSW, 0.25   , 0.0625 ,       20,        5,       15
VSY, 0.05063, 0.00256,       79,        4,       75
VS_, 0      , 0      ,        9,        0,        9
VTV, 0.01449, 0.00021,       69,        1,       68
VTW, 0      , 0      ,       11,        0,       11
VTY, 0.07895, 0.00623,       38,        3,       35
VT_, 0.14286, 0.02041,        7,        1,        6
VVV, 0.09091, 0.00826,       44,        4,       40
VVW, 0.08333, 0.00694,       12,        1,       11
VVY, 0.09302, 0.00865,       43,        4,       39
VV_, 0      , 0      ,        2,        0,        2
VWV, 0.28571, 0.08163,        7,        2,        5
VWW, 0      , 0      ,        2,        0,        2
VWY, 0.11111, 0.01235,        9,        1,        8
VW_, 0      , 0      ,        1,        0,        1
VYV, 0.07692, 0.00592,       26,        2,       24
VYW, 0      , 0      ,        4,        0,        4
VYY, 0.08   , 0.0064 ,       25,        2,       23
VY_, 0      , 0      ,        1,        0,        1
WAW, 0      , 0      ,        3,        0,        3
WAY, 0      , 0      ,        5,        0,        5
WA_, 0      , 0      ,        1,        0,        1
WCY, 0      , 0      ,        2,        0,        2
WC_, 0      , 0      ,        2,        0,        2
WDW, 0      , 0      ,        1,        0,        1
WDY, 0.07692, 0.00592,       13,        1,       12
WD_, 0      , 0      ,        2,        0,        2
WEW, 0      , 0      ,        2,        0,        2
WEY, 0.1    , 0.01   ,       20,        2,       18
WFY, 0.2    , 0.04   ,        5,        1,        4
WF_, 0      , 0      ,        1,        0,        1
WGW, 0      , 0      ,        2,        0,        2
WGY, 0.1    , 0.01   ,       10,        1,        9
WG_, 0      , 0      ,        1,        0,        1
WHY, 0      , 0      ,        6,        0,        6
WH_, 0      , 0      ,        1,        0,        1
WIW, 0      , 0      ,        1,        0,        1
WIY, 0      , 0      ,        7,        0,        7
WKW, 0      , 0      ,        1,        0,        1
WKY, 0      , 0      ,        9,        0,        9
WK_, 0      , 0      ,        2,        0,        2
WLW, 0      , 0      ,        2,        0,        2
WLY, 0.08333, 0.00694,       12,        1,       11
WMW, 0      , 0      ,        1,        0,        1
WMY, 0      , 0      ,        3,        0,        3
WNW, 0      , 0      ,        5,        0,        5
WNY, 0      , 0      ,       13,        0,       13
WN_, 0      , 0      ,        1,        0,        1
WPW, 0      , 0      ,        1,        0,        1
WPY, 0      , 0      ,       11,        0,       11
WP_, 0      , 0      ,        3,        0,        3
WQW, 1      , 1      ,        1,        1,        0
WQY, 0      , 0      ,        4,        0,        4
WQ_, 0      , 0      ,        1,        0,        1
WRW, 0      , 0      ,        1,        0,        1
WRY, 0      , 0      ,       13,        0,       13
WSW, 0      , 0      ,        3,        0,        3
WSY, 0.3125 , 0.09766,       16,        5,       11
WS_, 0      , 0      ,        2,        0,        2
WTW, 0      , 0      ,        3,        0,        3
WTY, 0      , 0      ,        9,        0,        9
WVY, 0.2    , 0.04   ,        5,        1,        4
WWY, 0      , 0      ,        1,        0,        1
WYW, 0      , 0      ,        3,        0,        3
WYY, 0.16667, 0.02778,        6,        1,        5
YAY, 0.06667, 0.00444,       15,        1,       14
YA_, 0      , 0      ,        2,        0,        2
YCY, 0.2    , 0.04   ,        5,        1,        4
YDY, 0.1    , 0.01   ,       30,        3,       27
YD_, 0      , 0      ,        7,        0,        7
YEY, 0      , 0      ,        9,        0,        9
YE_, 0      , 0      ,        2,        0,        2
YFY, 0.14286, 0.02041,       14,        2,       12
YGY, 0.16667, 0.02778,       24,        4,       20
YG_, 0      , 0      ,        3,        0,        3
YHY, 0.2    , 0.04   ,        5,        1,        4
YH_, 0      , 0      ,        2,        0,        2
YIY, 0.1    , 0.01   ,       10,        1,        9
YI_, 0      , 0      ,        2,        0,        2
YKY, 0      , 0      ,       21,        0,       21
YLY, 0.05882, 0.00346,       17,        1,       16
YL_, 0      , 0      ,        4,        0,        4
YMY, 0.1    , 0.01   ,       10,        1,        9
YM_, 0      , 0      ,        2,        0,        2
YNY, 0.05   , 0.0025 ,       20,        1,       19
YN_, 0      , 0      ,        4,        0,        4
YPY, 0.1    , 0.01   ,       10,        1,        9
YP_, 0      , 0      ,        4,        0,        4
YQY, 0      , 0      ,       12,        0,       12
YRY, 0      , 0      ,       10,        0,       10
YR_, 0      , 0      ,        1,        0,        1
YSY, 0.07143, 0.0051 ,       14,        1,       13
YS_, 0      , 0      ,        5,        0,        5
YTY, 0      , 0      ,       14,        0,       14
YT_, 0      , 0      ,        2,        0,        2
YVY, 0.25   , 0.0625 ,       12,        3,        9
YV_, 0      , 0      ,        3,        0,        3
YWY, 0.33333, 0.11111,        3,        1,        2
YYY, 0.0625 , 0.00391,       16,        1,       15
YY_, 0      , 0      ,        1,        0,        1
